lower,node,ortho,phono,original,replace,delete_insert,pos_l50,pos_m50
a,1,a,x,7,4,3,6,1
aback,3,aback,xb@k,3,2,1,2,1
abase,8,abase,xbes,4,3,1,2,2
abash,9,abash,xb@S,2,1,1,1,1
abate,10,abate,xbet,7,6,1,3,4
abatis,11,abatis,@bxti,3,2,1,1,2
abbacy,13,abbacy,@bxsi,2,1,1,0,2
abbe,14,abbe,@be,4,3,1,3,1
abbess,15,abbess,@bxs,4,3,1,2,2
abbey,16,abbey,@bi,10,5,5,9,1
abbot,17,abbot,@bxt,3,2,1,1,2
abeam,25,abeam,xbim,1,0,1,1,0
abed,27,abed,xbEd,5,4,1,2,3
abet,30,abet,xbEt,5,4,1,1,4
abide,33,abide,xbYd,5,4,1,3,2
ablaze,42,ablaze,xblez,1,0,1,1,0
able,43,able,ebL,8,1,7,8,0
abloom,44,abloom,xblum,1,0,1,1,0
aboard,51,aboard,xbord,5,3,2,4,1
abode,52,abode,xbod,4,2,2,1,3
abound,62,abound,xbWnd,2,1,1,2,0
about,63,about,xbWt,4,3,1,1,3
above,64,above,xb^v,1,1,0,0,1
abrade,66,abrade,xbred,3,2,1,2,1
abreast,68,abreast,xbrEst,2,0,2,2,0
abridge,69,abridge,xbrIJ,1,0,1,1,0
abroad,70,abroad,xbrcd,2,1,1,1,1
abstain,87,abstain,xbsten,1,0,1,1,0
abuse,96,abuse,xbyuz,2,2,0,2,0
abut,97,abut,xb^t,5,4,1,1,4
abyss,101,abyss,xbIs,2,2,0,1,1
accede,109,accede,@ksid,2,2,0,1,1
acclaim,125,acclaim,xklem,2,1,1,2,0
accord,136,accord,xkord,4,3,1,4,0
accost,139,accost,xkcst,2,1,1,2,0
account,140,account,xkWnt,2,1,1,2,0
accrue,145,accrue,xkru,2,1,1,2,0
accursed,150,accursed,xkRst,2,2,0,2,0
accusal,151,accusal,xkyuzL,2,1,1,0,2
accuse,154,accuse,xkyuz,5,3,2,2,3
accuser,155,accuser,xkyuzX,2,1,1,0,2
ace,157,ace,es,22,12,10,14,8
acerb,158,acerb,xsRb,1,1,0,0,1
ache,165,ache,ek,24,12,12,15,9
acorn,178,acorn,ekorn,2,1,1,2,0
acquaint,180,acquaint,xkwent,1,0,1,1,0
acquire,182,acquire,xkwYr,2,1,1,2,0
acquit,185,acquit,xkwIt,2,1,1,1,1
acre,186,acre,ekX,3,1,2,2,1
acrid,188,acrid,@krxd,1,0,1,1,0
across,198,across,xkrcs,2,0,2,2,0
act,200,act,@kt,9,4,5,7,2
actor,207,actor,@ktX,5,2,3,4,1
acute,216,acute,xkyut,2,1,1,1,1
ad,217,ad,@d,25,10,15,15,10
adder,226,adder,@dX,9,6,3,6,3
addle,232,addle,@dL,8,5,3,5,3
address,233,address,@drEs,2,0,2,1,1
addressee,234,addressee,@drEsi,1,0,1,0,1
adduce,235,adduce,xdus,3,1,2,2,1
adieu,240,adieu,xdyu,1,0,1,0,1
adjoin,247,adjoin,xJOn,2,1,1,1,1
adjourn,248,adjourn,xJRn,1,1,0,0,1
adjudge,249,adjudge,xJ^J,1,0,1,1,0
adjure,254,adjure,xJUr,4,4,0,3,1
adjust,255,adjust,xJ^st,1,0,1,1,0
ado,276,ado,xdu,4,1,3,2,2
adore,283,adore,xdor,2,1,1,1,1
adorn,284,adorn,xdorn,1,0,1,0,1
adrift,286,adrift,xdrIft,1,0,1,1,0
adult,290,adult,xd^lt,1,1,0,1,0
adze,319,adze,@dz,6,4,2,3,3
aerate,322,aerate,Eret,8,7,1,8,0
aerial,324,aerial,@riL,4,2,2,2,2
aerie,326,aerie,Eri,19,10,9,16,3
aero,327,aero,Ero,14,10,4,10,4
aerobe,328,aerobe,Erob,3,1,2,2,1
aeronaut,331,aeronaut,@rxnct,1,0,1,0,1
aery,336,aery,@ri,21,11,10,17,4
afar,341,afar,xfar,4,3,1,2,2
affable,343,affable,@fxbL,1,1,0,1,0
affair,345,affair,xfEr,4,3,1,2,2
affect,346,affect,xfEkt,2,2,0,2,0
affirm,354,affirm,xfRm,1,0,1,1,0
affix,357,affix,xfIks,1,0,1,1,0
afford,361,afford,xford,4,3,1,4,0
affray,362,affray,xfre,3,0,3,2,1
affright,363,affright,xfrYt,2,0,2,2,0
affront,364,affront,xfr^nt,1,0,1,1,0
afield,368,afield,xfild,1,0,1,1,0
afire,369,afire,xfYr,4,3,1,2,2
aflame,370,aflame,xflem,2,1,1,2,0
afloat,371,afloat,xflot,1,0,1,1,0
aflutter,372,aflutter,xfl^tX,1,0,1,1,0
afoot,373,afoot,xfUt,1,0,1,1,0
afoul,376,afoul,xfWl,2,0,2,2,0
afraid,377,afraid,xfred,2,1,1,1,1
afresh,378,afresh,xfrES,1,0,1,1,0
aft,381,aft,@ft,10,4,6,9,1
after,382,after,@ftX,5,2,3,4,1
agape,390,agape,xgep,1,0,1,1,0
agate,391,agate,@gxt,1,1,0,1,0
age,393,age,eJ,16,10,6,8,8
aggrieve,407,aggrieve,xgriv,2,0,2,1,1
aghast,408,aghast,xg@st,1,1,0,1,0
agile,409,agile,@JL,2,2,0,2,0
agleam,414,agleam,xglim,1,0,1,1,0
aglitter,415,aglitter,xglItX,1,0,1,1,0
aglow,416,aglow,xglo,2,0,2,1,1
ago,418,ago,xgo,3,1,2,2,1
agree,425,agree,xgri,2,0,2,1,1
aground,428,aground,xgrWnd,2,0,2,2,0
ahead,430,ahead,xhEd,2,1,1,2,0
ahoy,431,ahoy,xhO,1,1,0,1,0
aid,432,aid,ed,20,12,8,12,8
ail,434,ail,el,32,16,16,24,8
aim,437,aim,em,21,11,10,13,8
air,438,air,Er,30,13,17,19,11
aisle,443,aisle,Yl,23,11,12,19,4
ajar,444,ajar,xJar,3,2,1,2,1
akin,446,akin,xkIn,2,1,1,2,0
album,456,album,@lbxm,1,0,1,1,0
alder,467,alder,cldX,3,2,1,1,2
alee,469,alee,xli,9,7,2,6,3
alert,472,alert,xlRt,9,9,0,4,5
alga,476,alga,@lgx,1,0,1,0,1
algae,477,algae,@lJi,2,0,2,0,2
alight,487,alight,xlYt,16,14,2,7,9
alike,488,alike,xlYk,5,4,1,1,4
aline,492,aline,xlYn,8,6,2,3,5
alit,493,alit,xlIt,8,7,1,3,5
alive,494,alive,xlYv,4,4,0,0,4
all,501,all,cl,25,12,13,19,6
allah,502,Allah,@lx,8,5,3,1,7
allay,503,allay,xle,12,8,4,9,3
allege,505,allege,xlEJ,3,2,1,3,0
allergy,516,allergy,@lXJi,1,0,1,0,1
alley,519,alley,@li,22,13,9,16,6
allied,522,allied,xlYd,12,10,2,6,6
allot,528,allot,xlat,10,9,1,5,5
allow,529,allow,xlW,5,4,1,2,3
alloy,530,alloy,@lO,7,7,0,2,5
allude,532,allude,xlud,6,3,3,3,3
allure,533,allure,xlUr,4,3,1,4,0
ally,535,ally,@lY,9,8,1,4,5
alms,541,alms,amz,2,2,0,1,1
aloe,542,aloe,@lo,20,11,9,14,6
aloft,543,aloft,xlcft,1,0,1,1,0
alone,545,alone,xlon,7,5,2,5,2
along,546,along,xlcG,2,0,2,2,0
aloof,549,aloof,xluf,1,1,0,0,1
aloud,550,aloud,xlWd,5,3,2,2,3
alp,551,alp,@lp,6,6,0,1,5
altar,562,altar,cltX,5,1,4,4,1
alto,571,alto,@lto,1,0,1,0,1
alum,575,alum,@lxm,2,0,2,1,1
am,582,am,@m,19,9,10,12,7
amah,583,amah,amx,4,1,3,3,1
amain,584,amain,xmen,4,3,1,3,1
amass,591,amass,xm@s,3,2,1,1,2
amaze,596,amaze,xmez,2,1,1,1,1
amber,600,amber,@mbX,5,3,2,4,1
amble,609,amble,@mbL,6,3,3,4,2
amen,616,amen,emEn,1,0,1,1,0
amend,618,amend,xmEnd,8,5,3,7,1
amends,620,amends,xmEndz,1,0,1,0,1
amerce,622,amerce,xmRs,4,4,0,2,2
amid,632,amid,xmId,2,1,1,1,1
amiss,633,amiss,xmIs,5,4,1,2,3
amity,634,amity,@mxti,1,1,0,1,0
ammeter,635,ammeter,@mitX,1,0,1,1,0
ammo,636,ammo,@mo,4,2,2,3,1
amok,643,amok,xm^k,2,1,1,1,1
among,644,among,xm^G,1,1,0,0,1
amoral,646,amoral,emcrL,2,1,1,2,0
amount,651,amount,xmWnt,2,1,1,2,0
amour,652,amour,xmUr,3,3,0,3,0
ample,658,ample,@mpL,3,1,2,2,1
amuse,668,amuse,xmyuz,3,2,1,3,0
an,669,an,@n,22,11,11,14,8
anal,676,anal,enL,2,1,1,1,1
anchor,698,anchor,@GkX,7,2,5,4,3
and,704,and,@nd,12,2,10,8,4
anent,712,anent,xnEnt,3,3,0,3,0
anew,715,anew,xnu,4,2,2,3,1
angel,716,angel,enJL,1,0,1,0,1
anger,718,anger,@GgX,3,2,1,1,2
angle,720,angle,@GgL,10,3,7,8,2
anise,744,anise,@n|s,3,3,0,3,0
ankh,745,ankh,@Gk,14,2,12,12,2
ankle,746,ankle,@GkL,4,2,2,1,3
anneal,749,anneal,xnil,4,2,2,3,1
annoy,758,annoy,xnO,2,2,0,1,1
annul,762,annul,xn^l,2,1,1,1,1
anode,766,anode,@nod,2,0,2,1,1
anoint,769,anoint,xnOnt,2,2,0,2,0
answer,778,answer,@nsX,3,1,2,2,1
ant,780,ant,@nt,12,4,8,8,4
ante,785,ante,@nti,5,1,4,2,3
anther,796,anther,@nTX,2,1,1,1,1
anti,805,anti,@ntY,3,2,1,1,2
antic,808,antic,@ntIk,2,1,1,1,1
antique,826,antique,@ntik,2,1,1,0,2
anus,836,anus,en|s,3,2,1,3,0
any,840,any,Eni,9,4,5,5,4
apace,845,apace,xpes,4,3,1,3,1
apart,846,apart,xpart,3,1,2,3,0
ape,851,ape,ep,17,10,7,9,8
apeak,852,apeak,xpik,5,4,1,2,3
apiece,865,apiece,xpis,5,4,1,1,4
aplomb,866,aplomb,xpl^m,1,0,1,1,0
aport,875,aport,xport,5,3,2,5,0
apostle,878,apostle,xpasL,1,1,0,0,1
appal,884,appal,xpcl,3,2,1,1,2
apparent,888,apparent,xp@rxnt,1,0,1,1,0
appeal,890,appeal,xpil,6,5,1,2,4
appear,891,appear,xpIr,2,1,1,2,0
appease,893,appease,xpiz,5,4,1,1,4
append,898,append,xpEnd,7,6,1,7,0
applaud,906,applaud,xplcd,2,2,0,0,2
applause,907,applause,xplcz,1,1,0,0,1
apple,908,apple,@pL,8,5,3,6,2
applied,915,applied,xplYd,3,1,2,1,2
apply,917,apply,xplY,3,0,3,2,1
appoint,918,appoint,xpOnt,3,1,2,2,1
appointee,919,appointee,xpOnti,1,0,1,0,1
appraise,926,appraise,xprez,3,2,1,2,1
apprize,933,apprize,xprYz,3,1,2,2,1
approval,938,approval,xpruvL,1,0,1,0,1
approve,939,approve,xpruv,2,0,2,1,1
apse,947,apse,@ps,7,3,4,5,2
apt,948,apt,@pt,8,6,2,6,2
arab,960,Arab,@rxb,3,2,1,0,3
arable,964,arable,@rxbL,4,1,3,3,1
arbor,974,arbor,arbX,5,3,2,2,3
arc,979,arc,ark,11,3,8,7,4
arch,982,arch,arC,8,3,5,3,5
archer,989,archer,arCX,5,3,2,0,5
archery,990,archery,arCXi,3,2,1,2,1
ardor,1007,ardor,ardX,5,4,1,2,3
are,1009,are,ar,19,6,13,14,5
area,1010,area,@rix,4,2,2,1,3
aria,1022,aria,arix,1,1,0,1,0
arid,1023,arid,@rxd,4,3,1,2,2
aright,1026,aright,xrYt,8,5,3,6,2
arise,1027,arise,xrYz,7,4,3,4,3
arm,1034,arm,arm,9,3,6,3,6
armor,1044,armor,armX,6,4,2,0,6
armory,1046,armory,armXi,4,2,2,2,2
army,1048,army,armi,4,2,2,0,4
around,1052,around,xrWnd,4,2,2,4,0
arouse,1053,arouse,xrWz,4,3,1,3,1
arraign,1055,arraign,xren,10,7,3,8,2
arrange,1056,arrange,xrenJ,3,1,2,2,1
arrant,1057,arrant,@rxnt,3,1,2,2,1
arras,1058,arras,@rxs,5,4,1,2,3
array,1059,array,xre,12,9,3,10,2
arrest,1061,arrest,xrEst,5,3,2,5,0
arrival,1062,arrival,xrYvL,1,0,1,1,0
arrow,1065,arrow,@ro,18,11,7,16,2
arson,1071,arson,arsN,1,0,1,1,0
art,1072,art,art,13,4,9,8,5
artery,1076,artery,artXi,3,2,1,2,1
arty,1095,arty,arti,5,1,4,2,3
arum,1096,arum,@rM,5,3,2,3,2
aryan,1097,Aryan,@rixn,2,0,2,1,1
as,1098,as,@z,13,9,4,7,6
ascend,1101,ascend,xsEnd,6,5,1,5,1
ascension,1104,ascension,xsEnC|n,1,1,0,1,0
ascent,1105,ascent,xsEnt,4,3,1,3,1
ash,1111,ash,@S,17,6,11,10,7
ashore,1115,ashore,xSor,3,2,1,2,1
ashy,1116,ashy,@Si,5,3,2,4,1
aside,1118,aside,xsYd,5,4,1,3,2
ask,1121,ask,@sk,8,3,5,5,3
askew,1123,askew,xskyu,1,0,1,1,0
aslant,1124,aslant,xsl@nt,1,0,1,1,0
asleep,1125,asleep,xslip,1,0,1,1,0
asp,1126,asp,@sp,7,3,4,4,3
aspire,1138,aspire,xspYr,1,0,1,1,0
ass,1140,ass,@s,21,10,11,11,10
assail,1141,assail,xsel,2,1,1,2,0
assault,1143,assault,xsclt,2,0,2,2,0
assay,1144,assay,@se,7,4,3,4,3
assert,1148,assert,xsRt,3,3,0,2,1
asset,1151,asset,@sEt,1,0,1,1,0
assign,1156,assign,xsYn,5,4,1,3,2
assist,1160,assist,xsIst,1,0,1,1,0
assize,1162,assize,xsYz,4,3,1,2,2
assort,1167,assort,xsort,2,1,1,2,0
assuage,1168,assuage,xsweJ,1,0,1,1,0
assure,1172,assure,xSUr,6,4,2,4,2
assured,1173,assured,xSUrd,1,0,1,0,1
aster,1175,aster,@stX,10,6,4,10,0
astern,1177,astern,xstRn,2,0,2,1,1
astir,1182,astir,xstR,2,0,2,1,1
astray,1188,astray,xstre,1,0,1,1,0
astride,1189,astride,xstrYd,1,0,1,1,0
asunder,1200,asunder,xs^ndX,1,0,1,1,0
at,1203,at,@t,31,12,19,23,8
ate,1206,ate,et,27,14,13,17,10
atheistic,1210,atheistic,eTiIstIk,1,0,1,1,0
athirst,1212,athirst,xTRst,2,1,1,2,0
athwart,1215,athwart,xTwort,1,0,1,1,0
atilt,1216,atilt,xtIlt,2,1,1,2,0
atoll,1220,atoll,@tcl,2,1,1,2,0
atom,1221,atom,@tM,5,4,1,3,2
atonal,1225,atonal,etonL,2,0,2,1,1
atonally,1227,atonally,etonLi,1,0,1,0,1
atone,1228,atone,xton,5,4,1,3,2
atop,1229,atop,xtap,2,1,1,2,0
attach,1235,attach,xt@C,1,1,0,0,1
attack,1238,attack,xt@k,4,3,1,3,1
attain,1239,attain,xten,7,5,2,4,3
attaint,1243,attaint,xtent,2,0,2,1,1
attar,1244,attar,@tX,18,6,12,16,2
attempt,1245,attempt,xtEmpt,1,0,1,1,0
attend,1246,attend,xtEnd,5,4,1,5,0
attention,1248,attention,xtEnC|n,2,1,1,2,0
attest,1251,attest,xtEst,2,1,1,2,0
attic,1253,attic,@tIk,4,1,3,4,0
attire,1254,attire,xtYr,2,1,1,2,0
attract,1258,attract,xtr@kt,1,0,1,1,0
attune,1265,attune,xtun,3,2,1,1,2
auger,1285,auger,cgX,4,4,0,4,0
aught,1286,aught,ct,23,10,13,15,8
auk,1291,auk,ck,16,8,8,11,5
auld,1292,auld,cld,4,1,3,2,2
aura,1293,aura,crx,2,2,0,1,1
aural,1294,aural,crL,7,3,4,6,1
aureole,1297,aureole,criol,2,2,0,2,0
auricle,1298,auricle,crIkL,3,3,0,3,0
austere,1304,austere,cstIr,1,0,1,1,0
author,1312,author,cTX,3,3,0,3,0
auto,1319,auto,cto,4,2,2,2,2
autumn,1337,autumn,ctM,4,3,1,2,2
avail,1341,avail,xvel,2,1,1,2,0
avast,1346,avast,xv@st,2,1,1,2,0
avaunt,1348,avaunt,xvcnt,2,1,1,2,0
avenge,1350,avenge,xvEnJ,1,1,0,0,1
aver,1352,aver,xvR,5,2,3,1,4
averse,1355,averse,xvRs,4,2,2,2,2
aversion,1356,aversion,xvRZ|n,1,0,1,1,0
avert,1357,avert,xvRt,5,4,1,3,2
avid,1363,avid,@vxd,1,1,0,1,0
avoid,1370,avoid,xvOd,3,1,2,3,0
avouch,1372,avouch,xvWC,2,0,2,1,1
avow,1373,avow,xvW,5,2,3,2,3
await,1375,await,xwet,6,4,2,4,2
awake,1376,awake,xwek,4,2,2,2,2
award,1378,award,xword,5,4,1,5,0
aware,1379,aware,xwEr,4,3,1,4,0
awash,1380,awash,xwcS,1,0,1,1,0
awe,1381,awe,c,20,4,16,15,5
aweary,1382,aweary,xwIri,2,1,1,2,0
aweigh,1383,aweigh,xwe,6,3,3,4,2
awful,1386,awful,cfL,4,3,1,1,3
awhile,1387,awhile,xhwYl,2,1,1,1,1
awhirl,1388,awhirl,xhwRl,2,1,1,1,1
awn,1390,awn,cn,16,9,7,11,5
awning,1391,awning,cnIG,2,2,0,2,0
awol,1392,AWOL,ewcl,1,0,1,1,0
awry,1393,awry,xrY,9,6,3,6,3
axe,1394,axe,@ks,9,4,5,6,3
axial,1395,axial,@ksiL,2,1,1,0,2
axle,1399,axle,@ksL,2,0,2,0,2
ay,1400,ay,Y,25,4,21,21,4
ayah,1401,ayah,Yx,7,4,3,3,4
azure,1405,azure,@ZX,3,3,0,3,0
b,1406,b,bi,35,24,11,20,15
babble,1407,babble,b@bL,12,12,0,8,4
babe,1408,babe,beb,13,10,3,2,11
babel,1409,Babel,bebL,16,14,2,12,4
baby,1412,baby,bebi,5,4,1,3,2
back,1418,back,b@k,32,28,4,20,12
bad,1428,bad,b@d,30,27,3,19,11
badge,1429,badge,b@J,13,12,1,2,11
badger,1430,badger,b@JX,3,2,1,0,3
baffle,1433,baffle,b@fL,6,5,1,1,5
bag,1434,bag,b@g,28,26,2,17,11
bagel,1437,bagel,begL,3,3,0,1,2
baggy,1439,baggy,b@gi,3,2,1,2,1
baht,1442,baht,bat,34,31,3,26,8
bail,1443,bail,bel,33,30,3,24,9
bairn,1447,bairn,bErn,6,5,1,3,3
bait,1448,bait,bet,33,29,4,23,10
baize,1449,baize,bez,22,19,3,13,9
bake,1450,bake,bek,29,26,3,20,9
bald,1457,bald,bcld,4,2,2,3,1
baleen,1462,baleen,bxlin,3,3,0,0,3
balk,1464,balk,bck,19,18,1,15,4
ball,1465,ball,bcl,24,21,3,19,5
ballad,1466,ballad,b@lxd,3,3,0,3,0
ballast,1467,ballast,b@l|st,1,0,1,0,1
ballet,1470,ballet,b@le,1,1,0,1,0
balloon,1472,balloon,bxlun,2,2,0,1,1
ballot,1473,ballot,b@l|t,6,5,1,5,1
balm,1476,balm,bam,13,12,1,6,7
ban,1482,ban,b@n,30,25,5,17,13
band,1486,band,b@nd,19,13,6,14,5
bandy,1497,bandy,b@ndi,6,4,2,4,2
bane,1498,bane,ben,32,28,4,23,9
bang,1499,bang,b@G,19,18,1,8,11
bangle,1500,bangle,b@GgL,8,7,1,8,0
bani,1501,bani,bani,7,7,0,3,4
bank,1505,bank,b@Gk,15,11,4,12,3
banner,1508,banner,b@nX,10,8,2,4,6
banns,1510,banns,b@nz,5,4,1,1,4
banshee,1513,banshee,b@nSi,1,1,0,0,1
banter,1515,banter,b@ntX,4,2,2,2,2
bantu,1517,Bantu,b@ntu,1,1,0,0,1
bar,1524,bar,bar,24,17,7,12,12
barb,1525,barb,barb,10,6,4,1,9
barbed,1532,barbed,barbd,3,1,2,0,3
barber,1534,barber,barbX,6,4,2,2,4
bard,1539,bard,bard,19,17,2,11,8
bare,1540,bare,bEr,26,21,5,18,8
barge,1542,barge,barJ,9,8,1,3,6
bark,1545,bark,bark,15,11,4,7,8
barker,1547,barker,barkX,3,2,1,0,3
barley,1548,barley,barli,1,1,0,1,0
barn,1549,barn,barn,11,10,1,5,6
baroque,1558,baroque,bXok,1,1,0,1,0
barrel,1564,barrel,b@rL,7,7,0,2,5
barrier,1567,barrier,b@riX,3,3,0,3,0
barrow,1570,barrow,b@ro,10,9,1,7,3
barter,1572,barter,bartX,6,6,0,4,2
basal,1573,basal,besL,6,5,1,1,5
basalt,1574,basalt,bxsclt,1,0,1,1,0
base,1576,base,bes,27,20,7,15,12
bash,1578,bash,b@S,24,21,3,14,10
bashful,1579,bashful,b@SfL,1,0,1,0,1
basil,1581,basil,b@zL,6,6,0,2,4
basin,1584,basin,besN,8,7,1,5,3
bask,1586,bask,b@sk,10,7,3,5,5
bass,1588,bass,b@s,23,18,5,10,13
basso,1590,basso,b@so,6,5,1,1,5
bast,1593,bast,b@st,18,15,3,14,4
baste,1595,baste,best,16,14,2,12,4
bat,1598,bat,b@t,40,33,7,25,15
batch,1599,batch,b@C,20,20,0,10,10
bath,1600,bath,b@T,17,17,0,7,10
bathe,1601,bathe,beD,10,9,1,1,9
baths,1605,baths,b@Dz,2,2,0,1,1
batman,1607,batman,b@tmxn,2,1,1,1,1
batsman,1610,batsman,b@tsmxn,1,0,1,0,1
batteau,1612,batteau,b@to,7,6,1,1,6
batten,1613,batten,b@tN,11,10,1,7,4
batter,1614,batter,b@tX,19,15,4,12,7
battery,1615,battery,b@tXi,1,0,1,0,1
batting,1616,batting,b@tIG,4,4,0,4,0
battle,1617,battle,b@tL,14,13,1,6,8
bauble,1618,bauble,bcbL,5,5,0,5,0
bawdy,1620,bawdy,bcdi,3,3,0,3,0
bay,1621,bay,be,35,22,13,17,18
bayou,1624,bayou,bYu,8,6,2,3,5
beach,1627,beach,biC,18,14,4,11,7
bead,1630,bead,bid,26,21,5,17,9
beadle,1631,beadle,bidL,6,5,1,2,4
beagle,1632,beagle,bigL,6,5,1,4,2
beak,1633,beak,bik,28,23,5,19,9
beaked,1634,beaked,bikt,5,3,2,1,4
beaker,1635,beaker,bikX,4,3,1,1,3
beam,1636,beam,bim,16,14,2,9,7
bean,1637,bean,bin,25,23,2,17,8
beanie,1638,beanie,bini,6,5,1,5,1
beard,1639,beard,bIrd,6,4,2,3,3
bearing,1640,bearing,b@rIG,4,3,1,4,0
beast,1642,beast,bist,13,11,2,11,2
beat,1643,beat,bit,33,26,7,22,11
beaten,1644,beaten,bitN,6,4,2,4,2
beau,1648,beau,bo,32,20,12,15,17
beauty,1654,beauty,byuti,3,0,3,2,1
beaux,1655,beaux,boz,18,17,1,10,8
beaver,1656,beaver,bivX,3,3,0,1,2
beck,1659,beck,bEk,19,19,0,14,5
become,1662,become,bxk^m,1,1,0,1,0
bed,1664,bed,bEd,25,21,4,19,6
bedew,1668,bedew,bidu,2,1,1,0,2
beef,1676,beef,bif,15,13,2,8,7
been,1678,been,bIn,27,25,2,19,8
beer,1679,beer,bIr,29,26,3,21,8
beetle,1681,beetle,bitL,6,5,1,2,4
beeves,1682,beeves,bivz,5,4,1,4,1
befall,1683,befall,bxfcl,2,2,0,0,2
befog,1685,befog,bxfcg,1,1,0,0,1
befoul,1687,befoul,bxfWl,2,1,1,1,1
beg,1690,beg,bEg,14,13,1,8,6
beggar,1692,beggar,bEgX,3,2,1,1,2
beige,1705,beige,beZ,9,8,1,0,9
being,1706,being,biIG,1,1,0,1,0
belch,1708,belch,bElC,6,5,1,1,5
belief,1714,belief,bxlif,2,2,0,0,2
believe,1715,believe,bxliv,2,2,0,0,2
bell,1717,bell,bEl,27,22,5,18,9
bellow,1724,bellow,bElo,12,10,2,8,4
belly,1726,belly,bEli,11,10,1,5,6
belong,1727,belong,bxlcG,1,0,1,1,0
belt,1728,belt,bElt,17,15,2,10,7
bench,1732,bench,bEnC,7,6,1,4,3
bend,1733,bend,bEnd,18,15,3,15,3
bent,1746,bent,bEnt,17,16,1,12,5
berber,1753,Berber,bRbX,2,2,0,0,2
beret,1755,beret,bXe,2,1,1,1,1
berg,1756,berg,bRg,13,11,2,5,8
berry,1759,berry,bEri,13,10,3,7,6
berth,1761,berth,bRT,16,14,2,9,7
beryl,1762,beryl,bErL,10,8,2,3,7
best,1770,best,bEst,23,20,3,20,3
bet,1774,bet,bEt,32,27,5,23,9
bethel,1776,bethel,bETL,4,3,1,1,3
better,1778,better,bEtX,8,7,1,6,2
bevel,1781,bevel,bEvL,7,7,0,3,4
bevy,1783,bevy,bEvi,5,5,0,2,3
beyond,1785,beyond,biand,2,1,1,2,0
bezel,1786,bezel,bEzL,4,4,0,1,3
bias,1789,bias,bYxs,1,1,0,1,0
bib,1790,bib,bIb,13,13,0,6,7
bible,1792,bible,bYbL,6,6,0,6,0
bicker,1800,bicker,bIkX,7,7,0,6,1
bicycle,1802,bicycle,bYsIkL,1,0,1,1,0
bid,1803,bid,bId,25,21,4,15,10
bidden,1804,bidden,bIdN,7,6,1,5,2
bide,1805,bide,bYd,23,19,4,17,6
big,1810,big,bIg,20,19,1,13,7
bight,1813,bight,bYt,28,25,3,23,5
bigot,1814,bigot,bIg|t,1,1,0,1,0
bike,1816,bike,bYk,19,18,1,14,5
bile,1819,bile,bYl,24,21,3,18,6
bilge,1820,bilge,bIlJ,8,7,1,1,7
bilk,1823,bilk,bIlk,11,9,2,4,7
bill,1824,bill,bIl,35,28,7,22,13
billet,1825,billet,bIl|t,5,4,1,4,1
billow,1831,billow,bIlo,11,9,2,5,6
billy,1832,billy,bIli,13,12,1,6,7
bind,1836,bind,bYnd,12,10,2,11,1
binge,1837,binge,bInJ,5,4,1,3,2
birch,1854,birch,bRC,15,14,1,8,7
bird,1855,bird,bRd,22,18,4,12,10
birdie,1856,birdie,bRdi,7,6,1,3,4
bison,1863,bison,bYsN,2,2,0,2,0
bisque,1864,bisque,bIsk,5,4,1,4,1
bit,1866,bit,bIt,35,30,5,25,10
bitch,1867,bitch,bIC,18,17,1,11,7
biting,1868,biting,bYtIG,2,2,0,2,0
bitten,1869,bitten,bItN,10,8,2,7,3
bitter,1870,bitter,bItX,10,7,3,5,5
bittern,1871,bittern,bItXn,2,1,1,0,2
bitters,1872,bitters,bItXz,3,2,1,1,2
blab,1877,blab,bl@b,5,4,1,2,3
black,1878,black,bl@k,10,7,3,6,4
bladder,1885,bladder,bl@dX,2,1,1,1,1
blade,1886,blade,bled,9,8,1,3,6
blain,1887,blain,blen,9,7,2,5,4
blame,1888,blame,blem,7,6,1,3,4
blanch,1889,blanch,bl@nC,3,3,0,2,1
bland,1891,bland,bl@nd,8,6,2,7,1
blank,1893,blank,bl@Gk,7,4,3,6,1
blare,1895,blare,blEr,7,5,2,4,3
blast,1900,blast,bl@st,3,1,2,3,0
blather,1902,blather,bl@DX,2,1,1,1,1
blaze,1903,blaze,blez,11,6,5,5,6
blazer,1904,blazer,blezX,2,1,1,0,2
blazon,1905,blazon,blezN,3,2,1,1,2
bleach,1906,bleach,bliC,7,5,2,3,4
bleak,1908,bleak,blik,10,7,3,5,5
blear,1909,blear,blIr,7,4,3,4,3
bleary,1910,bleary,blIri,2,0,2,1,1
bleat,1911,bleat,blit,14,12,2,7,7
bled,1912,bled,blEd,12,9,3,6,6
bleed,1913,bleed,blid,9,8,1,3,6
blench,1915,blench,blEnC,4,3,1,3,1
blend,1916,blend,blEnd,7,4,3,5,2
bless,1917,bless,blEs,6,4,2,1,5
blessed,1918,blessed,blEst,5,2,3,4,1
blew,1919,blew,blu,12,8,4,8,4
blight,1920,blight,blYt,12,10,2,7,5
blimp,1921,blimp,blImp,1,0,1,1,0
blind,1922,blind,blYnd,4,3,1,4,0
blink,1924,blink,blIGk,6,4,2,5,1
blinker,1925,blinker,blIGkX,2,1,1,1,1
blintz,1926,blintz,blInts,2,0,2,0,2
blintze,1927,blintze,blIntsx,1,0,1,0,1
bliss,1928,bliss,blIs,4,3,1,0,4
blister,1929,blister,blIstX,2,2,0,2,0
blithe,1930,blithe,blYT,1,1,0,0,1
blitz,1931,blitz,blIts,2,0,2,0,2
bloat,1934,bloat,blot,11,8,3,3,8
bloater,1935,bloater,blotX,2,1,1,1,1
blob,1936,blob,blab,8,6,2,3,5
bloc,1937,bloc,blak,9,7,2,4,5
blonde,1941,blonde,bland,5,4,1,5,0
blood,1942,blood,bl^d,7,6,1,2,5
bloom,1945,bloom,blum,11,7,4,8,3
blot,1949,blot,blat,14,11,3,6,8
blotch,1950,blotch,blaC,5,4,1,1,4
blotter,1951,blotter,blatX,2,1,1,1,1
blouse,1952,blouse,blWs,3,2,1,1,2
blow,1953,blow,blo,15,7,8,9,6
blown,1955,blown,blon,8,5,3,4,4
blowsy,1956,blowsy,blWzi,1,0,1,1,0
blowy,1958,blowy,bloi,3,2,1,0,3
blubber,1959,blubber,bl^bX,1,0,1,1,0
blues,1966,blues,bluz,6,3,3,3,3
bluff,1969,bluff,bl^f,5,3,2,3,2
blunder,1971,blunder,bl^ndX,1,1,0,1,0
blunt,1972,blunt,bl^nt,2,1,1,2,0
blur,1973,blur,blR,6,3,3,2,4
blurb,1974,blurb,blRb,4,3,1,0,4
blurt,1975,blurt,blRt,8,7,1,2,6
blush,1976,blush,bl^S,7,6,1,5,2
bluster,1977,bluster,bl^stX,4,3,1,4,0
boa,1978,boa,box,8,7,1,0,8
boar,1979,boar,bor,29,25,4,19,10
board,1980,board,bord,16,12,4,11,5
boast,1981,boast,bost,17,16,1,14,3
boat,1982,boat,bot,32,27,5,22,10
boatman,1984,boatman,botmxn,2,1,1,2,0
boatswain,1985,boatswain,bosN,3,3,0,2,1
bob,1986,bob,bab,22,18,4,13,9
bobbin,1987,bobbin,bab|n,2,2,0,2,0
bobble,1988,bobble,babL,12,11,1,9,3
bobby,1989,bobby,babi,11,10,1,5,6
boccie,1994,boccie,baCi,5,4,1,0,5
bock,1995,bock,bak,28,25,3,20,8
bode,1996,bode,bod,27,22,5,17,10
body,2001,body,badi,11,11,0,7,4
bog,2002,bog,bcg,13,13,0,9,4
bogie,2004,bogie,bUgi,3,3,0,2,1
bogus,2005,bogus,bog|s,1,1,0,1,0
boil,2007,boil,bOl,15,12,3,14,1
bold,2009,bold,bold,18,14,4,11,7
bole,2010,bole,bol,33,28,5,21,12
bolo,2015,bolo,bolo,9,7,2,5,4
bolster,2019,bolster,bolstX,2,2,0,2,0
bolt,2020,bolt,bolt,14,12,2,8,6
bomber,2027,bomber,bamX,3,2,1,1,2
bond,2032,bond,band,13,11,2,10,3
bone,2038,bone,bon,31,26,5,21,10
boner,2039,boner,bonX,4,3,1,2,2
bonnet,2044,bonnet,ban|t,1,1,0,1,0
bonnie,2045,bonnie,bani,7,7,0,3,4
bonus,2047,bonus,bon|s,2,1,1,2,0
boo,2048,boo,bu,34,25,9,20,14
booby,2049,booby,bubi,6,5,1,3,3
boodle,2050,boodle,budL,4,4,0,4,0
book,2051,book,bUk,18,17,1,16,2
booklet,2052,booklet,bUkl|t,1,0,1,1,0
boom,2053,boom,bum,18,15,3,12,6
boon,2056,boon,bun,22,21,1,16,6
boost,2058,boost,bust,9,8,1,8,1
boot,2059,boot,but,32,26,6,23,9
booth,2060,booth,buT,12,11,1,6,6
booths,2061,booths,buDz,2,1,1,1,1
bootie,2062,bootie,buti,7,3,4,3,4
booty,2065,booty,buti,7,3,4,3,4
booze,2066,booze,buz,18,13,5,11,7
border,2068,border,bordX,4,2,2,3,1
boreal,2069,boreal,boriL,2,1,1,2,0
born,2071,born,born,14,11,3,10,4
boron,2072,boron,boran,2,1,1,1,1
borough,2073,borough,bRo,11,9,2,3,8
borrow,2074,borrow,baro,9,8,1,3,6
bosh,2076,bosh,baS,10,10,0,4,6
boss,2079,boss,bcs,11,11,0,7,4
botch,2083,botch,baC,13,11,2,6,7
both,2084,both,boT,13,11,2,5,8
bother,2085,bother,baDX,3,3,0,2,1
bottle,2086,bottle,batL,8,7,1,5,3
bottom,2087,bottom,batM,2,1,1,0,2
bough,2090,bough,bW,20,16,4,9,11
bought,2091,bought,bct,25,23,2,21,4
boulder,2092,boulder,boldX,5,3,2,3,2
bounce,2094,bounce,bWns,4,3,1,3,1
bound,2095,bound,bWnd,14,13,1,13,1
bounty,2100,bounty,bWnti,1,1,0,1,0
bouquet,2101,bouquet,boke,1,0,1,1,0
bourbon,2102,bourbon,bRb|n,4,3,1,4,0
bout,2106,bout,bWt,23,20,3,20,3
boutique,2107,boutique,butik,2,0,2,0,2
bowel,2111,bowel,bWL,7,6,1,4,3
bower,2112,bower,bWX,8,7,1,5,3
bowler,2114,bowler,bolX,11,9,2,5,6
bowman,2115,bowman,bomxn,5,3,2,5,0
box,2118,box,baks,5,3,2,4,1
boy,2119,boy,bO,13,11,2,5,8
bra,2121,bra,bra,3,3,0,0,3
brace,2122,brace,bres,13,10,3,5,8
bracket,2124,bracket,br@k|t,2,0,2,1,1
bract,2126,bract,br@kt,3,1,2,1,2
brad,2127,brad,br@d,13,11,2,1,12
brae,2128,brae,bre,19,10,9,8,11
brag,2129,brag,br@g,11,9,2,4,7
braid,2133,braid,bred,18,15,3,5,13
braille,2134,braille,brel,14,11,3,5,9
brain,2135,brain,bren,19,16,3,8,11
braise,2136,braise,brez,18,14,4,7,11
brake,2137,brake,brek,13,10,3,3,10
bramble,2138,bramble,br@mbL,1,0,1,1,0
bran,2139,bran,br@n,13,9,4,2,11
branch,2140,branch,br@nC,5,3,2,3,2
brand,2141,brand,br@nd,8,3,5,4,4
brandy,2143,brandy,br@ndi,3,1,2,2,1
brash,2144,brash,br@S,11,9,2,5,6
brass,2145,brass,br@s,10,8,2,4,6
brat,2147,brat,br@t,11,8,3,2,9
brave,2149,brave,brev,10,8,2,3,7
brawl,2153,brawl,brcl,11,10,1,5,6
brawn,2154,brawn,brcn,10,10,0,2,8
brazen,2155,brazen,brezN,3,1,2,2,1
breach,2158,breach,briC,10,8,2,4,6
bread,2159,bread,brEd,15,12,3,7,8
breadth,2160,breadth,brEdT,2,0,2,0,2
bream,2167,bream,brIm,10,9,1,4,6
breast,2168,breast,brEst,6,3,3,6,0
breath,2171,breath,brET,3,2,1,0,3
breathe,2172,breathe,briD,6,5,1,1,5
breed,2174,breed,brid,16,14,2,5,11
breeze,2175,breeze,briz,9,9,0,1,8
brew,2181,brew,bru,17,11,6,9,8
briar,2182,briar,brYX,8,8,0,4,4
bribe,2183,bribe,brYb,5,5,0,1,4
brick,2184,brick,brIk,13,10,3,4,9
bridal,2185,bridal,brYdL,1,0,1,0,1
bride,2186,bride,brYd,15,12,3,4,11
bridge,2188,bridge,brIJ,6,4,2,2,4
brief,2189,brief,brif,8,6,2,3,5
brig,2190,brig,brIg,10,8,2,4,6
bright,2194,bright,brYt,14,11,3,6,8
brighten,2195,brighten,brYtN,2,1,1,1,1
brine,2200,brine,brYn,10,10,0,2,8
bring,2201,bring,brIG,8,5,3,3,5
brink,2202,brink,brIGk,8,5,3,5,3
brio,2203,brio,brio,7,6,1,1,6
brioche,2204,brioche,brioS,1,0,1,0,1
brisk,2206,brisk,brIsk,7,4,3,4,3
bristle,2208,bristle,brIsL,3,3,0,1,2
briton,2212,Briton,brItN,4,2,2,3,1
brittle,2213,brittle,brItL,3,3,0,1,2
broach,2214,broach,broC,5,4,1,1,4
broad,2215,broad,brcd,13,11,2,2,11
broaden,2216,broaden,brcdN,1,0,1,0,1
brogue,2223,brogue,brog,7,6,1,2,5
broil,2225,broil,brOl,3,2,1,1,2
broke,2226,broke,brok,9,8,1,2,7
broker,2229,broker,brokX,1,0,1,0,1
brood,2237,brood,brud,14,12,2,4,10
brook,2238,brook,brUk,6,4,2,3,3
broom,2239,broom,brum,10,7,3,4,6
broth,2240,broth,brcT,8,7,1,3,5
brougham,2243,brougham,brom,7,6,1,2,5
brought,2244,brought,brct,10,8,2,3,7
brow,2246,brow,brW,7,4,3,1,6
brown,2247,brown,brWn,10,8,2,3,7
brownie,2248,brownie,brWni,1,0,1,0,1
browse,2250,browse,brWz,8,6,2,3,5
bruise,2252,bruise,bruz,10,8,2,3,7
bruit,2253,bruit,brut,12,8,4,4,8
brunch,2254,brunch,br^nC,4,3,1,3,1
brunt,2256,brunt,br^nt,6,4,2,5,1
brush,2257,brush,br^S,5,4,1,4,1
brusque,2258,brusque,br^sk,2,1,1,2,0
brutal,2259,brutal,brutL,3,1,2,1,2
brutally,2261,brutally,brutLi,1,0,1,0,1
bubble,2262,bubble,b^bL,10,10,0,8,2
buck,2265,buck,b^k,29,26,3,16,13
buckle,2267,buckle,b^kL,6,5,1,3,3
buckler,2268,buckler,b^klX,1,1,0,1,0
bud,2272,bud,b^d,23,21,2,12,11
buddy,2275,buddy,b^di,6,5,1,4,2
budge,2276,budge,b^J,15,14,1,4,11
buff,2279,buff,b^f,20,18,2,9,11
buffer,2281,buffer,b^fX,4,3,1,2,2
bug,2284,bug,b^g,26,25,1,15,11
buggy,2287,buggy,b^gi,5,4,1,3,2
build,2289,build,bIld,11,9,2,3,8
built,2290,built,bIlt,18,15,3,10,8
bulb,2291,bulb,b^lb,2,2,0,0,2
bulge,2295,bulge,b^lJ,4,3,1,1,3
bulk,2296,bulk,b^lk,7,6,1,3,4
bull,2298,bull,bUl,13,12,1,10,3
bullet,2299,bullet,bUl|t,5,3,2,4,1
bulletin,2300,bulletin,bUl|tN,1,0,1,0,1
bully,2304,bully,bUli,8,7,1,6,2
bum,2307,bum,b^m,24,23,1,13,11
bump,2309,bump,b^mp,9,8,1,8,1
bun,2312,bun,b^n,30,28,2,18,12
bunch,2313,bunch,b^nC,8,6,2,6,2
bung,2316,bung,b^G,19,18,1,8,11
bungle,2319,bungle,bEGgL,1,1,0,1,0
bunk,2321,bunk,b^Gk,14,10,4,9,5
bunker,2322,bunker,b^GkX,4,3,1,2,2
bunko,2323,bunko,b^Gko,3,2,1,1,2
bunt,2324,bunt,b^nt,12,8,4,8,4
buoy,2326,buoy,bui,11,6,5,1,10
bur,2328,bur,bR,22,14,8,8,14
burden,2329,burden,bRdN,4,3,1,2,2
burgee,2335,burgee,bRJi,2,2,0,0,2
burgeon,2336,burgeon,bRJ|n,4,4,0,3,1
burgess,2337,burgess,bRJ|s,1,1,0,0,1
burgher,2338,burgher,bRgX,4,3,1,1,3
burial,2344,burial,bEriL,3,1,2,1,2
burly,2347,burly,bRli,7,6,1,5,2
burn,2349,burn,bRn,22,18,4,13,9
burned,2350,burned,bRnd,9,7,2,6,3
burnt,2353,burnt,bRnt,5,4,1,2,3
burp,2354,burp,bRp,8,7,1,1,7
bursa,2355,bursa,bRsx,2,2,0,0,2
bursar,2356,bursar,bRsX,6,6,0,2,4
burst,2358,burst,bRst,15,14,1,12,3
bus,2359,bus,b^s,20,17,3,8,12
bush,2362,bush,bUS,6,5,1,3,3
bushel,2363,bushel,bUSL,1,0,1,0,1
bust,2369,bust,b^st,17,15,2,13,4
bustle,2370,bustle,b^sL,9,8,1,5,4
busy,2371,busy,bIzi,2,2,0,1,1
but,2373,but,b^t,35,30,5,21,14
butler,2375,butler,b^tlX,2,1,1,1,1
butte,2376,butte,byut,5,3,2,4,1
butter,2377,butter,b^tX,13,10,3,9,4
button,2382,button,b^tN,6,5,1,4,2
buy,2385,buy,bY,29,23,6,17,12
buzz,2386,buzz,b^z,15,15,0,5,10
byelaw,2388,byelaw,bYlc,1,0,1,0,1
c,2391,c,si,40,25,15,19,21
cab,2392,cab,k@b,22,19,3,11,11
cabbie,2397,cabbie,k@bi,12,9,3,5,7
cabin,2398,cabin,k@b|n,1,1,0,1,0
cable,2400,cable,kebL,8,7,1,8,0
cache,2406,cache,k@S,25,19,6,12,13
cachet,2407,cachet,k@Se,5,4,1,1,4
cackle,2408,cackle,k@kL,12,11,1,6,6
cad,2411,cad,k@d,30,26,4,18,12
caddy,2414,caddy,k@di,12,9,3,3,9
cadge,2418,cadge,k@J,13,13,0,3,10
cadre,2420,cadre,k@dri,2,0,2,1,1
caesar,2422,Caesar,sizX,4,3,1,0,4
cafe,2424,cafe,k@fe,2,1,1,0,2
cage,2428,cage,keJ,17,15,2,8,9
cairn,2430,cairn,kErn,4,2,2,2,2
cake,2435,cake,kek,26,23,3,17,9
calf,2453,calf,k@f,19,17,2,8,11
calk,2462,calk,kck,17,15,2,12,5
call,2463,call,kcl,26,23,3,21,5
calla,2464,calla,k@lx,7,4,3,3,4
calling,2466,calling,kclIG,3,2,1,3,0
callous,2470,callous,k@lxs,5,4,1,4,1
callow,2471,callow,k@lo,9,8,1,8,1
callus,2472,callus,k@lxs,5,4,1,4,1
calm,2473,calm,kam,17,15,2,8,9
calomel,2474,calomel,k@lxmL,1,1,0,1,0
calorie,2476,calorie,k@lXi,3,3,0,3,0
calve,2483,calve,k@v,17,15,2,5,12
calves,2484,calves,k@vz,4,3,1,2,2
cam,2489,cam,k@m,27,22,5,15,12
camber,2491,camber,k@mbX,5,3,2,4,1
came,2494,came,kem,24,21,3,15,9
camel,2495,camel,k@mL,8,7,1,1,7
camp,2502,camp,k@mp,12,7,5,9,3
camphor,2505,camphor,k@mfX,1,1,0,0,1
can,2510,can,k@n,35,27,8,21,14
cancel,2520,cancel,k@nsL,9,8,1,6,3
cancer,2522,cancer,k@nsX,6,4,2,2,4
candid,2526,candid,k@nd|d,2,2,0,1,1
candied,2529,candied,k@ndid,2,1,1,0,2
candle,2530,candle,k@ndL,11,9,2,6,5
candor,2532,candor,k@ndX,10,8,2,4,6
candy,2533,candy,k@ndi,10,6,4,3,7
cane,2534,cane,ken,33,30,3,24,9
canker,2537,canker,k@GkX,5,4,1,5,0
canned,2538,canned,k@nd,16,10,6,8,8
canner,2539,canner,k@nX,11,6,5,3,8
cannery,2540,cannery,k@nXi,4,2,2,1,3
cannon,2544,cannon,k@n|n,2,2,0,2,0
cannot,2548,cannot,k@nat,1,0,1,0,1
canny,2549,canny,k@ni,14,10,4,2,12
canoe,2550,canoe,kxnu,2,1,1,1,1
cant,2554,cant,k@nt,18,9,9,7,11
canter,2560,canter,k@ntX,11,9,2,4,7
cantle,2563,cantle,k@ntL,9,6,3,2,7
canto,2564,canto,k@nto,5,4,1,1,4
canton,2565,canton,k@ntN,5,3,2,0,5
cantonal,2566,cantonal,k@ntNL,2,0,2,0,2
cap,2571,cap,k@p,30,28,2,19,11
cape,2579,cape,kep,26,21,5,15,11
caper,2580,caper,kepX,9,8,1,6,3
capsular,2601,capsular,k@psLX,1,0,1,0,1
capsule,2602,capsule,k@psL,3,1,2,2,1
captor,2611,captor,k@ptX,4,4,0,3,1
capture,2612,capture,k@pCX,2,2,0,1,1
car,2614,car,kar,24,18,6,12,12
carafe,2618,carafe,kX@f,4,3,1,2,2
caramel,2619,caramel,k@rxmL,2,2,0,1,1
carat,2621,carat,k@rxt,3,2,1,3,0
card,2638,card,kard,15,13,2,10,5
cardinal,2641,cardinal,kardnL,1,0,1,0,1
care,2643,care,kEr,23,19,4,18,5
careen,2644,careen,kXin,8,6,2,6,2
career,2645,career,kXIr,2,2,0,2,0
caress,2647,caress,kXEs,1,1,0,1,0
caries,2653,caries,k@riz,3,2,1,1,2
carmine,2658,carmine,karmxn,2,0,2,1,1
carnage,2659,carnage,karnIJ,1,1,0,0,1
carnal,2660,carnal,karnL,5,3,2,2,3
carnally,2662,carnally,karnLi,1,0,1,0,1
carol,2670,carol,k@rL,10,10,0,3,7
carom,2671,carom,k@rM,5,4,1,2,3
carp,2676,carp,karp,8,5,3,2,6
carpel,2677,carpel,karpL,2,1,1,0,2
carrier,2683,carrier,k@riX,5,4,1,3,2
carrion,2684,carrion,k@rixn,2,0,2,2,0
carry,2685,carry,k@ri,19,15,4,9,10
cart,2686,cart,kart,14,10,4,8,6
cartage,2687,cartage,kartIJ,4,1,3,1,3
cartilage,2689,cartilage,kartLIJ,2,1,1,0,2
carton,2692,carton,kartN,5,3,2,4,1
cartridge,2694,cartridge,kartrIJ,3,2,1,1,2
carve,2696,carve,karv,4,3,1,0,4
case,2701,case,kes,22,19,3,12,10
cashew,2704,cashew,k@Su,3,2,1,0,3
cask,2709,cask,k@sk,7,5,2,4,3
cassia,2714,cassia,k@Sx,4,3,1,0,4
cassock,2715,cassock,k@sxk,2,1,1,1,1
cast,2716,cast,k@st,13,11,2,8,5
castle,2723,castle,k@sL,15,12,3,7,8
castled,2724,castled,k@sLd,1,0,1,0,1
castor,2725,castor,k@stX,6,4,2,5,1
cat,2732,cat,k@t,35,30,5,21,14
catch,2750,catch,k@C,20,19,1,9,11
catchy,2751,catchy,k@Ci,7,6,1,0,7
cater,2756,cater,ketX,6,5,1,5,1
cattle,2772,cattle,k@tL,14,12,2,7,7
catty,2773,catty,k@ti,14,13,1,6,8
caudal,2778,caudal,kcdL,6,6,0,4,2
caught,2779,caught,kct,23,20,3,17,6
causal,2781,causal,kczL,4,2,2,0,4
causally,2783,causally,kczLi,1,0,1,0,1
cause,2786,cause,kcz,10,7,3,4,6
cave,2797,cave,kev,22,19,3,12,10
cavil,2801,cavil,k@vL,9,8,1,2,7
cavy,2804,cavy,kevi,5,4,1,3,2
caw,2805,caw,kc,23,16,7,11,12
cay,2806,cay,ki,29,23,6,19,10
cease,2808,cease,sis,18,16,2,6,12
cecum,2809,cecum,sikM,1,0,1,0,1
cedar,2810,cedar,sidX,6,5,1,3,3
cede,2811,cede,sid,27,22,5,15,12
ceiling,2812,ceiling,silIG,2,1,1,2,0
celery,2819,celery,sElXi,2,1,1,1,1
cell,2822,cell,sEl,26,19,7,19,7
cellar,2823,cellar,sElX,10,6,4,3,7
cello,2826,cello,CElo,5,5,0,5,0
celt,2831,celt,sElt,18,14,4,12,6
censer,2839,censer,sEnsX,4,2,2,0,4
censure,2843,censure,sEnCX,5,4,1,2,3
cent,2845,cent,sEnt,22,16,6,13,9
center,2851,center,sEntX,9,5,4,5,4
century,2867,century,sEnCXi,2,1,1,0,2
certain,2882,certain,sRtN,4,4,0,3,1
chablis,2893,Chablis,S@bli,2,0,2,1,1
chafe,2894,chafe,Cef,7,6,1,4,3
chafer,2895,chafer,CefX,4,3,1,2,2
chaff,2896,chaff,C@f,9,8,1,6,3
chaffer,2897,chaffer,C@fX,4,3,1,2,2
chain,2900,chain,Cen,19,18,1,16,3
chair,2901,chair,CEr,20,18,2,17,3
chaise,2902,chaise,Sez,14,14,0,8,6
chalet,2904,chalet,S@le,4,3,1,1,3
chalice,2905,chalice,C@lxs,5,5,0,5,0
chalk,2906,chalk,Cck,13,12,1,13,0
challis,2909,challis,S@li,13,10,3,8,5
chamois,2914,chamois,S@mi,5,4,1,2,3
champ,2916,champ,C@mp,9,8,1,8,1
chance,2919,chance,C@ns,9,7,2,4,5
chancel,2920,chancel,C@nsL,6,3,3,2,4
chancellor,2921,chancellor,C@nsLX,2,0,2,0,2
chancellory,2922,chancellory,C@nsLXi,1,0,1,0,1
chancy,2924,chancy,C@nsi,4,2,2,2,2
change,2927,change,CenJ,3,2,1,2,1
channel,2929,channel,C@nL,6,5,1,1,5
chant,2932,chant,C@nt,8,6,2,5,3
chantry,2934,chantry,C@ntri,2,2,0,2,0
chanty,2935,chanty,S@nti,2,1,1,2,0
chaos,2936,chaos,keas,1,0,1,0,1
chap,2938,chap,C@p,20,17,3,15,5
chapel,2940,chapel,C@pL,6,4,2,2,4
chaps,2946,chaps,C@ps,7,5,2,4,3
chapter,2947,chapter,C@ptX,2,1,1,2,0
char,2948,char,Car,19,14,5,12,7
chard,2957,chard,Card,13,12,1,9,4
charge,2958,charge,CarJ,8,6,2,3,5
charger,2959,charger,CarJX,2,1,1,0,2
charm,2966,charm,Carm,7,5,2,3,4
charnel,2967,charnel,CarnL,2,2,0,2,0
chart,2968,chart,Cart,12,9,3,7,5
charter,2969,charter,CartX,6,5,1,4,2
chary,2972,chary,C@ri,12,11,1,10,2
chase,2973,chase,Ces,17,13,4,12,5
chaser,2974,chaser,CesX,5,4,1,1,4
chasm,2975,chasm,k@zM,1,1,0,0,1
chassis,2976,chassis,C@si,4,3,1,2,2
chaste,2977,chaste,Cest,9,8,1,6,3
chasten,2978,chasten,CesN,6,5,1,3,3
chat,2982,chat,C@t,22,17,5,16,6
chateau,2983,chateau,S@to,4,4,0,1,3
chattel,2985,chattel,C@tL,9,8,1,4,5
chatter,2986,chatter,C@tX,13,10,3,9,4
chatty,2988,chatty,C@ti,9,8,1,4,5
chauffeur,2989,chauffeur,SofX,1,1,0,1,0
chaunt,2990,chaunt,Ccnt,8,8,0,8,0
cheap,2993,cheap,Cip,18,18,0,14,4
cheat,2996,cheat,Cit,17,16,1,13,4
check,2997,check,CEk,15,14,1,12,3
checker,2998,checker,CEkX,3,1,2,0,3
checkers,2999,checkers,CEkXz,1,0,1,0,1
cheddar,3004,cheddar,CEdX,2,2,0,1,1
cheek,3005,cheek,Cik,21,19,2,16,5
cheeky,3006,cheeky,Ciki,1,0,1,0,1
cheer,3007,cheer,CIr,27,25,2,20,7
cheery,3009,cheery,CIri,8,6,2,7,1
cheese,3010,cheese,Ciz,13,12,1,9,4
chef,3011,chef,SEf,8,6,2,4,4
chela,3012,chela,kilx,4,3,1,2,2
chenille,3019,chenille,Sxnil,1,0,1,1,0
cherish,3020,cherish,CErIS,1,1,0,1,0
cherry,3022,cherry,CEri,10,8,2,9,1
chert,3023,chert,CRt,14,14,0,10,4
chess,3026,chess,CEs,11,9,2,8,3
chest,3027,chest,CEst,13,12,1,12,1
chew,3033,chew,Cu,20,19,1,18,2
chic,3037,chic,Sik,24,21,3,17,7
chick,3039,chick,CIk,23,22,1,16,7
chid,3044,chid,CId,16,14,2,9,7
chidden,3045,chidden,CIdN,5,4,1,4,1
chide,3046,chide,CYd,12,11,1,9,3
chiding,3048,chiding,CYdIG,3,3,0,3,0
chief,3049,chief,Cif,12,12,0,8,4
chigger,3053,chigger,CIgX,4,4,0,3,1
child,3056,child,CYld,4,3,1,3,1
chill,3061,chill,CIl,22,21,1,16,6
chime,3063,chime,CYm,8,8,0,6,2
chimp,3065,chimp,CImp,6,4,2,5,1
chin,3067,chin,CIn,21,20,1,15,6
china,3068,china,CYnx,1,1,0,1,0
chink,3071,chink,CIGk,12,10,2,11,1
chip,3074,chip,CIp,24,22,2,16,8
chipper,3076,chipper,CIpX,6,5,1,4,2
chirp,3081,chirp,CRp,9,9,0,5,4
chisel,3082,chisel,CIzL,2,2,0,2,0
chit,3083,chit,CIt,22,21,1,16,6
chive,3088,chive,CYv,8,8,0,6,2
chloral,3089,chloral,klorL,1,0,1,1,0
chock,3096,chock,Cak,20,20,0,17,3
choice,3098,choice,COs,3,3,0,3,0
choir,3099,choir,kwYX,3,3,0,1,2
choke,3100,choke,Cok,17,16,1,15,2
choler,3101,choler,kalX,13,8,5,4,9
cholera,3102,cholera,kalXx,2,1,1,0,2
chon,3105,chon,Can,10,10,0,7,3
choose,3106,choose,Cuz,10,7,3,8,2
choosey,3107,choosey,Cuzi,4,2,2,3,1
chop,3108,chop,Cap,18,16,2,13,5
choppy,3109,choppy,Capi,4,3,1,2,2
chops,3110,chops,Caps,5,4,1,3,2
choral,3112,choral,korL,12,7,5,4,8
chord,3113,chord,kord,19,15,4,10,9
chore,3114,chore,Cor,21,20,1,19,2
chortle,3118,chortle,CortL,2,2,0,2,0
chorus,3119,chorus,kor|s,4,2,2,1,3
chose,3120,chose,Coz,12,11,1,9,3
chosen,3121,chosen,CozN,1,0,1,0,1
chow,3122,chow,CW,10,10,0,9,1
chowder,3123,chowder,CWdX,2,2,0,2,0
chrism,3124,chrism,krIzM,1,1,0,1,0
christ,3125,Christ,krYst,2,2,0,2,0
christen,3126,christen,krIsN,1,1,0,0,1
chrome,3133,chrome,krom,11,7,4,3,8
chromo,3135,chromo,kromo,1,0,1,0,1
chronic,3137,chronic,kranIk,3,1,2,2,1
chronicle,3138,chronicle,kranIkL,1,0,1,0,1
chub,3147,chub,C^b,12,11,1,8,4
chubby,3148,chubby,C^bi,2,1,1,0,2
chuck,3149,chuck,C^k,20,17,3,14,6
chuckle,3150,chuckle,C^kL,5,4,1,3,2
chug,3151,chug,C^g,13,13,0,10,3
chukka,3152,chukka,C^kx,4,3,1,2,2
chum,3153,chum,C^m,16,14,2,11,5
chummy,3154,chummy,C^mi,7,6,1,4,3
chump,3155,chump,C^mp,12,11,1,10,2
chunk,3156,chunk,C^Gk,10,9,1,9,1
church,3157,church,CRC,8,8,0,4,4
churl,3158,churl,CRl,11,10,1,7,4
churn,3159,churn,CRn,13,12,1,9,4
chute,3160,chute,Sut,17,16,1,16,1
cider,3166,cider,sYdX,8,5,3,5,3
cinch,3169,cinch,sInC,8,6,2,5,3
cinder,3172,cinder,sIndX,3,3,0,3,0
cipher,3178,cipher,sYfX,3,3,0,2,1
circa,3179,circa,sRkx,1,1,0,0,1
circle,3180,circle,sRkL,5,5,0,3,2
circlet,3181,circlet,sRkl|t,1,0,1,0,1
circuit,3182,circuit,sRk|t,3,2,1,1,2
circus,3205,circus,sRk|s,1,1,0,0,1
cistern,3207,cistern,sIstXn,1,0,1,0,1
cite,3210,cite,sYt,28,24,4,22,6
city,3216,city,sIti,7,6,1,5,2
civet,3217,civet,sIvxt,3,3,0,3,0
civic,3218,civic,sIvIk,1,1,0,1,0
civil,3219,civil,sIvL,7,4,3,3,4
clack,3224,clack,kl@k,23,20,3,9,14
clad,3225,clad,kl@d,13,11,2,4,9
claim,3226,claim,klem,8,4,4,5,3
clam,3229,clam,kl@m,16,11,5,4,12
clamber,3230,clamber,kl@mbX,2,0,2,1,1
clammy,3231,clammy,kl@mi,3,2,1,0,3
clamor,3232,clamor,kl@mX,8,6,2,1,7
clamp,3233,clamp,kl@mp,9,5,4,4,5
clan,3234,clan,kl@n,12,11,1,3,9
clang,3236,clang,kl@G,12,10,2,1,11
clangor,3237,clangor,kl@GX,5,4,1,0,5
clank,3238,clank,kl@Gk,9,6,3,6,3
clap,3239,clap,kl@p,16,11,5,4,12
clapper,3241,clapper,kl@pX,4,3,1,0,4
claret,3243,claret,kl@rxt,2,0,2,1,1
clarion,3247,clarion,kl@rixn,1,0,1,1,0
clarity,3248,clarity,kl@rxti,1,0,1,0,1
clash,3249,clash,kl@S,14,12,2,6,8
clasp,3250,clasp,kl@sp,3,1,2,0,3
class,3251,class,kl@s,12,10,2,3,9
clatter,3258,clatter,kl@tX,6,5,1,3,3
clause,3259,clause,klcz,4,2,2,1,3
claw,3264,claw,klc,9,5,4,3,6
clay,3265,clay,kle,10,7,3,6,4
clean,3266,clean,klin,11,8,3,6,5
cleanse,3268,cleanse,klEnz,2,1,1,1,1
clear,3269,clear,klIr,9,8,1,5,4
cleat,3273,cleat,klit,11,10,1,6,5
cleave,3275,cleave,kliv,6,5,1,2,4
clef,3276,clef,klEf,3,1,2,1,2
cleft,3277,cleft,klEft,2,0,2,1,1
clench,3280,clench,klEnC,4,4,0,3,1
clerk,3284,clerk,klRk,8,7,1,2,6
clever,3285,clever,klEvX,2,1,1,2,0
clew,3286,clew,klu,12,9,3,9,3
click,3288,click,klIk,19,14,5,8,11
cliff,3291,cliff,klIf,5,5,0,0,5
climb,3296,climb,klYm,5,4,1,3,2
clinch,3297,clinch,klInC,3,2,1,3,0
cling,3298,cling,klIG,14,8,6,7,7
clink,3301,clink,klIGk,8,3,5,5,3
clinker,3302,clinker,klIGkX,2,1,1,1,1
clip,3303,clip,klIp,11,9,2,5,6
clique,3305,clique,klik,13,12,1,4,9
cloak,3306,cloak,klok,13,12,1,2,11
cloche,3307,cloche,kloS,6,6,0,0,6
clock,3308,clock,klak,15,13,2,5,10
clod,3309,clod,klad,9,8,1,3,6
clog,3310,clog,klag,6,5,1,2,4
cloister,3312,cloister,klOstX,1,1,0,1,0
clop,3313,clop,klap,12,10,2,6,6
close,3314,close,klos,6,6,0,0,6
closure,3317,closure,kloZX,3,3,0,1,2
clot,3318,clot,klat,12,10,2,6,6
cloth,3319,cloth,klcT,3,2,1,1,2
clothe,3320,clothe,kloD,6,5,1,1,5
clothes,3321,clothes,kloz,7,7,0,1,6
cloture,3324,cloture,kloCX,2,2,0,0,2
cloud,3325,cloud,klWd,7,6,1,3,4
clout,3326,clout,klWt,7,6,1,3,4
clove,3327,clove,klov,8,6,2,1,7
clover,3329,clover,klovX,4,3,1,1,3
clown,3330,clown,klWn,5,5,0,1,4
cloy,3331,cloy,klO,6,5,1,3,3
club,3332,club,kl^b,4,3,1,1,3
cluck,3333,cluck,kl^k,11,10,1,2,9
clump,3334,clump,kl^mp,4,3,1,4,0
clung,3336,clung,kl^G,8,7,1,3,5
cluster,3337,cluster,kl^stX,5,3,2,4,1
clutch,3338,clutch,kl^C,4,4,0,1,3
clutter,3339,clutter,kl^tX,4,2,2,3,1
coach,3340,coach,koC,14,14,0,5,9
coal,3343,coal,kol,35,32,3,23,12
coarse,3348,coarse,kors,16,12,4,5,11
coarsen,3349,coarsen,korsN,2,1,1,0,2
coast,3350,coast,kost,12,11,1,9,3
coat,3352,coat,kot,31,26,5,19,12
coax,3354,coax,koks,6,5,1,1,5
cob,3356,cob,kab,22,21,1,13,9
cobble,3358,cobble,kabL,8,7,1,5,3
cobbler,3359,cobbler,kablX,2,1,1,1,1
coca,3363,coca,kokx,6,5,1,0,6
cock,3367,cock,kak,30,24,6,18,12
cockeye,3374,cockeye,kakY,3,2,1,0,3
cockle,3375,cockle,kakL,6,5,1,1,5
cockney,3376,cockney,kakni,1,0,1,0,1
cocky,3377,cocky,kaki,11,9,2,5,6
coco,3378,coco,koko,3,2,1,0,3
cod,3381,cod,kad,27,22,5,17,10
coda,3382,coda,kodx,5,4,1,1,4
coddle,3383,coddle,kadL,10,9,1,7,3
code,3384,code,kod,28,23,5,16,12
codger,3388,codger,kaJX,6,5,1,2,4
coerce,3398,coerce,koRs,3,2,1,1,2
coffee,3402,coffee,kcfi,2,1,1,0,2
coffer,3403,coffer,kcfX,3,1,2,1,2
cog,3405,cog,kag,12,11,1,4,8
coheir,3417,coheir,koEr,2,0,2,1,1
coif,3420,coif,kOf,6,5,1,3,3
coiffeur,3421,coiffeur,kwafR,1,0,1,0,1
coil,3423,coil,kOl,18,16,2,15,3
coin,3424,coin,kOn,14,13,1,11,3
coke,3429,coke,kok,29,22,7,16,13
cola,3430,cola,kolx,9,7,2,3,6
cold,3432,cold,kold,15,11,4,10,5
colic,3434,colic,kalIk,6,5,1,5,1
collapse,3438,collapse,kxl@ps,1,0,1,1,0
collard,3439,collard,kalXd,4,3,1,1,3
collate,3440,collate,kolet,1,0,1,0,1
colleague,3443,colleague,kalig,2,1,1,0,2
collect,3444,collect,kxlEkt,3,2,1,3,0
colleen,3447,colleen,kalin,3,1,2,1,2
college,3448,college,kalIJ,3,3,0,2,1
collide,3451,collide,kxlYd,1,0,1,1,0
collie,3452,collie,kali,12,10,2,6,6
collier,3453,collier,kalyX,1,0,1,0,1
colloid,3456,colloid,kalOd,1,1,0,0,1
cologne,3462,cologne,kxlon,1,0,1,1,0
colonel,3464,colonel,kRnL,5,5,0,3,2
color,3471,color,k^lX,8,4,4,2,6
colored,3474,colored,k^lXd,4,3,1,3,1
colt,3479,colt,kolt,16,13,3,9,7
column,3481,column,kalM,2,2,0,0,2
coma,3484,coma,komx,6,5,1,1,5
comb,3485,comb,kom,24,20,4,13,11
comber,3489,comber,komX,3,2,1,0,3
come,3495,come,k^m,22,20,2,16,6
comedy,3499,comedy,kamxdi,1,1,0,0,1
comet,3502,comet,kamxt,4,2,2,1,3
comic,3508,comic,kamIk,3,2,1,3,0
comity,3510,comity,kamxti,2,1,1,0,2
comma,3511,comma,kamx,8,3,5,4,4
command,3512,command,kxm@nd,4,2,2,1,3
commander,3515,commander,kxm@ndX,2,1,1,0,2
commando,3517,commando,kxm@ndo,2,1,1,0,2
commence,3519,commence,kxmEns,1,1,0,0,1
commend,3520,commend,kxmEnd,3,2,1,1,2
common,3539,common,kamxn,3,1,2,1,2
con,3613,con,kan,22,21,1,14,8
conch,3634,conch,kaGk,4,1,3,1,3
conchs,3636,conchs,kaGks,2,1,1,0,2
condor,3670,condor,kandX,5,5,0,4,1
cone,3677,cone,kon,35,30,5,24,11
coney,3679,coney,koni,7,4,3,4,3
conic,3731,conic,kanIk,6,5,1,6,0
conjure,3742,conjure,kanJX,2,1,1,0,2
connect,3743,connect,kxnEkt,1,1,0,1,0
conquer,3751,conquer,kaGkX,3,2,1,1,2
consul,3806,consul,kansL,3,3,0,3,0
coo,3913,coo,ku,31,24,7,19,12
cook,3914,cook,kUk,15,13,2,13,2
cookery,3915,cookery,kUkXi,1,0,1,0,1
cooky,3916,cooky,kUki,5,3,2,3,2
cool,3917,cool,kul,22,18,4,17,5
coolie,3919,coolie,kuli,5,4,1,3,2
coon,3920,coon,kun,23,21,2,19,4
coop,3921,coop,kup,20,15,5,14,6
cooper,3922,cooper,kupX,6,5,1,3,3
coot,3926,coot,kut,24,21,3,19,5
cootie,3927,cootie,kuti,7,6,1,5,2
cop,3928,cop,kap,30,24,6,18,12
cope,3930,cope,kop,25,23,2,16,9
copper,3934,copper,kapX,9,8,1,3,6
coppice,3937,coppice,kapxs,1,0,1,0,1
copse,3939,copse,kaps,6,4,2,2,4
copy,3943,copy,kapi,8,7,1,3,5
coracle,3946,coracle,kcrxkL,3,2,1,2,1
coral,3947,coral,kcrL,9,7,2,7,2
corbel,3948,corbel,korbL,3,2,1,1,2
cordial,3949,cordial,korJL,3,1,2,0,3
cordially,3951,cordially,korJLi,1,0,1,0,1
cordon,3954,cordon,kordN,3,2,1,1,2
core,3958,core,kor,36,26,10,20,16
cork,3960,cork,kork,11,9,2,4,7
corn,3962,corn,korn,20,14,6,11,9
cornea,3963,cornea,kornix,1,0,1,0,1
corner,3964,corner,kornX,2,1,1,0,2
cornice,3967,cornice,korn|s,1,0,1,0,1
corny,3970,corny,korni,4,1,3,0,4
corolla,3971,corolla,kXolx,2,1,1,1,1
corona,3973,corona,kXonx,2,2,0,1,1
coronal,3974,coronal,kcrxnL,3,3,0,0,3
coroner,3977,coroner,kcrxnX,3,3,0,0,3
corpse,3983,corpse,korps,3,1,2,0,3
corpus,3985,corpus,korpxs,2,1,1,1,1
corral,3987,corral,kX@l,3,3,0,1,2
corridor,3993,corridor,kcrxdX,1,1,0,0,1
corrode,3996,corrode,kXod,1,0,1,1,0
cosmic,4016,cosmic,kazmIk,1,0,1,1,0
cost,4023,cost,kcst,5,3,2,4,1
cot,4027,cot,kat,35,30,5,24,11
coterie,4028,coterie,kotXi,1,1,0,1,0
cottage,4031,cottage,katIJ,3,2,1,3,0
cottar,4032,cottar,katX,9,7,2,4,5
cotton,4033,cotton,katN,7,5,2,5,2
couch,4036,couch,kWC,9,7,2,6,3
cougar,4038,cougar,kugX,1,1,0,0,1
cough,4039,cough,kcf,11,7,4,4,7
could,4040,could,kUd,11,11,0,10,1
council,4041,council,kWnsL,2,2,0,2,0
count,4042,count,kWnt,7,4,3,5,2
counter,4044,counter,kWntX,3,2,1,1,2
county,4063,county,kWnti,3,2,1,1,2
coupe,4064,coupe,kupe,3,2,1,1,2
couple,4065,couple,k^pL,4,3,1,1,3
courier,4071,courier,kRiX,2,1,1,1,1
court,4072,court,kort,17,14,3,8,9
courtly,4078,courtly,kortli,1,1,0,1,0
cousin,4080,cousin,k^zN,1,1,0,1,0
cove,4081,cove,kov,18,17,1,9,9
cover,4084,cover,k^vX,4,4,0,1,3
covert,4086,covert,kovRt,1,0,1,1,0
covey,4088,covey,k^vi,2,2,0,1,1
cow,4089,cow,kW,19,15,4,10,9
coward,4090,coward,kWXd,1,0,1,0,1
cower,4092,cower,kWX,9,7,2,5,4
cowl,4094,cowl,kWl,18,15,3,15,3
cowlick,4095,cowlick,kWlIk,3,2,1,2,1
cowling,4096,cowling,kWlIG,4,3,1,3,1
coy,4101,coy,kO,14,10,4,5,9
cozy,4104,cozy,kozi,5,5,0,4,1
crab,4105,crab,kr@b,10,8,2,3,7
crabby,4107,crabby,kr@bi,3,1,2,1,2
crack,4108,crack,kr@k,18,14,4,5,13
cracker,4109,cracker,kr@kX,2,1,1,0,2
crackle,4110,crackle,kr@kL,4,2,2,2,2
craft,4113,craft,kr@ft,4,2,2,3,1
crafty,4115,crafty,kr@fti,2,1,1,1,1
crag,4116,crag,kr@g,8,7,1,3,5
cram,4117,cram,kr@m,16,13,3,6,10
cramp,4118,cramp,kr@mp,6,3,3,5,1
crane,4120,crane,kren,15,12,3,7,8
crank,4122,crank,kr@Gk,8,5,3,6,2
cranky,4123,cranky,kr@Gki,1,0,1,0,1
cranny,4124,cranny,kr@ni,3,2,1,2,1
crape,4125,crape,krep,12,9,3,5,7
craps,4126,craps,kr@ps,2,1,1,1,1
crash,4128,crash,kr@S,13,11,2,6,7
crass,4129,crass,kr@s,13,11,2,4,9
crate,4130,crate,kret,16,13,3,9,7
crater,4131,crater,kretX,5,2,3,4,1
crave,4133,crave,krev,8,6,2,4,4
craven,4134,craven,krevxn,1,0,1,1,0
crawl,4137,crawl,krcl,9,7,2,6,3
crayon,4139,crayon,krean,2,0,2,1,1
craze,4140,craze,krez,11,9,2,5,6
crazy,4141,crazy,krezi,1,0,1,0,1
creak,4142,creak,krik,15,14,1,5,10
cream,4143,cream,krim,12,10,2,3,9
crease,4145,crease,kris,9,9,0,1,8
create,4146,create,kriet,3,0,3,0,3
creator,4148,creator,krietX,2,0,2,1,1
creche,4150,creche,krES,4,4,0,1,3
credo,4157,credo,krido,1,0,1,0,1
creed,4160,creed,krid,11,9,2,3,8
creel,4161,creel,kril,10,7,3,2,8
creep,4162,creep,krip,11,8,3,2,9
creepy,4163,creepy,kripi,1,0,1,0,1
cremate,4164,cremate,krimet,1,0,1,0,1
creole,4169,creole,kriol,3,2,1,2,1
crept,4171,crept,krEpt,3,2,1,2,1
crescent,4174,crescent,krEsNt,1,0,1,0,1
cress,4175,cress,krEs,9,8,1,4,5
crest,4176,crest,krEst,9,6,3,6,3
crew,4182,crew,kru,19,10,9,11,8
crib,4183,crib,krIb,3,2,1,1,2
crick,4185,crick,krIk,13,11,2,7,6
crier,4187,crier,krYX,7,6,1,5,2
crime,4188,crime,krYm,10,8,2,4,6
crimp,4193,crimp,krImp,5,4,1,4,1
crinkle,4196,crinkle,krIGkL,1,0,1,1,0
cripple,4198,cripple,krIpL,3,2,1,2,1
crisp,4200,crisp,krIsp,2,2,0,0,2
critter,4207,critter,krItX,2,2,0,2,0
croak,4208,croak,krok,12,9,3,3,9
crochet,4209,crochet,kroSe,1,1,0,0,1
crock,4210,crock,krak,11,9,2,4,7
crone,4213,crone,kron,14,9,5,6,8
crony,4214,crony,kroni,4,2,2,2,2
crook,4215,crook,krUk,8,6,2,3,5
croon,4217,croon,krun,11,8,3,3,8
crop,4218,crop,krap,9,8,1,4,5
croquet,4220,croquet,kroke,2,1,1,0,2
crosier,4222,crosier,kroZX,1,1,0,1,0
cross,4223,cross,krcs,5,4,1,1,4
crotch,4227,crotch,kraC,4,4,0,0,4
crouch,4229,crouch,krWC,7,6,1,2,5
croup,4230,croup,krup,12,10,2,4,8
crow,4233,crow,kro,14,10,4,9,5
crowd,4235,crowd,krWd,8,8,0,3,5
crown,4237,crown,krWn,10,10,0,4,6
crude,4244,crude,krud,11,9,2,4,7
cruel,4246,cruel,krul,11,8,3,4,7
cruise,4248,cruise,kruz,8,6,2,1,7
cruiser,4249,cruiser,kruzX,1,0,1,0,1
cruller,4250,cruller,kr^lX,1,0,1,1,0
crumb,4251,crumb,kr^m,11,9,2,5,6
crumble,4252,crumble,kr^mbL,3,2,1,2,1
crumple,4254,crumple,kr^mpL,2,1,1,1,1
crunch,4255,crunch,kr^nC,2,1,1,1,1
crush,4257,crush,kr^S,7,6,1,3,4
crust,4258,crust,kr^st,5,4,1,5,0
crutch,4260,crutch,kr^C,6,5,1,1,5
cry,4263,cry,krY,10,7,3,6,4
crypt,4264,crypt,krIpt,3,2,1,2,1
cub,4270,cub,k^b,18,17,1,12,6
cube,4272,cube,kyub,2,1,1,0,2
cud,4278,cud,k^d,18,16,2,11,7
cuddle,4279,cuddle,k^dL,10,9,1,7,3
cudgel,4280,cudgel,k^JL,2,2,0,0,2
cue,4281,cue,kyu,12,7,5,9,3
cuff,4282,cuff,k^f,16,16,0,10,6
cull,4285,cull,k^l,24,21,3,16,8
cult,4290,cult,k^lt,7,4,3,4,3
culture,4294,culture,k^lCX,2,1,1,1,1
cumber,4296,cumber,k^mbX,4,3,1,4,0
cup,4303,cup,k^p,18,15,3,10,8
cupboard,4304,cupboard,k^bXd,1,1,0,1,0
cur,4309,cur,kR,21,13,8,8,13
curb,4313,curb,kRb,12,11,1,5,7
curd,4314,curd,kRd,19,17,2,11,8
curdle,4315,curdle,kRdL,8,7,1,5,3
curl,4323,curl,kRl,23,20,3,15,8
curlew,4324,curlew,kRlu,2,0,2,1,1
curry,4329,curry,kRi,14,10,4,5,9
curse,4330,curse,kRs,16,14,2,9,7
curt,4333,curt,kRt,26,21,5,17,9
curtain,4335,curtain,kRtN,5,4,1,3,2
curve,4338,curve,kRv,13,12,1,6,7
cusp,4341,cusp,k^sp,1,0,1,0,1
custard,4343,custard,k^stXd,1,1,0,1,0
cut,4351,cut,k^t,25,23,2,17,8
cute,4354,cute,kyut,6,3,3,4,2
cutter,4359,cutter,k^tX,12,9,3,9,3
cycle,4367,cycle,sYkL,6,6,0,3,3
cymbal,4378,cymbal,sImbL,4,3,1,3,1
cynic,4379,cynic,sInIk,3,3,0,3,0
cyst,4383,cyst,sIst,10,7,3,6,4
cystic,4384,cystic,sIstIk,2,2,0,2,0
czar,4385,czar,zar,9,8,1,9,0
d,4387,d,di,29,22,7,19,10
dab,4388,dab,d@b,14,12,2,10,4
dabble,4389,dabble,d@bL,8,7,1,5,3
dace,4390,dace,des,20,17,3,13,7
dactyl,4393,dactyl,d@ktL,2,2,0,2,0
dad,4395,dad,d@d,21,18,3,16,5
daddy,4396,daddy,d@di,7,5,2,4,3
daemon,4397,daemon,dimxn,2,2,0,2,0
daft,4399,daft,d@ft,6,4,2,6,0
dagger,4400,dagger,d@gX,1,1,0,0,1
daily,4403,daily,deli,9,8,1,7,2
dairy,4406,dairy,dEri,11,9,2,10,1
dais,4407,dais,dexs,1,0,1,0,1
daisy,4408,daisy,dezi,6,5,1,4,2
dale,4409,dale,del,30,27,3,23,7
dally,4410,dally,d@li,14,13,1,13,1
dam,4412,dam,d@m,22,18,4,17,5
dame,4416,dame,dem,23,21,2,17,6
damned,4419,damned,d@md,3,1,2,0,3
damp,4420,damp,d@mp,9,8,1,7,2
damsel,4422,damsel,d@mzL,1,0,1,1,0
dance,4424,dance,d@ns,6,6,0,6,0
dander,4426,dander,d@ndX,5,5,0,3,2
dandle,4428,dandle,d@ndL,7,7,0,5,2
dandy,4430,dandy,d@ndi,6,5,1,3,3
dane,4431,Dane,den,29,27,2,23,6
danger,4432,danger,denJX,2,2,0,2,0
dangle,4434,dangle,d@GgL,8,7,1,8,0
dank,4436,dank,d@Gk,12,10,2,12,0
dapper,4437,dapper,d@pX,4,4,0,2,2
dapple,4438,dapple,d@pL,5,4,1,2,3
dare,4439,dare,dEr,26,24,2,17,9
daring,4440,daring,d@rIG,3,3,0,3,0
dark,4441,dark,dark,10,8,2,7,3
darn,4447,darn,darn,7,5,2,3,4
darnel,4448,darnel,darnL,3,2,1,2,1
dart,4449,dart,dart,10,8,2,7,3
dash,4450,dash,d@S,15,14,1,12,3
data,4452,data,detx,2,1,1,0,2
date,4453,date,det,24,20,4,16,8
datum,4456,datum,detM,2,1,1,0,2
daub,4457,daub,dcb,5,5,0,3,2
daughter,4458,daughter,dctX,1,1,0,1,0
daunt,4459,daunt,dcnt,10,9,1,9,1
davit,4462,davit,devxt,1,1,0,1,0
dawdle,4463,dawdle,dcdL,2,2,0,2,0
dawn,4465,dawn,dcn,19,16,3,16,3
day,4466,day,de,27,20,7,15,12
daze,4468,daze,dez,19,17,2,12,7
dazzle,4469,dazzle,d@zL,4,3,1,2,2
dead,4473,dead,dEd,24,22,2,15,9
deaden,4474,deaden,dEdN,3,2,1,2,1
deaf,4478,deaf,dEf,13,11,2,4,9
deal,4480,deal,dil,29,24,5,22,7
dealer,4481,dealer,dilX,5,4,1,3,2
dealing,4482,dealing,dilIG,1,1,0,1,0
dealt,4483,dealt,dElt,17,12,5,10,7
dean,4484,dean,din,24,23,1,19,5
dear,4485,dear,dIr,29,27,2,21,8
dearth,4486,dearth,dRT,10,9,1,7,3
death,4487,death,dET,10,9,1,1,9
deb,4489,deb,dEb,14,13,1,6,8
debase,4493,debase,dIbes,1,1,0,1,0
debris,4499,debris,dxbri,2,2,0,2,0
debt,4500,debt,dEt,28,24,4,17,11
decay,4513,decay,dxke,1,1,0,0,1
deceive,4514,deceive,dIsiv,1,1,0,1,0
deck,4528,deck,dEk,20,19,1,11,9
decree,4557,decree,dxkri,2,2,0,2,0
deduce,4563,deduce,dIdus,3,2,1,3,0
deed,4564,deed,did,18,17,1,13,5
deem,4565,deem,dim,18,16,2,13,5
deep,4566,deep,dip,18,17,1,13,5
deface,4567,deface,dIfes,3,2,1,2,1
defame,4571,defame,dIfem,1,1,0,0,1
defeat,4573,defeat,dxfit,1,1,0,1,0
defend,4576,defend,dxfEnd,3,2,1,2,1
defense,4577,defense,dxfEns,2,1,1,1,1
defile,4583,defile,dIfYl,2,1,1,0,2
define,4584,define,dIfYn,4,3,1,2,2
deft,4592,deft,dEft,10,7,3,5,5
defy,4594,defy,dIfY,4,2,2,0,4
degree,4597,degree,dxgri,3,2,1,3,0
deice,4603,deice,diYs,1,0,1,1,0
deistic,4607,deistic,diIstIk,2,1,1,2,0
delay,4610,delay,dxle,3,2,1,2,1
dele,4611,dele,dili,10,8,2,8,2
delete,4616,delete,dxlit,2,1,1,2,0
delft,4618,delft,dElft,2,0,2,0,2
dell,4629,dell,dEl,29,25,4,19,10
delta,4632,delta,dEltx,1,0,1,0,1
delude,4633,delude,dxlud,1,0,1,1,0
delve,4637,delve,dElv,4,3,1,2,2
demand,4640,demand,dxm@nd,1,1,0,1,0
demise,4653,demise,dxmYz,1,1,0,1,0
den,4675,den,dEn,33,29,4,22,11
denial,4678,denial,dInYL,2,1,1,0,2
denier,4679,denier,dInYX,3,1,2,0,3
denim,4681,denim,dEnM,4,3,1,1,3
denote,4685,denote,dInot,1,0,1,0,1
dense,4687,dense,dEns,11,10,1,8,3
dent,4689,dent,dEnt,19,16,3,12,7
dental,4690,dental,dEntL,5,4,1,4,1
denture,4695,denture,dEnCX,2,2,0,2,0
deny,4699,deny,dInY,6,3,3,0,6
depart,4701,depart,dxpart,1,0,1,1,0
depend,4704,depend,dxpEnd,2,1,1,2,0
deplete,4707,deplete,dIplit,1,1,0,1,0
depth,4723,depth,dEpT,1,0,1,0,1
derive,4736,derive,dXYv,2,1,1,2,0
design,4758,design,dIzYn,2,2,0,2,0
desk,4763,desk,dEsk,3,2,1,2,1
deuce,4808,deuce,dus,20,17,3,11,9
device,4817,device,dxvYs,3,3,0,0,3
devil,4818,devil,dEvL,3,3,0,3,0
devise,4821,devise,dxvYz,5,4,1,1,4
devoid,4823,devoid,dxvOd,2,1,1,1,1
devotee,4828,devotee,dEvxti,1,1,0,1,0
dew,4831,dew,du,34,23,11,19,15
dhow,4836,dhow,dW,20,14,6,9,11
dial,4846,dial,dYl,26,24,2,18,8
diaper,4854,diaper,dYpX,4,4,0,3,1
diary,4860,diary,dYri,6,4,2,5,1
dibble,4864,dibble,dIbL,5,4,1,5,0
dice,4865,dice,dYs,19,16,3,11,8
dicker,4867,dicker,dIkX,11,11,0,5,6
dicky,4868,dicky,dIki,6,5,1,1,5
did,4878,did,dId,21,20,1,13,8
die,4881,die,dY,31,21,10,17,14
dies,4883,dies,dYz,16,15,1,8,8
diet,4884,diet,dYxt,1,1,0,1,0
differ,4887,differ,dIfX,7,7,0,1,6
dig,4893,dig,dIg,17,17,0,9,8
digit,4895,digit,dIJ|t,2,2,0,2,0
dike,4901,dike,dYk,19,18,1,11,8
dill,4910,dill,dIl,31,29,2,23,8
dim,4913,dim,dIm,21,20,1,12,9
dime,4914,dime,dYm,20,19,1,12,8
dimmer,4920,dimmer,dImX,8,7,1,2,6
dimple,4921,dimple,dImpL,3,3,0,3,0
din,4922,din,dIn,32,28,4,21,11
dine,4924,dine,dYn,30,28,2,21,9
diner,4925,diner,dYnX,7,6,1,5,2
dinghy,4927,dinghy,dIGi,4,3,1,0,4
dingle,4928,dingle,dIGgL,7,6,1,7,0
dinky,4931,dinky,dIGki,5,2,3,3,2
dinner,4932,dinner,dInX,13,10,3,4,9
dint,4934,dint,dInt,11,9,2,7,4
dip,4937,dip,dIp,25,23,2,16,9
dipper,4944,dipper,dIpX,12,11,1,6,6
dipstick,4945,dipstick,dIpstIk,2,1,1,2,0
dire,4947,dire,dYr,22,19,3,13,9
dirge,4950,dirge,dRJ,10,9,1,7,3
dirham,4951,dirham,dxr@m,1,0,1,1,0
dirk,4953,dirk,dRk,16,15,1,13,3
dirndl,4954,dirndl,dRndL,1,1,0,1,0
dirt,4955,dirt,dRt,15,15,0,12,3
disc,4975,disc,dIsk,4,4,0,4,0
dish,5005,dish,dIS,12,12,0,4,8
distich,5081,distich,dIstIk,5,3,2,4,1
distil,5082,distil,dIstIl,1,1,0,0,1
ditch,5097,ditch,dIC,16,15,1,8,8
dither,5098,dither,dIDX,9,9,0,4,5
ditto,5099,ditto,dIto,1,1,0,0,1
ditty,5100,ditty,dIti,10,10,0,6,4
dive,5107,dive,dYv,17,14,3,9,8
divide,5113,divide,dxvYd,4,4,0,0,4
divine,5117,divine,dxvYn,3,3,0,0,3
divisor,5122,divisor,dxvYzX,1,0,1,0,1
divot,5124,divot,dIvxt,4,4,0,4,0
dizzy,5126,dizzy,dIzi,5,5,0,2,3
docile,5129,docile,dasL,4,4,0,3,1
dock,5131,dock,dak,22,21,1,16,6
docket,5132,docket,dak|t,4,4,0,4,0
dodder,5142,dodder,dadX,3,3,0,2,1
dodge,5143,dodge,daJ,8,8,0,3,5
doe,5145,doe,do,29,18,11,14,15
does,5146,does,d^z,16,15,1,6,10
doff,5147,doff,daf,6,6,0,1,5
dog,5148,dog,dcg,8,8,0,6,2
doge,5149,doge,doJ,11,10,1,2,9
doily,5155,doily,dOli,6,6,0,6,0
dole,5159,dole,dol,33,29,4,22,11
doll,5160,doll,dal,16,14,2,9,7
dollar,5161,dollar,dalX,7,6,1,4,3
dolly,5163,dolly,dali,13,12,1,11,2
dolor,5165,dolor,dolX,11,9,2,7,4
dolt,5167,dolt,dolt,10,8,2,7,3
dome,5169,dome,dom,25,22,3,15,10
don,5180,don,dan,19,18,1,13,6
done,5184,done,d^n,30,29,1,20,10
donkey,5185,donkey,dcGki,1,1,0,1,0
donor,5187,donor,donX,5,4,1,3,2
doodle,5189,doodle,dudL,7,5,2,4,3
doom,5190,doom,dum,24,22,2,14,10
door,5192,door,doX,13,10,3,2,11
dope,5193,dope,dop,20,18,2,11,9
dorm,5194,dorm,dorm,5,4,1,3,2
dorsal,5198,dorsal,dorsL,1,1,0,1,0
dory,5199,dory,dori,7,7,0,6,1
dose,5201,dose,dos,12,11,1,3,9
dot,5203,dot,dat,26,24,2,19,7
dote,5205,dote,dot,25,22,3,15,10
dottle,5206,dottle,datL,5,4,1,3,2
double,5207,double,d^bL,7,5,2,5,2
doubly,5211,doubly,d^bLi,1,0,1,0,1
doubt,5212,doubt,dWt,20,17,3,13,7
douche,5213,douche,duS,11,10,1,2,9
doughty,5214,doughty,dWti,6,5,1,2,4
dour,5215,dour,dWr,13,10,3,6,7
dove,5216,dove,dov,16,14,2,7,9
dowdy,5219,dowdy,dWdi,5,5,0,2,3
dowel,5220,dowel,dWL,11,10,1,5,6
dower,5221,dower,dWX,12,11,1,6,6
down,5222,down,dWn,20,17,3,13,7
downy,5228,downy,dWni,4,3,1,0,4
dowry,5229,dowry,dWri,8,7,1,4,4
dowse,5230,dowse,dWz,12,10,2,6,6
doze,5232,doze,doz,20,19,1,11,9
dozen,5233,dozen,d^zN,2,1,1,1,1
drab,5234,drab,dr@b,6,5,1,3,3
draft,5236,draft,dr@ft,7,3,4,5,2
draftee,5237,draftee,dr@fti,3,2,1,1,2
drag,5239,drag,dr@g,7,6,1,3,4
drain,5243,drain,dren,13,10,3,7,6
drake,5244,drake,drek,5,3,2,2,3
dram,5245,dram,dr@m,10,7,3,6,4
drank,5251,drank,dr@Gk,8,6,2,8,0
drape,5252,drape,drep,10,7,3,3,7
draper,5253,draper,drepX,1,0,1,0,1
draughts,5255,draughts,dr@fts,2,1,1,0,2
draw,5256,draw,drc,6,3,3,1,5
drawer,5257,drawer,dror,6,5,1,1,5
drawl,5258,drawl,drcl,9,8,1,4,5
drawn,5259,drawn,drcn,8,6,2,3,5
dray,5261,dray,dre,14,9,5,7,7
dread,5262,dread,drEd,8,6,2,6,2
dream,5263,dream,drim,7,3,4,3,4
dreamed,5264,dreamed,drimd,2,1,1,0,2
dreamer,5265,dreamer,drimX,3,1,2,1,2
drear,5268,drear,drIr,7,4,3,3,4
dreary,5269,dreary,drIri,1,0,1,0,1
dredge,5270,dredge,drEJ,3,3,0,0,3
drench,5272,drench,drEnC,3,2,1,3,0
dress,5273,dress,drEs,9,6,3,5,4
dresser,5275,dresser,drEsX,1,0,1,0,1
drew,5276,drew,dru,13,9,4,7,6
dribble,5277,dribble,drIbL,3,2,1,1,2
drift,5279,drift,drIft,5,3,2,5,0
drill,5280,drill,drIl,12,10,2,7,5
drink,5281,drink,drIGk,6,5,1,6,0
drip,5282,drip,drIp,9,7,2,4,5
drive,5283,drive,drYv,9,5,4,5,4
drivel,5284,drivel,drIvL,3,3,0,1,2
driven,5285,driven,drIvxn,3,2,1,3,0
driver,5286,driver,drYvX,3,1,2,1,2
driving,5288,driving,drYvIG,3,2,1,3,0
drizzle,5289,drizzle,drIzL,3,3,0,1,2
drogue,5290,drogue,drog,8,7,1,2,6
droll,5291,droll,drol,11,8,3,3,8
drolly,5292,drolly,droli,1,0,1,0,1
drone,5294,drone,dron,12,11,1,5,7
drool,5295,drool,drul,8,6,2,3,5
droop,5296,droop,drup,9,7,2,4,5
drop,5297,drop,drap,6,6,0,2,4
dross,5300,dross,dras,2,2,0,0,2
drouth,5301,drouth,drWT,2,2,0,0,2
drove,5302,drove,drov,11,8,3,5,6
drover,5303,drover,drovX,3,1,2,2,1
drown,5304,drown,drWn,9,8,1,4,5
drowse,5305,drowse,drWz,7,4,3,4,3
drowsy,5306,drowsy,drWzi,2,1,1,1,1
drub,5307,drub,dr^b,8,6,2,4,4
drudge,5308,drudge,dr^J,6,6,0,2,4
drug,5309,drug,dr^g,8,6,2,3,5
drum,5311,drum,dr^m,10,8,2,5,5
drunk,5314,drunk,dr^Gk,5,4,1,5,0
dry,5315,dry,drY,12,8,4,6,6
dryer,5317,dryer,drYX,7,5,2,4,3
dual,5318,dual,duL,14,11,3,3,11
dub,5320,dub,d^b,22,20,2,12,10
ducal,5323,ducal,dukL,3,1,2,0,3
ducat,5324,ducat,d^kxt,1,0,1,0,1
duchy,5326,duchy,d^Ci,4,3,1,1,3
duck,5327,duck,d^k,25,22,3,13,12
duct,5328,duct,d^kt,4,1,3,0,4
ductile,5329,ductile,d^ktL,2,1,1,1,1
dud,5331,dud,d^d,18,18,0,9,9
dude,5332,dude,dud,20,18,2,10,10
duet,5335,duet,duEt,1,0,1,1,0
duffer,5336,duffer,d^fX,3,3,0,3,0
dug,5337,dug,d^g,22,21,1,13,9
duke,5339,duke,duk,16,14,2,6,10
dull,5342,dull,d^l,23,22,1,13,10
dullard,5343,dullard,d^lXd,1,1,0,1,0
dully,5344,dully,d^li,11,10,1,8,3
duly,5345,duly,duli,9,9,0,8,1
duma,5346,duma,dumx,1,0,1,0,1
dumb,5347,dumb,d^m,29,26,3,18,11
dummy,5352,dummy,d^mi,9,7,2,4,5
dump,5353,dump,d^mp,13,10,3,9,4
dumps,5354,dumps,d^mps,3,2,1,1,2
dumpy,5355,dumpy,d^mpi,3,1,2,0,3
dunce,5356,dunce,d^ns,4,3,1,3,1
dune,5358,dune,dun,27,26,1,18,9
dung,5359,dung,d^G,17,16,1,7,10
dunk,5363,dunk,d^Gk,13,10,3,10,3
duo,5364,duo,duo,10,8,2,0,10
dupe,5366,dupe,dup,18,16,2,9,9
duress,5376,duress,dUrEs,1,0,1,1,0
during,5377,during,dUrIG,2,2,0,2,0
dusk,5378,dusk,d^sk,9,8,1,6,3
dust,5379,dust,d^st,8,8,0,6,2
dutch,5381,dutch,d^C,15,14,1,5,10
duty,5385,duty,duti,6,6,0,5,1
dwarf,5386,dwarf,dworf,1,0,1,1,0
dwell,5388,dwell,dwEl,6,2,4,4,2
dwelled,5389,dwelled,dwEld,3,1,2,1,2
dwelt,5390,dwelt,dwElt,4,1,3,2,2
e,5401,e,i,28,4,24,22,6
each,5402,each,iC,14,8,6,8,6
eager,5403,eager,igX,7,6,1,5,2
eagle,5404,eagle,igL,8,5,3,6,2
ear,5406,ear,Ir,31,12,19,22,9
earl,5407,earl,Rl,19,12,7,14,5
early,5409,early,Rli,10,6,4,9,1
earn,5411,earn,Rn,15,9,6,11,4
earnings,5413,earnings,RnIGz,1,1,0,1,0
earth,5416,earth,RT,12,5,7,7,5
earthen,5417,earthen,RT|n,2,2,0,2,0
earthy,5419,earthy,RTi,2,1,1,1,1
ease,5420,ease,iz,19,8,11,10,9
easel,5421,easel,izL,6,3,3,4,2
east,5422,east,ist,8,2,6,7,1
easter,5423,Easter,istX,6,4,2,4,2
eastern,5424,eastern,istXn,1,0,1,0,1
easy,5425,easy,izi,4,2,2,2,2
eat,5427,eat,it,24,11,13,17,7
eaten,5428,eaten,itN,3,1,2,2,1
eaves,5429,eaves,ivz,7,1,6,4,3
ebb,5430,ebb,Eb,11,8,3,3,8
echo,5438,echo,Eko,2,2,0,1,1
eddy,5458,eddy,Edi,5,2,3,5,0
eden,5460,Eden,idN,1,1,0,1,0
edge,5461,edge,EJ,15,10,5,7,8
educe,5474,educe,Idus,6,1,5,6,0
eel,5475,eel,il,28,13,15,22,6
eery,5476,eery,Iri,14,8,6,12,2
efface,5477,efface,Ifes,3,1,2,3,0
effect,5478,effect,IfEkt,3,2,1,3,0
ego,5484,ego,igo,4,3,1,2,2
eider,5494,eider,YdX,6,4,2,4,2
eighteen,5496,eighteen,etin,1,0,1,0,1
eighth,5497,eighth,etT,2,1,1,0,2
eighty,5498,eighty,eti,4,1,3,1,3
either,5501,either,iDX,4,3,1,4,0
eject,5503,eject,IJEkt,3,1,2,3,0
eke,5504,eke,ik,20,9,11,14,6
elapse,5506,elapse,xl@ps,3,1,2,3,0
elate,5508,elate,xlet,11,9,2,5,6
elder,5510,elder,EldX,2,2,0,1,1
elect,5512,elect,xlEkt,4,1,3,3,1
elector,5516,elector,xlEktX,1,0,1,0,1
eleven,5542,eleven,xlEvxn,1,0,1,1,0
elf,5543,elf,Elf,8,3,5,4,4
elicit,5545,elicit,xlIs|t,3,1,2,3,0
elite,5550,elite,xlit,13,10,3,7,6
elk,5553,elk,Elk,5,4,1,1,4
ell,5554,ell,El,31,16,15,19,12
ellipse,5555,ellipse,xlIps,1,1,0,1,0
elm,5557,elm,Elm,7,3,4,3,4
elope,5560,elope,xlop,2,2,0,1,1
else,5562,else,Els,6,4,2,2,4
elver,5565,elver,ElvX,3,2,1,1,2
elves,5566,elves,Elvz,3,1,2,2,1
ember,5582,ember,EmbX,3,2,1,3,0
emend,5601,emend,ImEnd,4,2,2,3,1
emerge,5604,emerge,ImRJ,3,2,1,1,2
emir,5613,emir,ImIr,4,3,1,2,2
emit,5615,emit,ImIt,6,4,2,3,3
emote,5618,emote,Imot,4,2,2,3,1
emu,5637,emu,imyu,1,0,1,1,0
enable,5643,enable,InebL,2,2,0,2,0
enchain,5648,enchain,InCen,3,2,1,3,0
encipher,5650,encipher,InsYfX,2,2,0,0,2
end,5661,end,End,13,3,10,10,3
ennoble,5693,ennoble,InobL,4,2,2,4,0
enough,5696,enough,In^f,1,1,0,1,0
enter,5711,enter,EntX,2,1,1,2,0
entomb,5720,entomb,Intum,1,0,1,0,1
envenom,5739,envenom,InvEnM,1,1,0,0,1
envoy,5745,envoy,EnvO,1,1,0,0,1
envy,5746,envy,Envi,2,1,1,0,2
epee,5751,epee,Epe,3,2,1,3,0
epergne,5752,epergne,IpRn,2,2,0,2,0
epic,5755,epic,EpIk,2,1,1,1,1
epoch,5779,epoch,Epxk,1,1,0,0,1
equate,5790,equate,Ikwet,2,0,2,1,1
equator,5792,equator,IkwetX,1,0,1,0,1
equip,5801,equip,xkwIp,2,1,1,1,1
era,5810,era,Irx,4,2,2,2,2
erase,5812,erase,Ires,5,4,1,5,0
ermine,5816,ermine,Rmxn,4,1,3,4,0
erode,5817,erode,Irod,2,0,2,2,0
errand,5819,errand,Erxnd,2,1,1,1,1
errant,5820,errant,Erxnt,2,2,0,1,1
error,5825,error,ErX,5,3,2,2,3
erst,5827,erst,Rst,7,2,5,7,0
esprit,5855,esprit,Ispri,2,1,1,2,0
espy,5856,espy,IspY,1,0,1,1,0
esquire,5857,esquire,EskwYr,1,0,1,1,0
essay,5858,essay,Ese,4,2,2,3,1
estate,5862,estate,Istet,2,0,2,2,0
ester,5863,ester,EstX,8,5,3,8,0
estrange,5868,estrange,IstrenJ,1,0,1,1,0
etch,5871,etch,EC,15,11,4,7,8
eternal,5872,eternal,ItRnL,2,1,1,2,0
ether,5874,ether,iTX,3,3,0,3,0
ethyl,5882,ethyl,ETL,1,0,1,1,0
etiquette,5885,etiquette,EtIk|t,1,0,1,1,0
euchre,5891,euchre,yukX,2,1,1,1,1
eve,5918,eve,iv,15,6,9,7,8
event,5923,event,xvEnt,5,4,1,4,1
ever,5926,ever,EvX,6,2,4,6,0
every,5930,every,Evri,2,1,1,2,0
evil,5936,evil,ivL,6,4,2,4,2
ewe,5944,ewe,yu,30,20,10,24,6
ewer,5945,ewer,yuX,6,4,2,1,5
exceed,5959,exceed,Iksid,1,1,0,1,0
excite,5971,excite,IksYt,2,2,0,2,0
expect,6037,expect,IkspEkt,1,1,0,1,0
eyestrain,6138,eyestrain,Ystren,1,0,1,1,0
eyrie,6139,eyrie,Yri,13,9,4,11,2
eyrir,6140,eyrir,erIr,2,1,1,2,0
f,6141,f,Ef,15,11,4,7,8
fable,6143,fable,febL,11,10,1,9,2
face,6149,face,fes,21,18,3,12,9
facet,6151,facet,f@s|t,4,3,1,3,1
facial,6153,facial,feSL,3,3,0,1,2
facile,6154,facile,f@sL,8,8,0,6,2
fact,6158,fact,f@kt,6,3,3,3,3
factor,6161,factor,f@ktX,2,0,2,1,1
fad,6165,fad,f@d,19,18,1,15,4
fade,6166,fade,fed,22,19,3,12,10
faery,6167,faery,fEri,14,11,3,10,4
fag,6168,fag,f@g,18,17,1,14,4
faggot,6169,faggot,f@g|t,2,2,0,2,0
fail,6172,fail,fel,37,33,4,28,9
faille,6173,faille,fYl,27,25,2,21,6
fain,6175,fain,fen,31,29,2,21,10
faint,6176,faint,fent,7,5,2,5,2
fair,6177,fair,fEr,28,22,6,20,8
fairy,6178,fairy,f@ri,14,11,3,11,3
faith,6179,faith,feT,11,10,1,2,9
fake,6180,fake,fek,22,19,3,13,9
fall,6184,fall,fcl,26,23,3,21,5
fallout,6189,fallout,fclWt,2,0,2,1,1
fallow,6190,fallow,f@lo,12,10,2,11,1
false,6191,FALSE,fcls,4,3,1,2,2
falter,6198,falter,fcltX,7,5,2,6,1
fame,6199,fame,fem,24,19,5,14,10
famed,6200,famed,femd,2,0,2,0,2
famine,6206,famine,f@mxn,3,3,0,3,0
fan,6209,fan,f@n,21,20,1,17,4
fancier,6211,fancier,f@nsiX,1,0,1,0,1
fancy,6212,fancy,f@nsi,2,1,1,1,1
fang,6215,fang,f@G,11,11,0,7,4
far,6220,far,far,18,14,4,14,4
farce,6222,farce,fars,6,5,1,3,3
farm,6226,farm,farm,6,4,2,4,2
farrier,6231,farrier,f@riX,4,3,1,3,1
farrow,6232,farrow,f@ro,10,8,2,8,2
farther,6235,farther,farDX,1,0,1,1,0
fast,6246,fast,f@st,15,13,2,10,5
fasten,6247,fasten,f@sN,4,3,1,0,4
fastener,6248,fastener,f@sNX,1,0,1,0,1
fat,6252,fat,f@t,28,22,6,20,8
fatal,6253,fatal,fetL,7,5,2,3,4
fate,6257,fate,fet,29,24,5,18,11
fateful,6259,fateful,fetfL,1,0,1,0,1
father,6260,father,faDX,6,5,1,5,1
fatten,6263,fatten,f@tN,8,6,2,5,3
fatty,6264,fatty,f@ti,7,6,1,4,3
faucet,6268,faucet,fcs|t,1,1,0,1,0
fault,6269,fault,fclt,10,6,4,5,5
faun,6270,faun,fcn,18,16,2,14,4
fauna,6271,fauna,fcnx,1,0,1,0,1
favor,6272,favor,fevX,4,3,1,4,0
fay,6274,fay,fe,30,19,11,15,15
faze,6275,faze,fez,23,21,2,14,9
fear,6277,fear,fIr,31,27,4,23,8
feast,6281,feast,fist,10,8,2,8,2
feat,6282,feat,fit,24,19,5,17,7
feather,6283,feather,fEDX,8,8,0,7,1
feature,6284,feature,fiCX,2,2,0,0,2
feaze,6285,feaze,fiz,18,15,3,13,5
febrile,6286,febrile,fEbrL,1,0,1,1,0
fed,6294,fed,fEd,20,18,2,14,6
fee,6300,fee,fi,31,21,10,19,12
feeble,6301,feeble,fibL,2,2,0,2,0
feed,6303,feed,fid,19,16,3,12,7
feel,6305,feel,fil,30,27,3,24,6
fell,6309,fell,fEl,30,25,5,21,9
fellah,6310,fellah,fElx,4,3,1,0,4
felloe,6312,felloe,fElo,14,12,2,9,5
felly,6315,felly,fEli,12,10,2,7,5
felt,6319,felt,fElt,13,12,1,9,4
femur,6325,femur,fimX,3,3,0,1,2
fen,6326,fen,fEn,29,25,4,21,8
fence,6327,fence,fEns,10,8,2,7,3
fend,6328,fend,fEnd,20,15,5,16,4
fennel,6331,fennel,fEnL,8,7,1,3,5
fern,6335,fern,fRn,21,19,2,14,7
ferrule,6340,ferrule,fErL,8,6,2,3,5
fertile,6341,fertile,fRtL,6,6,0,6,0
festal,6346,festal,fEstL,4,3,1,3,1
fester,6347,fester,fEstX,6,4,2,5,1
fetch,6351,fetch,fEC,9,8,1,4,5
fetich,6352,fetich,fEtIS,1,1,0,1,0
fetter,6355,fetter,fEtX,6,5,1,4,2
fettle,6356,fettle,fEtL,11,10,1,8,3
feud,6358,feud,fyud,7,4,3,1,6
feudal,6359,feudal,fyudL,2,1,1,0,2
fever,6362,fever,fivX,4,4,0,2,2
few,6363,few,fyu,12,6,6,7,5
fez,6364,fez,fEz,10,10,0,5,5
fiat,6367,fiat,fiat,2,1,1,0,2
fib,6368,fib,fIb,12,12,0,5,7
fichu,6372,fichu,fISu,4,2,2,2,2
fickle,6373,fickle,fIkL,8,7,1,4,4
fiddle,6376,fiddle,fIdL,6,6,0,4,2
fidget,6379,fidget,fIJ|t,2,2,0,2,0
fie,6381,fie,fY,29,20,9,17,12
fief,6382,fief,fif,12,11,1,7,5
field,6383,field,fild,9,6,3,6,3
fiend,6385,fiend,find,7,6,1,5,2
fierce,6386,fierce,fIrs,6,5,1,3,3
fiery,6387,fiery,fYri,6,3,3,5,1
fife,6389,fife,fYf,11,10,1,5,6
fifth,6391,fifth,fIfT,1,1,0,0,1
fig,6393,fig,fIg,16,16,0,9,7
fight,6394,fight,fYt,24,21,3,18,6
filch,6402,filch,fIlC,8,7,1,0,8
filet,6403,filet,fIle,8,6,2,1,7
filial,6404,filial,fIliL,1,0,1,0,1
filing,6407,filing,fYlIG,3,2,1,3,0
fill,6409,fill,fIl,40,31,9,26,14
filler,6410,filler,fIlX,11,9,2,2,9
filling,6411,filling,fIlIG,6,5,1,6,0
filly,6413,filly,fIli,18,15,3,8,10
film,6414,film,fIlm,7,6,1,0,7
fils,6415,fils,fIls,10,9,1,1,9
filter,6416,filter,fIltX,3,2,1,2,1
filth,6417,filth,fIlT,9,8,1,1,8
fin,6420,fin,fIn,30,26,4,20,10
final,6422,final,fYnL,6,4,2,3,3
finally,6426,finally,fYnLi,2,1,1,0,2
finch,6430,finch,fInC,10,7,3,6,4
find,6431,find,fYnd,12,11,1,10,2
fine,6433,fine,fYn,28,25,3,20,8
finery,6434,finery,fYnXi,1,1,0,0,1
finger,6436,finger,fIGgX,1,1,0,1,0
finis,6441,finis,fIni,8,7,1,5,3
finny,6444,finny,fIni,8,7,1,5,3
fir,6445,fir,fR,18,11,7,7,11
fire,6446,fire,fYr,22,18,4,15,7
firm,6449,firm,fRm,13,11,2,6,7
first,6451,first,fRst,9,8,1,9,0
firth,6454,firth,fRT,14,12,2,7,7
fiscal,6455,fiscal,fIskL,1,0,1,0,1
fish,6456,fish,fIS,13,9,4,4,9
fissure,6461,fissure,fISX,3,2,1,0,3
fist,6462,fist,fIst,11,9,2,9,2
fit,6465,fit,fIt,28,25,3,20,8
five,6466,five,fYv,12,11,1,6,6
fix,6467,fix,fIks,10,8,2,6,4
fixed,6470,fixed,fIkst,3,1,2,1,2
fizz,6475,fizz,fIz,16,13,3,8,8
fizzle,6476,fizzle,fIzL,6,4,2,3,3
fjord,6477,fjord,fiord,1,0,1,1,0
flag,6482,flag,fl@g,8,6,2,3,5
flail,6490,flail,flel,5,3,2,2,3
flair,6491,flair,flEr,10,8,2,4,6
flak,6492,flak,fl@k,17,13,4,5,12
flake,6493,flake,flek,11,8,3,3,8
flame,6496,flame,flem,11,7,4,6,5
flank,6502,flank,fl@Gk,8,6,2,6,2
flap,6505,flap,fl@p,10,9,1,4,6
flash,6507,flash,fl@S,10,9,1,4,6
flask,6508,flask,fl@sk,2,1,1,0,2
flat,6509,flat,fl@t,15,13,2,3,12
flatten,6511,flatten,fl@tN,4,1,3,3,1
flaunt,6514,flaunt,flcnt,1,1,0,1,0
flavor,6516,flavor,flevX,2,1,1,2,0
flaw,6518,flaw,flc,9,7,2,3,6
flax,6519,flax,fl@ks,5,3,2,4,1
flay,6520,flay,fle,16,10,6,7,9
flea,6521,flea,fli,22,12,10,13,9
fleck,6522,fleck,flEk,11,9,2,1,10
fled,6523,fled,flEd,10,8,2,5,5
fleece,6525,fleece,flis,4,2,2,1,3
fleer,6526,fleer,flIr,11,9,2,4,7
fleet,6527,fleet,flit,16,13,3,7,9
flesh,6529,flesh,flES,7,7,0,1,6
flew,6530,flew,flu,14,10,4,6,8
flex,6531,flex,flEks,4,3,1,3,1
flick,6536,flick,flIk,14,12,2,3,11
flicker,6537,flicker,flIkX,5,3,2,2,3
flier,6538,flier,flYX,6,4,2,2,4
flight,6539,flight,flYt,16,13,3,7,9
flinch,6542,flinch,flInC,5,2,3,3,2
fling,6543,fling,flIG,12,9,3,6,6
flint,6544,flint,flInt,5,3,2,3,2
flip,6546,flip,flIp,11,9,2,3,8
flipper,6548,flipper,flIpX,4,3,1,1,3
flirt,6549,flirt,flRt,10,10,0,2,8
flit,6551,flit,flIt,17,14,3,4,13
flitch,6552,flitch,flIC,6,5,1,0,6
flivver,6553,flivver,flIvX,5,4,1,3,2
float,6554,float,flot,13,11,2,3,10
flock,6555,flock,flak,12,10,2,4,8
floe,6556,floe,flo,20,11,9,12,8
flog,6557,flog,flag,4,4,0,1,3
flood,6558,flood,fl^d,5,5,0,1,4
floor,6559,floor,floX,6,4,2,1,5
flop,6562,flop,flap,9,7,2,5,4
floss,6568,floss,flcs,4,2,2,2,2
flounder,6572,flounder,flWndX,1,0,1,1,0
flour,6573,flour,flWr,5,4,1,1,4
flout,6575,flout,flWt,12,10,2,3,9
flower,6576,flower,flWX,5,5,0,1,4
flown,6577,flown,flon,7,4,3,4,3
fluff,6581,fluff,fl^f,5,4,1,2,3
fluke,6584,fluke,fluk,8,7,1,0,8
flume,6585,flume,flum,11,9,2,6,5
flung,6586,flung,fl^G,8,6,2,3,5
flunk,6587,flunk,fl^Gk,6,3,3,4,2
flunkey,6588,flunkey,fl^Gki,1,0,1,0,1
flurry,6594,flurry,flRi,3,1,2,1,2
flush,6595,flush,fl^S,9,8,1,4,5
fluster,6596,fluster,fl^stX,4,2,2,3,1
flute,6597,flute,flut,12,10,2,2,10
flutter,6599,flutter,fl^tX,3,1,2,2,1
flux,6600,flux,fl^ks,3,3,0,3,0
fly,6601,fly,flY,13,9,4,5,8
foal,6605,foal,fol,30,28,2,24,6
foam,6606,foam,fom,16,13,3,10,6
fob,6607,fob,fab,13,13,0,11,2
fodder,6610,fodder,fadX,3,3,0,2,1
foe,6611,foe,fo,26,17,9,15,11
fog,6612,fog,fcg,10,9,1,7,3
fogey,6613,fogey,fogi,3,3,0,2,1
foible,6614,foible,fObL,2,2,0,2,0
foist,6615,foist,fOst,8,8,0,8,0
fold,6616,fold,fold,12,10,2,10,2
folio,6619,folio,folio,2,1,1,2,0
folk,6620,folk,fok,16,13,3,10,6
folksy,6621,folksy,foksi,2,2,0,1,1
follow,6624,follow,falo,7,6,1,6,1
folly,6625,folly,fali,11,10,1,10,1
fond,6628,fond,fand,12,9,3,9,3
fondle,6630,fondle,fandL,2,1,1,0,2
fondu,6631,fondu,fandu,2,1,1,0,2
font,6632,font,fant,3,3,0,2,1
food,6633,food,fud,11,10,1,10,1
fool,6635,fool,ful,18,17,1,17,1
foot,6639,foot,fUt,10,9,1,9,1
fop,6643,fop,fap,12,11,1,10,2
for,6644,for,for,33,23,10,20,13
foray,6646,foray,fcre,1,0,1,1,0
force,6650,force,fors,16,14,2,7,9
ford,6653,ford,ford,19,16,3,10,9
forecastle,6657,forecastle,foksL,1,1,0,0,1
foresee,6671,foresee,forsi,4,3,1,2,2
forge,6690,forge,forJ,9,8,1,1,8
fork,6695,fork,fork,13,10,3,3,10
forked,6696,forked,forkt,2,0,2,0,2
form,6699,form,form,15,11,4,4,11
formal,6700,formal,formL,3,2,1,1,2
former,6708,former,formX,2,1,1,0,2
fort,6718,fort,fort,16,13,3,6,10
forth,6719,forth,forT,9,8,1,1,8
forty,6731,forty,forti,4,2,2,1,3
forum,6732,forum,forM,8,7,1,0,8
fossil,6734,fossil,fasL,4,4,0,4,0
foster,6735,foster,fcstX,2,2,0,2,0
fought,6736,fought,fct,20,17,3,16,4
foul,6737,foul,fWl,17,14,3,16,1
foully,6739,foully,fWli,6,4,2,5,1
found,6741,found,fWnd,14,13,1,12,2
founder,6743,founder,fWndX,2,0,2,1,1
fount,6746,fount,fWnt,6,5,1,4,2
fountain,6747,fountain,fWntN,2,1,1,1,1
fourteen,6748,fourteen,fortin,1,0,1,0,1
fox,6749,fox,faks,8,5,3,6,2
foxed,6750,foxed,fakst,2,1,1,1,1
foyer,6751,foyer,fOX,1,1,0,1,0
fragile,6755,fragile,fr@JL,1,1,0,0,1
frail,6759,frail,frel,11,8,3,6,5
frame,6761,frame,frem,7,5,2,2,5
franc,6762,franc,fr@Gk,6,5,1,6,0
frappe,6771,frappe,fr@p,3,2,1,3,0
fraud,6775,fraud,frcd,4,4,0,1,3
fraught,6777,fraught,frct,11,8,3,3,8
fray,6778,fray,fre,18,10,8,10,8
frazzle,6779,frazzle,fr@zL,2,2,0,1,1
freak,6780,freak,frik,7,5,2,4,3
free,6782,free,fri,17,11,6,11,6
freeze,6790,freeze,friz,7,5,2,2,5
freight,6791,freight,fret,17,14,3,9,8
french,6792,french,frEnC,4,3,1,3,1
fresh,6798,fresh,frES,4,3,1,3,1
fret,6799,fret,frEt,6,6,0,1,5
friar,6802,friar,frYX,7,6,1,5,2
friend,6807,friend,frEnd,5,3,2,4,1
fright,6809,fright,frYt,13,9,4,7,6
frill,6812,frill,frIl,9,7,2,7,2
frisk,6815,frisk,frIsk,2,1,1,2,0
fritter,6816,fritter,frItX,1,1,0,1,0
frizz,6820,frizz,frIz,6,4,2,1,5
frizzle,6821,frizzle,frIzL,4,2,2,3,1
fro,6822,fro,fro,17,12,5,12,5
frock,6823,frock,frak,4,3,1,3,1
frog,6824,frog,frcg,4,3,1,1,3
frolic,6825,frolic,fralIk,1,0,1,1,0
from,6826,from,fr^m,5,4,1,4,1
frond,6827,frond,frand,2,1,1,2,0
front,6828,front,fr^nt,5,2,3,4,1
frontal,6830,frontal,fr^ntL,1,0,1,0,1
frost,6833,frost,frcst,1,0,1,0,1
froth,6836,froth,frcT,6,5,1,3,3
frown,6839,frown,frWn,3,3,0,3,0
frowsy,6840,frowsy,frWzi,1,1,0,1,0
froze,6841,froze,froz,7,4,3,2,5
frozen,6842,frozen,frozN,1,0,1,0,1
fruit,6846,fruit,frut,7,6,1,3,4
fry,6850,fry,frY,13,9,4,7,6
fuddle,6852,fuddle,f^dL,6,6,0,5,1
fudge,6853,fudge,f^J,6,6,0,3,3
fuel,6855,fuel,fyul,9,6,3,4,5
fugue,6857,fugue,fyug,5,4,1,0,5
full,6860,full,fUl,15,14,1,13,2
fully,6861,fully,fUli,9,7,2,8,1
fumble,6865,fumble,f^mbL,6,5,1,6,0
fume,6866,fume,fyum,6,5,1,1,5
fun,6870,fun,f^n,25,22,3,19,6
fund,6873,fund,f^nd,8,7,1,5,3
funk,6883,funk,f^Gk,9,8,1,9,0
funnel,6884,funnel,f^nL,9,8,1,5,4
funny,6885,funny,f^ni,11,10,1,8,3
furl,6889,furl,fRl,24,21,3,16,8
furlough,6891,furlough,fRlo,6,3,3,4,2
furrier,6896,furrier,fRiX,3,2,1,1,2
furring,6897,furring,fRIG,1,1,0,1,0
furrow,6898,furrow,fRo,13,10,3,4,9
furry,6899,furry,fRi,16,12,4,7,9
further,6900,further,fRDX,3,3,0,2,1
furze,6904,furze,fRz,13,12,1,6,7
fuse,6905,fuse,fyuz,7,5,2,2,5
fuss,6910,fuss,f^s,9,8,1,6,3
fusty,6912,fusty,f^sti,2,2,0,2,0
futile,6913,futile,fyutL,2,1,1,1,1
fuzz,6918,fuzz,f^z,10,10,0,7,3
g,6919,g,Ji,24,21,3,18,6
gab,6920,gab,g@b,17,14,3,8,9
gabble,6922,gabble,g@bL,9,7,2,5,4
gabby,6923,gabby,g@bi,7,5,2,4,3
gable,6925,gable,gebL,9,8,1,9,0
gad,6926,gad,g@d,25,23,2,18,7
gadget,6929,gadget,g@J|t,1,1,0,1,0
gael,6933,Gael,gel,34,29,5,24,10
gaff,6935,gaff,g@f,14,12,2,6,8
gaffer,6936,gaffer,g@fX,5,4,1,2,3
gag,6937,gag,g@g,19,19,0,12,7
gage,6938,gage,geJ,15,13,2,7,8
gaily,6940,gaily,geli,8,6,2,5,3
gain,6941,gain,gen,25,23,2,17,8
gait,6943,gait,get,28,24,4,19,9
gaiter,6944,gaiter,getX,5,4,1,4,1
gala,6945,gala,gelx,3,2,1,0,3
gall,6949,gall,gcl,24,23,1,18,6
gallant,6950,gallant,g@l|nt,2,1,1,1,1
gallery,6954,gallery,g@lXi,3,2,1,2,1
galley,6955,galley,g@li,13,10,3,11,2
gallon,6960,gallon,g@l|n,2,1,1,1,1
gallows,6962,gallows,g@loz,1,0,1,1,0
gambit,6969,gambit,g@mbxt,1,0,1,0,1
gamble,6970,gamble,g@mbL,4,2,2,3,1
game,6971,game,gem,20,17,3,11,9
gamin,6975,gamin,g@mxn,5,5,0,3,2
gamine,6976,gamine,g@min,1,1,0,0,1
gammer,6977,gammer,g@mX,6,4,2,4,2
gamut,6978,gamut,g@mxt,3,2,1,1,2
gamy,6979,gamy,gemi,2,1,1,0,2
gander,6980,gander,g@ndX,3,3,0,3,0
gang,6981,gang,g@G,15,15,0,8,7
gannet,6990,gannet,g@n|t,2,1,1,2,0
gantry,6992,gantry,g@ntri,2,2,0,2,0
gaol,6993,gaol,Jel,22,19,3,18,4
gap,6994,gap,g@p,20,19,1,12,8
gape,6995,gape,gep,18,14,4,10,8
garb,6997,garb,garb,4,2,2,1,3
garble,6999,garble,garbL,4,2,2,2,2
garden,7000,garden,gardN,2,1,1,1,1
gargle,7002,gargle,gargL,2,1,1,1,1
garish,7004,garish,g@rIS,1,1,0,1,0
garner,7008,garner,garnX,1,1,0,0,1
garotte,7011,garotte,gxrat,2,1,1,2,0
garret,7012,garret,g@rxt,3,3,0,3,0
garter,7017,garter,gartX,5,5,0,4,1
gas,7018,gas,g@s,19,15,4,11,8
gash,7019,gash,g@S,19,18,1,12,7
gasp,7023,gasp,g@sp,6,2,4,4,2
gather,7030,gather,g@DX,4,4,0,2,2
gauche,7031,gauche,goS,7,6,1,2,5
gaud,7034,gaud,gcd,13,13,0,7,6
gaunt,7035,gaunt,gcnt,10,8,2,7,3
gauze,7036,gauze,gcz,11,11,0,5,6
gave,7037,gave,gev,18,16,2,10,8
gavel,7038,gavel,g@vL,4,3,1,3,1
gavotte,7039,gavotte,gxvat,1,1,0,1,0
gawk,7040,gawk,gck,14,12,2,7,7
gawky,7041,gawky,gcki,1,0,1,0,1
gay,7042,gay,ge,27,18,9,15,12
gaze,7043,gaze,gez,20,17,3,12,8
gear,7048,gear,gIr,21,20,1,18,3
geese,7049,geese,gis,8,7,1,8,0
geisha,7050,geisha,geSx,1,1,0,0,1
geld,7053,geld,gEld,5,5,0,5,0
gem,7055,gem,JEm,9,8,1,6,3
gender,7062,gender,JEndX,3,3,0,3,0
gene,7063,gene,Jin,17,14,3,13,4
general,7066,general,JEnXL,1,1,0,0,1
genic,7084,genic,JinIk,1,1,0,1,0
genie,7085,genie,Jini,7,6,1,5,2
genital,7086,genital,JEn|tL,2,0,2,0,2
gens,7091,gens,JEnz,3,3,0,2,1
gent,7092,gent,JEnt,17,14,3,12,5
gentian,7095,gentian,JEnC|n,3,3,0,3,0
gentle,7098,gentle,JEntL,7,5,2,4,3
genus,7105,genus,Jin|s,2,2,0,2,0
germ,7116,germ,JRm,7,7,0,6,1
german,7117,german,JRmxn,5,4,1,4,1
germane,7118,germane,JRmen,1,1,0,0,1
gerund,7127,gerund,JErxnd,1,0,1,1,0
gesture,7132,gesture,JEsCX,1,1,0,1,0
get,7134,get,gEt,21,19,2,18,3
geyser,7138,geyser,gYzX,5,4,1,4,1
ghat,7141,ghat,gct,23,21,2,16,7
ghetto,7143,ghetto,gEto,1,0,1,0,1
ghost,7144,ghost,gost,10,9,1,9,1
ghoul,7145,ghoul,gul,17,15,2,14,3
gi,7146,GI,JiY,2,1,1,0,2
gibber,7148,gibber,JIbX,4,3,1,2,2
gibbon,7150,gibbon,gIb|n,2,1,1,1,1
gibe,7151,gibe,JYb,4,4,0,3,1
gibson,7153,Gibson,gIbs|n,1,0,1,0,1
giddy,7154,giddy,gIdi,3,3,0,2,1
gift,7155,gift,gIft,5,5,0,4,1
gig,7156,gig,gIg,12,11,1,8,4
giggle,7158,giggle,gIgL,6,5,1,5,1
gild,7160,gild,gIld,6,4,2,3,3
gill,7161,gill,gIl,28,24,4,23,5
gilt,7162,gilt,gIlt,11,10,1,8,3
gin,7167,gin,JIn,20,19,1,15,5
ginger,7168,ginger,JInJX,1,0,1,1,0
giraffe,7170,giraffe,JX@f,1,1,0,1,0
gird,7171,gird,gRd,17,14,3,11,6
girder,7172,girder,gRdX,4,3,1,1,3
girdle,7173,girdle,gRdL,6,5,1,2,4
girl,7174,girl,gRl,16,15,1,13,3
girt,7175,girt,gRt,17,17,0,14,3
girth,7176,girth,gRT,10,9,1,7,3
gist,7178,gist,JIst,10,10,0,9,1
give,7179,give,gIv,7,7,0,4,3
given,7181,given,gIvxn,1,1,0,1,0
glad,7186,glad,gl@d,9,5,4,4,5
gladden,7187,gladden,gl@dN,1,0,1,0,1
glade,7188,glade,gled,6,5,1,3,3
glamor,7193,glamor,gl@mX,4,3,1,4,0
glance,7195,glance,gl@ns,3,1,2,1,2
gland,7196,gland,gl@nd,5,3,2,3,2
glare,7198,glare,glEr,4,3,1,3,1
glass,7200,glass,gl@s,7,4,3,4,3
glaze,7201,glaze,glez,6,4,2,4,2
gleam,7203,gleam,glim,6,4,2,1,5
glean,7204,glean,glin,7,5,2,3,4
glebe,7205,glebe,glib,8,7,1,2,6
glee,7206,glee,gli,15,7,8,10,5
glen,7207,glen,glEn,2,2,0,0,2
glib,7209,glib,glIb,3,3,0,0,3
glide,7210,glide,glYd,5,4,1,3,2
glimmer,7211,glimmer,glImX,2,2,0,1,1
glint,7213,glint,glInt,2,1,1,2,0
glisten,7214,glisten,glIsN,1,0,1,1,0
glister,7215,glister,glIstX,2,1,1,1,1
glitter,7216,glitter,glItX,4,1,3,2,2
gloat,7218,gloat,glot,8,6,2,4,4
glob,7219,glob,glab,6,4,2,3,3
global,7220,global,globL,1,0,1,0,1
globe,7221,globe,glob,8,5,3,1,7
gloom,7224,gloom,glum,9,7,2,6,3
glory,7228,glory,glori,1,0,1,1,0
gloss,7229,gloss,glcs,3,2,1,2,1
glove,7233,glove,gl^v,3,2,1,1,2
glow,7234,glow,glo,13,7,6,8,5
glower,7235,glower,glWX,1,1,0,1,0
gloze,7237,gloze,gloz,6,4,2,2,4
glue,7239,glue,glu,11,7,4,8,3
glum,7240,glum,gl^m,7,6,1,3,4
glut,7241,glut,gl^t,6,4,2,2,4
gluten,7242,gluten,glutN,1,1,0,1,0
glutton,7244,glutton,gl^tN,2,1,1,1,1
gnarl,7247,gnarl,narl,3,2,1,2,1
gnash,7248,gnash,n@S,15,14,1,10,5
gnat,7249,gnat,n@t,28,26,2,22,6
gnaw,7250,gnaw,nc,19,16,3,11,8
gneiss,7251,gneiss,nYs,14,12,2,10,4
gnome,7252,gnome,nom,18,15,3,10,8
gnu,7253,gnu,nu,31,24,7,19,12
go,7254,go,go,26,16,10,17,9
goad,7255,goad,god,22,18,4,15,7
goal,7256,goal,gol,28,25,3,21,7
goalie,7257,goalie,goli,11,9,2,7,4
goat,7260,goat,got,26,20,6,19,7
goatee,7261,goatee,goti,4,3,1,1,3
gob,7263,gob,gab,17,14,3,12,5
gobble,7265,gobble,gabL,9,7,2,7,2
gobbler,7267,gobbler,gablX,1,1,0,1,0
god,7270,god,gad,19,17,2,15,4
goggle,7271,goggle,gagL,5,4,1,4,1
going,7272,going,goIG,1,1,0,1,0
goitre,7273,goitre,gOtX,3,3,0,3,0
gold,7274,gold,gold,15,12,3,11,4
golf,7279,golf,g^lf,4,3,1,0,4
gone,7282,gone,gcn,17,14,3,9,8
goner,7283,goner,gcnX,2,1,1,0,2
gong,7285,gong,gcG,12,12,0,6,6
goo,7287,goo,gu,26,21,5,19,7
good,7288,good,gUd,12,10,2,10,2
goodly,7289,goodly,gUdli,1,0,1,0,1
goody,7292,goody,gUdi,3,1,2,1,2
goof,7293,goof,guf,5,4,1,2,3
goose,7294,goose,gus,12,11,1,9,3
gopher,7297,gopher,gofX,2,2,0,2,0
gore,7298,gore,gor,26,20,6,17,9
gorge,7299,gorge,gorJ,5,4,1,1,4
gorse,7304,gorse,gors,9,8,1,5,4
gory,7305,gory,gori,10,8,2,4,6
got,7310,got,gat,26,24,2,22,4
goth,7311,Goth,gaT,4,4,0,1,3
gotten,7313,gotten,gatN,3,2,1,2,1
gouge,7315,gouge,gWJ,3,3,0,1,2
gourd,7317,gourd,gord,16,14,2,10,6
gourde,7318,gourde,gUrd,3,2,1,2,1
gout,7321,gout,gWt,17,16,1,15,2
gown,7326,gown,gWn,8,8,0,6,2
grab,7327,grab,gr@b,8,7,1,3,5
grace,7328,grace,gres,16,14,2,4,12
grackle,7330,grackle,gr@kL,3,3,0,1,2
grade,7332,grade,gred,14,12,2,4,10
graft,7338,graft,gr@ft,6,3,3,3,3
grail,7339,grail,grel,16,13,3,5,11
grain,7340,grain,gren,20,16,4,7,13
grammar,7341,grammar,gr@mX,3,1,2,2,1
gramme,7343,gramme,gr@m,11,9,2,4,7
grand,7345,grand,gr@nd,7,5,2,5,2
grandee,7349,grandee,gr@ndi,3,2,1,1,2
grange,7356,grange,grenJ,3,1,2,2,1
granite,7357,granite,gr@n|t,2,0,2,1,1
grant,7358,grant,gr@nt,6,3,3,2,4
grantee,7359,grantee,gr@nti,2,1,1,0,2
grape,7363,grape,grep,16,13,3,4,12
graph,7364,graph,gr@f,7,5,2,1,6
graphite,7366,graphite,gr@fYt,1,0,1,0,1
grapnel,7367,grapnel,gr@pnL,2,1,1,1,1
grapple,7368,grapple,gr@pL,3,2,1,0,3
grasp,7369,grasp,gr@sp,3,0,3,2,1
grass,7370,grass,gr@s,13,10,3,5,8
grate,7371,grate,gret,21,18,3,9,12
grating,7375,grating,gretIG,2,1,1,1,1
grave,7379,grave,grev,16,12,4,4,12
gravel,7380,gravel,gr@vL,6,4,2,4,2
gravy,7387,gravy,grevi,1,0,1,0,1
gray,7388,gray,gre,18,8,10,7,11
grayling,7390,grayling,grelIG,2,1,1,1,1
graze,7391,graze,grez,15,12,3,7,8
grease,7393,grease,gris,14,12,2,2,12
greasy,7395,greasy,grisi,1,0,1,0,1
grebe,7396,grebe,grib,10,10,0,1,9
greed,7398,greed,grid,12,11,1,3,9
greek,7399,Greek,grik,11,10,1,4,7
green,7400,green,grin,13,13,0,2,11
greet,7402,greet,grit,12,12,0,1,11
grew,7408,grew,gru,15,9,6,8,7
grid,7410,grid,grId,9,7,2,1,8
griddle,7411,griddle,grIdL,3,1,2,1,2
grief,7413,grief,grif,11,10,1,2,9
grieve,7415,grieve,griv,12,10,2,2,10
grill,7417,grill,grIl,15,13,2,7,8
grim,7419,grim,grIm,12,11,1,4,8
grime,7421,grime,grYm,7,6,1,3,4
grin,7422,grin,grIn,9,9,0,0,9
grind,7423,grind,grYnd,4,2,2,3,1
grinder,7424,grinder,grYndX,1,0,1,0,1
grip,7426,grip,grIp,12,11,1,3,9
gripe,7427,gripe,grYp,7,6,1,2,5
grist,7429,grist,grIst,4,2,2,2,2
gristle,7430,gristle,grIsL,3,3,0,1,2
grit,7432,grit,grIt,12,9,3,1,11
grits,7433,grits,grIts,1,0,1,0,1
groan,7435,groan,gron,15,13,2,5,10
groat,7436,groat,grot,14,11,3,4,10
grocer,7437,grocer,grosX,2,0,2,0,2
grocery,7438,grocery,grosXi,1,0,1,0,1
grog,7439,grog,grag,2,1,1,0,2
groggy,7440,groggy,gragi,1,0,1,0,1
groin,7441,groin,grOn,4,4,0,0,4
groom,7443,groom,grum,10,8,2,3,7
groove,7445,groove,gruv,8,7,1,1,7
grope,7446,grope,grop,12,10,2,2,10
gross,7449,gross,gros,11,9,2,0,11
grot,7452,grot,grat,10,6,4,4,6
grotto,7454,grotto,grato,1,0,1,0,1
grouch,7455,grouch,grWC,3,3,0,1,2
ground,7456,ground,grWnd,5,3,2,5,0
group,7461,group,grup,11,10,1,3,8
grouse,7462,grouse,grWs,6,6,0,0,6
grove,7463,grove,grov,13,11,2,4,9
grovel,7464,grovel,gravL,1,1,0,1,0
grow,7465,grow,gro,18,10,8,9,9
growl,7466,growl,grWl,6,6,0,1,5
growth,7467,growth,groT,6,5,1,0,6
grub,7468,grub,gr^b,8,6,2,3,5
grubby,7469,grubby,gr^bi,1,0,1,0,1
grudge,7471,grudge,gr^J,4,4,0,2,2
gruel,7472,gruel,grul,11,8,3,4,7
gruff,7474,gruff,gr^f,5,4,1,1,4
grumble,7475,grumble,gr^mbL,2,1,1,2,0
grunt,7477,grunt,gr^nt,4,3,1,4,0
guard,7483,guard,gard,14,12,2,11,3
guerdon,7488,guerdon,gRdN,4,3,1,1,3
guess,7489,guess,gEs,11,9,2,9,2
guest,7490,guest,gEst,15,13,2,13,2
guide,7493,guide,gYd,18,16,2,15,3
guilder,7495,guilder,gIldX,1,0,1,0,1
guile,7496,guile,gYl,21,19,2,18,3
guinea,7499,guinea,gIni,6,6,0,5,1
guise,7500,guise,gYz,10,8,2,6,4
gulch,7502,gulch,g^lC,5,4,1,1,4
gull,7504,gull,g^l,21,17,4,13,8
gullet,7505,gullet,g^l|t,2,2,0,2,0
gully,7506,gully,g^li,13,11,2,6,7
gulp,7507,gulp,g^lp,5,4,1,1,4
gum,7508,gum,g^m,16,15,1,12,4
gumbo,7509,gumbo,g^mbo,1,1,0,1,0
gun,7512,gun,g^n,20,18,2,14,6
gunnel,7513,gunnel,g^nL,6,5,1,3,3
gunnery,7514,gunnery,g^nXi,1,0,1,0,1
gunny,7515,gunny,g^ni,12,10,2,6,6
guppy,7518,guppy,g^pi,4,4,0,1,3
gurgle,7519,gurgle,gRgL,3,3,0,2,1
gush,7520,gush,g^S,10,10,0,6,4
gusset,7521,gusset,g^s|t,3,2,1,2,1
gust,7522,gust,g^st,11,8,3,8,3
gusto,7524,gusto,g^sto,1,0,1,0,1
gut,7525,gut,g^t,24,20,4,17,7
gutter,7526,gutter,g^tX,11,8,3,8,3
guttural,7527,guttural,g^tXL,1,0,1,0,1
gutty,7528,gutty,g^ti,9,8,1,4,5
guy,7529,guy,gY,23,19,4,17,6
guzzle,7530,guzzle,g^zL,4,4,0,3,1
gym,7531,gym,JIm,14,13,1,8,6
gyp,7536,gyp,JIp,18,18,0,13,5
gyrate,7539,gyrate,JYret,1,0,1,1,0
gyve,7543,gyve,JYv,7,7,0,6,1
h,7544,h,eC,11,11,0,3,8
habit,7548,habit,h@b|t,2,2,0,2,0
hack,7559,hack,h@k,30,27,3,17,13
hackle,7560,hackle,h@kL,8,7,1,5,3
had,7564,had,h@d,31,28,3,18,13
haddock,7565,haddock,h@dxk,4,4,0,4,0
haft,7570,haft,h@ft,7,4,3,5,2
hag,7571,hag,h@g,25,24,1,13,12
haggle,7574,haggle,h@gL,4,3,1,1,3
hail,7576,hail,hel,30,26,4,25,5
hair,7577,hair,hEr,24,22,2,18,6
hairy,7581,hairy,h@ri,14,12,2,10,4
hake,7582,hake,hek,21,19,2,17,4
haler,7585,haler,halX,6,5,1,2,4
half,7586,half,h@f,18,17,1,6,12
hall,7591,hall,hcl,23,20,3,19,4
hallo,7595,hallo,hxlo,4,4,0,4,0
hallow,7596,hallow,h@lo,12,11,1,11,1
halo,7600,halo,helo,5,4,1,4,1
halt,7602,halt,hclt,8,6,2,5,3
halter,7603,halter,hcltX,5,3,2,4,1
halve,7604,halve,h@v,17,16,1,5,12
halvers,7605,halvers,h@vXz,1,0,1,0,1
halves,7606,halves,h@vz,7,4,3,4,3
ham,7607,ham,h@m,26,24,2,14,12
hammer,7611,hammer,h@mX,6,4,2,2,4
hammock,7612,hammock,h@mxk,4,4,0,4,0
hamper,7613,hamper,h@mpX,3,2,1,2,1
hand,7616,hand,h@nd,13,9,4,9,4
handle,7621,handle,h@ndL,7,6,1,4,3
handy,7630,handy,h@ndi,6,5,1,4,2
hang,7631,hang,h@G,23,19,4,9,14
hangar,7632,hangar,h@GX,6,4,2,0,6
hanged,7634,hanged,h@Gd,5,3,2,0,5
hank,7637,hank,h@Gk,17,13,4,12,5
hanker,7638,hanker,h@GkX,7,4,3,5,2
hansel,7639,hansel,h@nsL,4,3,1,3,1
hap,7640,hap,h@p,30,28,2,17,13
happy,7646,happy,h@pi,3,2,1,1,2
harangue,7647,harangue,hX@G,2,1,1,1,1
harass,7648,harass,hX@s,2,2,0,1,1
harbor,7650,harbor,harbX,2,1,1,2,0
hard,7651,hard,hard,18,16,2,10,8
hardly,7654,hardly,hardli,1,0,1,0,1
hardy,7656,hardy,hardi,5,3,2,1,4
harem,7657,harem,h@rM,4,3,1,2,2
hark,7658,hark,hark,14,12,2,7,7
harm,7661,harm,harm,9,8,1,3,6
harp,7668,harp,harp,10,8,2,2,8
harpy,7671,harpy,harpi,3,2,1,0,3
harrier,7673,harrier,h@riX,4,3,1,3,1
harrow,7674,harrow,h@ro,10,9,1,7,3
harsh,7675,harsh,harS,7,7,0,1,6
hart,7676,hart,hart,16,12,4,7,9
has,7679,has,h@z,20,18,2,8,12
hash,7680,hash,h@S,22,21,1,11,11
hasp,7682,hasp,h@sp,5,3,2,3,2
hassle,7683,hassle,h@sL,10,9,1,7,3
hassock,7684,hassock,h@sxk,4,4,0,4,0
haste,7685,haste,hest,10,9,1,8,2
hasten,7686,hasten,hesN,4,4,0,3,1
hat,7687,hat,h@t,34,31,3,21,13
hatch,7688,hatch,h@C,19,19,0,8,11
hatchet,7689,hatchet,h@C|t,3,3,0,3,0
hate,7691,hate,het,24,21,3,19,5
hatter,7693,hatter,h@tX,11,9,2,8,3
haunch,7696,haunch,hcnC,4,4,0,3,1
haunt,7697,haunt,hcnt,11,11,0,9,2
hautboy,7698,hautboy,obO,4,3,1,1,3
haven,7700,haven,hevxn,3,3,0,3,0
havoc,7703,havoc,h@vxk,3,3,0,3,0
haw,7704,haw,hc,21,17,4,11,10
hawk,7705,hawk,hck,18,14,4,13,5
hawker,7706,hawker,hckX,3,2,1,0,3
hawser,7707,hawser,hczX,2,2,0,0,2
hay,7709,hay,he,26,22,4,15,11
haze,7713,haze,hez,19,16,3,13,6
hazel,7714,hazel,hezL,3,2,1,1,2
hazy,7715,hazy,hezi,6,5,1,4,2
he,7716,he,hi,33,24,9,18,15
head,7717,head,hEd,25,22,3,17,8
heady,7723,heady,hEdi,4,2,2,2,2
heal,7724,heal,hil,29,26,3,23,6
health,7725,health,hElT,7,6,1,1,6
heap,7726,heap,hip,22,21,1,16,6
hear,7727,hear,hIr,30,28,2,20,10
heard,7728,heard,hRd,20,18,2,12,8
hearse,7732,hearse,hRs,15,14,1,8,7
hearten,7733,hearten,hartN,5,4,1,3,2
hearth,7734,hearth,harT,6,6,0,0,6
hearty,7736,hearty,harti,6,4,2,2,4
heat,7737,heat,hit,25,22,3,19,6
heath,7738,heath,hiT,10,9,1,4,6
heather,7740,heather,hEDX,7,7,0,6,1
heave,7742,heave,hiv,15,13,2,9,6
heaven,7743,heaven,hEvxn,4,4,0,4,0
heavy,7744,heavy,hEvi,3,3,0,2,1
heckle,7751,heckle,hEkL,2,2,0,1,1
hector,7754,hector,hEktX,4,4,0,4,0
hedge,7755,hedge,hEJ,11,10,1,5,6
heed,7758,heed,hid,21,20,1,15,6
heft,7760,heft,hEft,7,6,1,5,2
hefty,7761,hefty,hEfti,1,0,1,0,1
heifer,7764,heifer,hEfX,3,3,0,1,2
height,7765,height,hYt,26,22,4,19,7
heighten,7766,heighten,hYtN,4,2,2,3,1
heinous,7767,heinous,hen|s,1,0,1,1,0
heiress,7768,heiress,@r|s,4,4,0,3,1
heist,7770,heist,hYst,4,3,1,3,1
held,7771,held,hEld,11,9,2,4,7
hell,7779,hell,hEl,31,24,7,19,12
hello,7788,hello,hElo,15,14,1,9,6
helm,7789,helm,hElm,10,6,4,3,7
help,7793,help,hElp,11,8,3,3,8
helve,7795,helve,hElv,8,7,1,2,6
hem,7797,hem,hEm,16,13,3,8,8
hemp,7808,hemp,hEmp,4,2,2,1,3
hen,7810,hen,hEn,24,20,4,16,8
hence,7811,hence,hEns,10,8,2,7,3
henna,7814,henna,hEnx,3,2,1,1,2
hep,7816,hep,hEp,15,13,2,7,8
her,7819,her,hR,22,14,8,7,15
herb,7823,herb,hRb,11,10,1,4,7
hero,7852,hero,hIro,3,2,1,2,1
heron,7857,heron,hErxn,1,1,0,1,0
hers,7859,hers,hRz,13,12,1,6,7
hew,7866,hew,hyu,9,5,4,7,2
hewn,7867,hewn,hyun,2,1,1,0,2
hex,7868,hex,hEks,6,5,1,4,2
hick,7881,hick,hIk,25,25,0,16,9
hid,7883,hid,hId,25,23,2,15,10
hidden,7885,hidden,hIdN,6,5,1,5,1
hide,7886,hide,hYd,21,19,2,15,6
hiding,7890,hiding,hYdIG,3,3,0,3,0
hie,7891,hie,hY,30,23,7,17,13
hike,7900,hike,hYk,17,16,1,12,5
hill,7902,hill,hIl,33,31,2,23,10
hilt,7904,hilt,hIlt,12,10,2,9,3
him,7905,him,hIm,20,19,1,11,9
hind,7907,hind,hYnd,8,7,1,7,1
hinder,7908,hinder,hIndX,3,3,0,2,1
hindi,7909,Hindi,hIndi,3,3,0,2,1
hinge,7914,hinge,hInJ,4,4,0,3,1
hint,7915,hint,hInt,10,9,1,7,3
hip,7917,hip,hIp,28,27,1,19,9
hire,7921,hire,hYr,18,16,2,13,5
his,7923,his,hIz,17,15,2,8,9
hiss,7924,hiss,hIs,14,14,0,5,9
history,7930,history,hIstXi,1,1,0,1,0
hit,7932,hit,hIt,33,29,4,22,11
hitch,7933,hitch,hIC,19,17,2,10,9
hither,7934,hither,hIDX,6,5,1,6,0
hive,7935,hive,hYv,15,13,2,9,6
hives,7936,hives,hYvz,6,5,1,5,1
hoard,7937,hoard,hord,14,13,1,9,5
hoarse,7940,hoarse,hors,11,9,2,5,6
hoary,7941,hoary,hori,11,9,2,5,6
hoax,7942,hoax,hoks,4,4,0,2,2
hob,7943,hob,hab,18,16,2,12,6
hobble,7944,hobble,habL,6,5,1,4,2
hobby,7945,hobby,habi,7,6,1,3,4
hobo,7947,hobo,hobo,1,0,1,1,0
hock,7948,hock,hak,23,21,2,17,6
hockey,7949,hockey,haki,6,5,1,3,3
hod,7950,hod,had,21,19,2,16,5
hoe,7952,hoe,ho,28,20,8,14,14
hog,7953,hog,hcg,9,8,1,6,3
hoist,7955,hoist,hOst,7,7,0,7,0
hokum,7956,hokum,hokM,2,1,1,1,1
hold,7957,hold,hold,13,11,2,10,3
hole,7959,hole,hol,31,28,3,22,9
holla,7962,holla,halx,4,4,0,1,3
hollo,7963,hollo,halo,9,9,0,6,3
holly,7964,holly,hali,11,11,0,6,5
holster,7967,holster,holstX,2,2,0,2,0
holy,7968,holy,holi,8,6,2,4,4
home,7971,home,hom,20,18,2,13,7
homely,7972,homely,homli,1,0,1,0,1
hone,7988,hone,hon,23,20,3,15,8
honey,7990,honey,h^ni,9,8,1,5,4
honk,7992,honk,hcGk,3,2,1,2,1
honor,7993,honor,anX,2,2,0,2,0
hood,7998,hood,hUd,13,13,0,11,2
hooey,8002,hooey,hui,8,6,2,2,6
hoof,8003,hoof,hUf,5,5,0,3,2
hook,8004,hook,hUk,16,15,1,13,3
hookah,8005,hookah,hUkx,1,0,1,0,1
hoop,8008,hoop,hup,17,15,2,12,5
hoot,8010,hoot,hut,23,22,1,18,5
hooves,8012,hooves,hUvz,2,2,0,2,0
hop,8013,hop,hap,20,19,1,15,5
hope,8014,hope,hop,21,19,2,14,7
horn,8021,horn,horn,13,11,2,8,5
horror,8033,horror,hcrX,2,2,0,0,2
horsy,8036,horsy,horsi,3,1,2,1,2
hose,8042,hose,hoz,19,18,1,12,7
host,8050,host,host,10,10,0,10,0
hostler,8055,hostler,haslX,1,0,1,0,1
hot,8056,hot,hat,28,26,2,23,5
hound,8061,hound,hWnd,9,9,0,9,0
hour,8062,hour,Wr,11,7,4,8,3
houri,8063,houri,hUri,3,3,0,3,0
house,8064,house,hWs,7,6,1,5,2
hove,8073,hove,hov,15,14,1,8,7
hovel,8074,hovel,h^vL,4,4,0,1,3
hover,8075,hover,h^vX,2,2,0,1,1
how,8076,how,hW,18,16,2,9,9
howl,8081,howl,hWl,15,13,2,13,2
hoyden,8083,hoyden,hOdN,1,1,0,1,0
hub,8085,hub,h^b,19,19,0,10,9
huddle,8090,huddle,h^dL,7,7,0,5,2
huff,8091,huff,h^f,18,18,0,9,9
hug,8092,hug,h^g,21,21,0,12,9
huge,8093,huge,hyuJ,2,1,1,0,2
hula,8095,hula,hulx,1,1,0,1,0
hulk,8096,hulk,h^lk,5,4,1,2,3
hull,8098,hull,h^l,24,23,1,14,10
hum,8100,hum,h^m,25,24,1,15,10
humble,8109,humble,h^mbL,6,5,1,6,0
hummock,8120,hummock,h^mxk,1,1,0,1,0
hump,8124,hump,h^mp,10,9,1,9,1
hun,8126,Hun,h^n,25,22,3,13,12
hunch,8127,hunch,h^nC,9,7,2,5,4
hung,8129,hung,h^G,18,17,1,8,10
hunger,8131,hunger,h^GgX,2,2,0,1,1
hunk,8132,hunk,h^Gk,14,12,2,10,4
hunker,8133,hunker,h^GkX,5,4,1,3,2
hunt,8134,hunt,h^nt,10,8,2,6,4
hurdle,8137,hurdle,hRdL,5,4,1,3,2
hurl,8138,hurl,hRl,22,19,3,15,7
hurry,8141,hurry,hRi,13,11,2,5,8
hurt,8142,hurt,hRt,23,21,2,15,8
hurtle,8143,hurtle,hRtL,6,5,1,4,2
hush,8145,hush,h^S,14,14,0,5,9
husk,8146,husk,h^sk,8,7,1,4,4
husky,8147,husky,h^ski,1,0,1,0,1
hussar,8148,hussar,h^zar,1,0,1,0,1
hussy,8149,hussy,h^zi,3,3,0,1,2
hustle,8151,hustle,h^sL,8,8,0,5,3
hut,8152,hut,h^t,27,26,1,17,10
hutch,8153,hutch,h^C,16,15,1,6,10
huzza,8155,huzza,h^za,2,1,1,0,2
ibis,8216,ibis,Ybxs,1,1,0,1,0
ice,8217,ice,Ys,16,7,9,11,5
ichor,8222,ichor,Ykor,2,1,1,2,0
icicle,8224,icicle,YsIkL,2,0,2,2,0
icon,8225,icon,Ykan,1,0,1,1,0
icy,8229,icy,Ysi,4,2,2,3,1
id,8230,id,Id,19,11,8,12,7
idea,8231,idea,Ydix,1,1,0,0,1
ideal,8232,ideal,Ydil,3,1,2,1,2
ideally,8237,ideally,Ydili,3,0,3,2,1
ides,8244,ides,Ydz,4,4,0,2,2
idle,8251,idle,YdL,5,3,2,3,2
idly,8252,idly,Ydli,1,0,1,1,0
if,8256,if,If,13,10,3,5,8
iffy,8257,iffy,Ifi,4,1,3,3,1
igloo,8258,igloo,Iglu,1,0,1,1,0
ignoble,8262,ignoble,IgnobL,1,0,1,1,0
ilk,8269,ilk,Ilk,6,2,4,5,1
ill,8270,ill,Il,31,15,16,23,8
illegal,8271,illegal,IligL,2,0,2,1,1
illegally,8273,illegally,IligLi,1,0,1,0,1
illiberal,8278,illiberal,IlIbXL,1,0,1,1,0
illicit,8279,illicit,IlIs|t,2,1,1,2,0
illume,8283,illume,Ilum,5,4,1,5,0
image,8292,image,ImIJ,4,3,1,1,3
immense,8324,immense,ImEns,1,1,0,0,1
immerse,8325,immerse,ImRs,2,2,0,1,1
immobile,8333,immobile,ImobL,2,1,1,2,0
immoral,8340,immoral,ImcrL,2,1,1,2,0
immortal,8342,immortal,ImortL,1,0,1,1,0
imp,8356,imp,Imp,3,0,3,3,0
impend,8382,impend,ImpEnd,2,1,1,1,1
impound,8442,impound,ImpWnd,1,1,0,0,1
in,8481,in,In,26,12,14,17,9
inane,8492,inane,Inen,4,2,2,1,3
inca,8508,Inca,IGkx,2,1,1,0,2
incense,8522,incense,InsEns,1,1,0,1,0
incessant,8526,incessant,InsEsNt,1,0,1,0,1
incest,8527,incest,InsEst,7,5,2,3,4
inch,8529,inch,InC,8,1,7,6,2
incise,8535,incise,InsYz,4,3,1,0,4
incisor,8538,incisor,InsYzX,3,2,1,0,3
incite,8539,incite,InsYt,7,7,0,3,4
incur,8607,incur,InkR,2,2,0,0,2
indent,8628,indent,IndEnt,2,2,0,2,0
indict,8646,indict,IndYt,3,3,0,3,0
induce,8677,induce,Indus,1,0,1,1,0
inert,8702,inert,InRt,4,2,2,0,4
infect,8727,infect,InfEkt,5,3,2,3,2
infer,8730,infer,InfR,3,2,1,0,3
infernal,8734,infernal,InfRnL,3,3,0,1,2
inferno,8735,inferno,InfRno,1,1,0,0,1
infertile,8736,infertile,InfRtL,1,1,0,0,1
infest,8737,infest,InfEst,4,4,0,3,1
infirm,8750,infirm,InfRm,1,0,1,0,1
inflect,8759,inflect,InflEkt,2,1,1,0,2
inflict,8764,inflict,InflIkt,1,1,0,0,1
ingest,8791,ingest,InJEst,4,4,0,3,1
ingle,8792,ingle,IGgL,7,1,6,7,0
inject,8827,inject,InJEkt,4,3,1,3,1
injure,8829,injure,InJX,3,0,3,1,2
injury,8831,injury,InJXi,1,0,1,0,1
ink,8833,ink,IGk,14,2,12,12,2
inky,8836,inky,IGki,4,1,3,2,2
inlet,8840,inlet,InlEt,1,1,0,1,0
inmate,8841,inmate,Inmet,1,0,1,1,0
innate,8844,innate,Inet,4,2,2,2,2
inner,8845,inner,InX,6,2,4,3,3
inning,8848,inning,InIG,2,1,1,1,1
innings,8849,innings,InIGz,2,1,1,1,1
inroad,8871,inroad,Inrod,1,0,1,1,0
insane,8874,insane,Insen,2,1,1,1,1
insect,8880,insect,InsEkt,5,3,2,2,3
insert,8892,insert,InsRt,5,4,1,1,4
inset,8894,inset,InsEt,6,4,2,1,5
inside,8896,inside,InsYd,4,3,1,0,4
insider,8897,insider,InsYdX,3,2,1,0,3
insight,8899,insight,InsYt,7,7,0,3,4
insist,8906,insist,InsIst,1,1,0,0,1
inspect,8916,inspect,InspEkt,2,1,1,1,1
instate,8929,instate,Instet,1,0,1,1,0
intend,8983,intend,IntEnd,2,2,0,0,2
intense,8985,intense,IntEns,3,3,0,1,2
intent,8989,intent,IntEnt,4,4,0,2,2
inter,8992,inter,IntR,5,3,2,0,5
intern,9041,intern,IntRn,5,1,4,1,4
internal,9042,internal,IntRnL,5,2,3,2,3
interne,9044,interne,IntRn,5,1,4,1,4
internee,9046,internee,IntRni,3,1,2,0,3
into,9082,into,Intu,4,3,1,2,2
intone,9086,intone,Inton,2,2,0,0,2
inurn,9116,inurn,InRn,5,3,2,3,2
invent,9126,invent,InvEnt,4,4,0,2,2
inverse,9131,inverse,InvRs,2,2,0,0,2
invert,9133,invert,InvRt,4,3,1,1,3
invest,9135,invest,InvEst,4,4,0,3,1
invite,9152,invite,InvYt,4,4,0,3,1
invoice,9155,invoice,InvOs,1,1,0,0,1
ion,9171,ion,Y|n,4,1,3,4,0
ionic,9172,ionic,YanIk,4,3,1,4,0
irate,9178,irate,Yret,9,7,2,9,0
ire,9179,ire,Yr,21,8,13,15,6
irenic,9180,irenic,YrEnIk,1,1,0,1,0
iris,9184,iris,Yr|s,3,2,1,3,0
irk,9186,irk,Rk,16,8,8,12,4
iron,9187,iron,Yrn,3,2,1,1,2
ironic,9188,ironic,YranIk,3,2,1,3,0
is,9230,is,Iz,13,10,3,5,8
ism,9236,ism,IzM,2,0,2,1,1
issue,9249,issue,ISu,3,0,3,3,0
it,9252,it,It,27,13,14,19,8
itch,9255,itch,IC,18,10,8,11,7
item,9256,item,YtM,2,2,0,2,0
its,9262,its,Its,1,0,1,0,1
ivory,9264,ivory,Yvri,3,1,2,2,1
ivy,9265,ivy,Yvi,4,2,2,3,1
j,9266,j,Je,22,19,3,15,7
jab,9267,jab,J@b,14,13,1,9,5
jabber,9268,jabber,J@bX,3,2,1,2,1
jack,9271,jack,J@k,17,16,1,12,5
jackal,9272,jackal,J@kL,5,4,1,4,1
jade,9276,jade,Jed,11,9,2,8,3
jag,9277,jag,J@g,18,18,0,14,4
jailor,9280,jailor,JelX,3,2,1,2,1
jam,9284,jam,J@m,16,15,1,12,4
jangle,9286,jangle,J@GgL,9,8,1,9,0
jape,9290,jape,Jep,11,9,2,8,3
jar,9291,jar,Jar,16,14,2,11,5
jaunt,9297,jaunt,Jcnt,10,9,1,9,1
jaunty,9298,jaunty,Jcnti,1,0,1,0,1
jaw,9300,jaw,Jc,15,14,1,11,4
jazz,9302,jazz,J@z,7,6,1,3,4
jeans,9304,jeans,Jinz,4,3,1,2,2
jeer,9305,jeer,JIr,23,22,1,18,5
jell,9309,jell,JEl,17,15,2,13,4
jelly,9310,jelly,JEli,5,4,1,3,2
jennet,9311,jennet,JEn|t,4,2,2,2,2
jerk,9314,jerk,JRk,11,10,1,10,1
jerkin,9315,jerkin,JRkxn,1,1,0,1,0
jersey,9317,jersey,JRzi,1,1,0,0,1
jess,9318,jess,JEs,12,10,2,8,4
jest,9320,jest,JEst,18,16,2,15,3
jet,9321,jet,JEt,20,17,3,14,6
jetty,9324,jetty,JEti,4,3,1,2,2
jew,9325,Jew,Ju,26,22,4,18,8
jewel,9326,jewel,JuL,6,5,1,2,4
jewry,9327,Jewry,JUri,2,2,0,1,1
jib,9328,jib,JIb,13,12,1,7,6
jiffy,9329,jiffy,JIfi,2,1,1,1,1
jig,9330,jig,JIg,17,15,2,10,7
jigger,9331,jigger,JIgX,6,5,1,3,3
jiggle,9332,jiggle,JIgL,8,6,2,5,3
jilt,9334,jilt,JIlt,10,10,0,9,1
jimmy,9335,jimmy,JImi,3,2,1,1,2
jingle,9337,jingle,JIGgL,9,7,2,8,1
jinx,9341,jinx,JIGks,2,2,0,2,0
jitters,9344,jitters,JItXz,1,1,0,1,0
job,9345,job,Jab,19,18,1,13,6
jobber,9346,jobber,JabX,3,2,1,2,1
jockey,9349,jockey,Jaki,5,5,0,3,2
jog,9355,jog,Jag,11,10,1,5,6
joggle,9356,joggle,JagL,5,4,1,3,2
johnny,9357,johnny,Jani,7,7,0,5,2
join,9358,join,JOn,8,5,3,6,2
joint,9359,joint,JOnt,5,4,1,3,2
joist,9360,joist,JOst,9,9,0,8,1
joke,9361,joke,Jok,11,10,1,11,0
jolly,9364,jolly,Jali,8,8,0,6,2
jolt,9365,jolt,Jolt,7,7,0,7,0
josh,9367,josh,JaS,7,7,0,2,5
joss,9368,joss,Jas,8,7,1,2,6
jostle,9369,jostle,JasL,5,4,1,3,2
jot,9370,jot,Jat,22,22,0,17,5
jounce,9371,jounce,JWns,3,2,1,3,0
journal,9372,journal,JRnL,3,3,0,2,1
journey,9376,journey,JRni,4,4,0,2,2
joust,9377,joust,JWst,5,4,1,5,0
jowl,9381,jowl,JWl,7,6,1,7,0
joy,9382,joy,JO,9,8,1,4,5
judge,9388,judge,J^J,6,5,1,4,2
jug,9395,jug,J^g,16,15,1,13,3
juggle,9397,juggle,J^gL,5,2,3,2,3
juggler,9398,juggler,J^gLX,1,0,1,0,1
juice,9400,juice,Jus,13,11,2,8,5
juicy,9401,juicy,Jusi,1,0,1,0,1
jumble,9407,jumble,J^mbL,7,6,1,6,1
jumbo,9408,jumbo,J^mbo,2,2,0,1,1
jump,9409,jump,J^mp,8,8,0,8,0
junco,9410,junco,J^Gko,2,1,1,1,1
june,9413,June,Jun,16,15,1,12,4
jungle,9414,jungle,J^GgL,3,2,1,2,1
junk,9417,junk,J^Gk,9,8,1,8,1
junker,9418,Junker,yUGkX,1,1,0,1,0
juror,9425,juror,JUrX,1,1,0,0,1
just,9426,just,J^st,12,10,2,11,1
jut,9430,jut,J^t,15,14,1,12,3
jute,9431,jute,Jut,17,16,1,13,4
k,9435,k,ke,32,21,11,17,15
kaiser,9438,kaiser,kYzX,4,4,0,4,0
kale,9439,kale,kel,36,32,4,27,9
karakul,9447,karakul,k@rxkL,2,2,0,1,1
karma,9449,karma,karmx,2,0,2,0,2
kayak,9451,kayak,kY@k,3,3,0,3,0
kayo,9452,kayo,keo,10,9,1,1,9
kazoo,9453,kazoo,kxzu,1,1,0,0,1
kedge,9454,kedge,kEJ,11,10,1,7,4
keel,9455,keel,kil,29,24,5,24,5
keen,9456,keen,kin,25,21,4,22,3
keep,9457,keep,kip,21,19,2,18,3
keg,9458,keg,kEg,8,8,0,4,4
kelp,9460,kelp,kElp,3,3,0,2,1
kelt,9461,Kelt,kElt,13,13,0,11,2
ken,9462,ken,kEn,28,25,3,22,6
kennel,9463,kennel,kEnL,4,3,1,2,2
kepi,9464,kepi,kepi,4,3,1,1,3
kept,9465,kept,kEpt,3,2,1,2,1
ketch,9468,ketch,kEC,12,10,2,8,4
kettle,9469,kettle,kEtL,8,8,0,7,1
khaki,9470,khaki,k@ki,12,12,0,5,7
kick,9475,kick,kIk,28,23,5,18,10
kid,9477,kid,kId,24,21,3,16,8
kill,9480,kill,kIl,36,31,5,26,10
killing,9481,killing,kIlIG,7,6,1,7,0
kiln,9482,kiln,kIln,3,1,2,0,3
kilo,9483,kilo,kilo,3,2,1,1,2
kilt,9487,kilt,kIlt,17,13,4,12,5
kilter,9488,kilter,kIltX,2,1,1,1,1
kin,9490,kin,kIn,33,28,5,23,10
kind,9491,kind,kYnd,7,6,1,6,1
kindle,9494,kindle,kIndL,1,1,0,1,0
kine,9498,kine,kYn,23,22,1,21,2
king,9501,king,kIG,17,15,2,8,9
kink,9502,kink,kIGk,15,11,4,12,3
kip,9507,kip,kIp,31,27,4,22,9
kipper,9508,kipper,kIpX,9,7,2,8,1
kirk,9509,kirk,kIrk,3,2,1,1,2
kirtle,9510,kirtle,kRtL,10,9,1,6,4
kiss,9512,kiss,kIs,13,13,0,5,8
kit,9513,kit,kIt,35,28,7,23,12
kite,9517,kite,kYt,20,19,1,19,1
kith,9518,kith,kIT,11,11,0,3,8
kitten,9519,kitten,kItN,7,6,1,5,2
kitty,9520,kitty,kIti,8,7,1,6,2
knack,9522,knack,n@k,20,19,1,15,5
knave,9524,knave,nev,15,12,3,9,6
knavery,9525,knavery,nevXi,1,0,1,0,1
knead,9527,knead,nid,21,16,5,11,10
knee,9528,knee,ni,31,23,8,19,12
kneel,9529,kneel,nil,27,23,4,20,7
kneeled,9530,kneeled,nild,6,4,2,4,2
knell,9531,knell,nEl,21,18,3,17,4
knelt,9532,knelt,nElt,11,9,2,8,3
knickers,9533,knickers,nIkXz,1,0,1,0,1
knife,9535,knife,nYf,8,7,1,4,4
knight,9536,knight,nYt,24,22,2,19,5
knit,9537,knit,nIt,28,27,1,22,6
knives,9538,knives,nYvz,3,3,0,3,0
knob,9539,knob,nab,21,18,3,15,6
knobbed,9540,knobbed,nabd,4,2,2,0,4
knobby,9541,knobby,nabi,6,5,1,3,3
knock,9542,knock,nak,19,19,0,15,4
knoll,9544,knoll,nol,27,25,2,19,8
knot,9545,knot,nat,27,27,0,23,4
know,9546,know,no,27,19,8,14,13
knowable,9547,knowable,noxbL,2,0,2,2,0
knowledge,9548,knowledge,nalIJ,2,2,0,2,0
known,9549,known,non,26,22,4,18,8
knuckle,9550,knuckle,n^kL,6,6,0,4,2
koran,9555,Koran,kX@n,5,4,1,2,3
korean,9556,Korean,kXixn,1,0,1,0,1
koruna,9557,koruna,kcrxna,2,2,0,0,2
kosher,9558,kosher,koSX,1,1,0,0,1
kraut,9560,kraut,krWt,7,6,1,3,4
krona,9562,krona,kronx,3,2,1,1,2
kulak,9564,kulak,kul@k,1,0,1,1,0
lab,9567,lab,l@b,20,18,2,10,10
label,9568,label,lebL,11,9,2,8,3
labial,9569,labial,lebiL,1,0,1,0,1
labor,9571,labor,lebX,7,6,1,5,2
lac,9578,lac,l@k,38,29,9,24,14
lace,9579,lace,les,29,25,4,18,11
lackey,9585,lackey,l@ki,10,7,3,4,6
lacquer,9588,lacquer,l@kX,12,10,2,4,8
lacrosse,9589,lacrosse,lxkrcs,1,0,1,1,0
lacy,9594,lacy,lesi,5,4,1,2,3
lad,9595,lad,l@d,34,27,7,21,13
ladder,9596,ladder,l@dX,10,7,3,4,6
laddie,9597,laddie,l@di,7,6,1,4,3
laden,9598,laden,ledN,4,3,1,1,3
ladle,9600,ladle,ledL,4,3,1,0,4
lady,9601,lady,ledi,6,5,1,1,5
lag,9603,lag,l@g,27,25,2,17,10
lager,9604,lager,lagX,2,2,0,0,2
laid,9608,laid,led,30,23,7,17,13
lain,9609,lain,len,33,29,4,23,10
lair,9610,lair,lEr,30,25,5,22,8
laird,9611,laird,lErd,6,4,2,2,4
lake,9613,lake,lek,32,28,4,22,10
lamb,9614,lamb,l@m,27,23,4,16,11
lame,9618,lame,lem,28,23,5,18,10
lamp,9625,lamp,l@mp,11,8,3,9,2
lance,9629,lance,l@ns,10,7,3,5,5
lancer,9630,lancer,l@nsX,3,1,2,2,1
land,9632,land,l@nd,14,9,5,11,3
landau,9633,landau,l@ndW,1,0,1,0,1
landed,9634,landed,l@nd|d,1,1,0,1,0
languor,9647,languor,l@GgX,3,2,1,3,0
lank,9648,lank,l@Gk,17,10,7,15,2
lanky,9649,lanky,l@Gki,4,2,2,2,2
lap,9654,lap,l@p,30,25,5,18,12
lapse,9660,lapse,l@ps,8,4,4,4,4
larch,9664,larch,larC,6,5,1,3,3
lard,9665,lard,lard,15,14,1,11,4
larder,9666,larder,lardX,2,0,2,1,1
large,9667,large,larJ,7,6,1,3,4
lark,9671,lark,lark,11,9,2,7,4
larva,9672,larva,larvx,1,0,1,1,0
lascar,9677,lascar,l@skX,1,0,1,0,1
lash,9679,lash,l@S,26,21,5,16,10
lass,9680,lass,l@s,30,22,8,15,15
lasso,9682,lasso,l@so,3,2,1,1,2
last,9683,last,l@st,14,12,2,12,2
latch,9685,latch,l@C,18,18,0,8,10
latchet,9686,latchet,l@C|t,2,2,0,2,0
latchkey,9687,latchkey,l@Cki,2,1,1,1,1
late,9688,late,let,32,26,6,21,11
lateral,9690,lateral,l@tXL,2,1,1,1,1
lath,9692,lath,l@T,15,15,0,5,10
lathe,9693,lathe,leD,13,12,1,3,10
lather,9694,lather,l@DX,8,7,1,4,4
latin,9695,Latin,l@tN,8,6,2,7,1
latter,9699,latter,l@tX,21,17,4,15,6
laud,9702,laud,lcd,13,12,1,8,5
laugh,9705,laugh,l@f,19,19,0,9,10
launch,9706,launch,lcnC,5,4,1,4,1
laurel,9709,laurel,lcrL,5,4,1,4,1
lava,9710,lava,lavx,3,2,1,2,1
lave,9714,lave,lev,22,20,2,12,10
lavish,9716,lavish,l@vIS,1,1,0,1,0
law,9717,law,lc,24,15,9,14,10
lawn,9718,lawn,lcn,19,16,3,13,6
lawsuit,9720,lawsuit,lcsut,1,0,1,0,1
lawyer,9721,lawyer,lOX,7,6,1,4,3
lax,9722,lax,l@ks,11,7,4,5,6
lay,9725,lay,le,35,20,15,20,15
layer,9726,layer,leX,16,14,2,5,11
layette,9727,layette,leEt,2,0,2,1,1
layman,9728,layman,lemxn,1,1,0,1,0
lazar,9730,lazar,l@zX,4,4,0,0,4
laze,9731,laze,lez,23,19,4,12,11
lazy,9732,lazy,lezi,7,6,1,4,3
lea,9734,lea,li,43,22,21,24,19
leach,9735,leach,liC,22,19,3,8,14
lead,9736,lead,lEd,31,23,8,20,11
leaden,9737,leaden,lEdN,5,4,1,3,2
leaf,9738,leaf,lif,25,24,1,11,14
league,9742,league,lig,19,17,2,4,15
leak,9743,leak,lik,36,31,5,22,14
leal,9745,leal,lil,31,29,2,17,14
lean,9746,lean,lin,33,30,3,19,14
leap,9747,leap,lip,30,27,3,15,15
leapt,9750,leapt,lipt,4,2,2,1,3
learn,9751,learn,lRn,16,14,2,13,3
learned,9752,learned,lRnd,4,3,1,3,1
learning,9753,learning,lRnIG,1,1,0,1,0
lease,9754,lease,lis,27,24,3,12,15
leash,9755,leash,liS,16,15,1,2,14
least,9756,least,list,12,9,3,9,3
leather,9757,leather,lEDX,10,10,0,6,4
leave,9758,leave,liv,26,21,5,11,15
leaven,9759,leaven,lEvxn,7,5,2,6,1
leaves,9760,leaves,livz,8,5,3,6,2
ledge,9766,ledge,lEJ,18,13,5,10,8
ledger,9767,ledger,lEJX,6,5,1,1,5
leer,9768,leer,lIr,34,28,6,25,9
leery,9769,leery,lIri,10,7,3,7,3
lees,9770,lees,liz,25,21,4,10,15
left,9773,left,lEft,11,8,3,7,4
leg,9776,leg,lEg,15,14,1,7,8
legal,9778,legal,ligL,6,3,3,4,2
legate,9783,legate,lEgxt,2,1,1,0,2
legatee,9784,legatee,lEgxti,2,1,1,1,1
legged,9789,legged,lEgd,4,2,2,0,4
leggin,9790,leggin,lEgxn,3,3,0,2,1
leisure,9804,leisure,liZX,3,3,0,1,2
lek,9806,lek,lEk,23,22,1,16,7
lemon,9808,lemon,lEmxn,3,3,0,3,0
lend,9811,lend,lEnd,17,14,3,12,5
lens,9818,lens,lEnz,4,3,1,2,2
lent,9819,lent,lEnt,17,15,2,11,6
lentil,9820,lentil,lEntL,6,5,1,5,1
leo,9821,Leo,lio,17,13,4,2,15
leopard,9823,leopard,lEpXd,2,1,1,1,1
leper,9825,leper,lEpX,6,5,1,1,5
less,9831,less,lEs,24,19,5,14,10
lessee,9832,lessee,lEsi,5,4,1,1,4
lessen,9833,lessen,lEsN,6,5,1,2,4
lest,9835,lest,lEst,23,20,3,17,6
let,9836,let,lEt,30,25,5,19,11
lethal,9838,lethal,liTL,1,1,0,0,1
letter,9841,letter,lEtX,13,12,1,8,5
leu,9845,leu,lu,36,23,13,23,13
lev,9848,lev,lEf,17,14,3,9,8
leva,9849,leva,lEvx,5,4,1,1,4
levee,9850,levee,lEvi,6,6,0,2,4
level,9851,level,lEvL,6,6,0,3,3
lever,9853,lever,lEvX,13,11,2,6,7
levity,9857,levity,lEvxti,2,2,0,2,0
lewd,9858,lewd,lud,21,19,2,13,8
liable,9862,liable,lYxbL,3,1,2,3,0
liar,9864,liar,lYX,18,13,5,5,13
libel,9866,libel,lYbL,3,2,1,3,0
liberal,9867,liberal,lIbXL,3,1,2,2,1
liberally,9871,liberally,lIbXLi,1,0,1,0,1
lice,9885,lice,lYs,26,22,4,15,11
lichen,9890,lichen,lYkxn,2,2,0,1,1
licit,9891,licit,lIs|t,5,2,3,4,1
lick,9892,lick,lIk,32,26,6,22,10
lid,9894,lid,lId,23,21,2,16,7
lido,9895,lido,lido,2,1,1,0,2
lie,9896,lie,lY,36,21,15,21,15
lied,9897,lied,lit,40,29,11,23,17
lieder,9898,lieder,lidX,5,5,0,2,3
liege,9899,liege,liJ,17,16,1,3,14
life,9901,life,lYf,20,18,2,9,11
lifer,9905,lifer,lYfX,5,3,2,1,4
lift,9907,lift,lIft,11,10,1,6,5
light,9910,light,lYt,35,26,9,22,13
lighten,9911,lighten,lYtN,6,5,1,3,3
lighter,9912,lighter,lYtX,14,12,2,8,6
lightning,9915,lightning,lYtnIG,1,0,1,1,0
lights,9916,lights,lYts,5,3,2,1,4
like,9920,like,lYk,26,24,2,16,10
liken,9923,liken,lYk|n,2,1,1,1,1
liking,9925,liking,lYkIG,3,2,1,3,0
lilt,9927,lilt,lIlt,14,13,1,8,6
lily,9928,lily,lIli,5,5,0,3,2
limb,9929,limb,lIm,20,17,3,11,9
limber,9931,limber,lImbX,3,3,0,2,1
limbo,9933,limbo,lImbo,1,1,0,0,1
lime,9934,lime,lYm,23,19,4,12,11
limit,9939,limit,lIm|t,2,2,0,2,0
limp,9943,limp,lImp,10,6,4,6,4
limy,9945,limy,lYmi,2,1,1,1,1
linage,9946,linage,lYnIJ,1,1,0,0,1
linden,9948,linden,lInd|n,1,0,1,0,1
line,9949,line,lYn,32,28,4,20,12
lineal,9951,lineal,lIniL,2,2,0,0,2
linear,9953,linear,lIniX,1,1,0,0,1
linen,9955,linen,lIn|n,2,1,1,0,2
liner,9956,liner,lYnX,7,5,2,3,4
ling,9959,ling,lIG,21,16,5,13,8
linger,9960,linger,lIGgX,4,4,0,3,1
lingo,9962,lingo,lIGgo,1,1,0,0,1
lining,9966,lining,lYnIG,5,3,2,4,1
link,9967,link,lIGk,17,10,7,14,3
links,9968,links,lIGks,3,2,1,2,1
linnet,9970,linnet,lIn|t,5,4,1,3,2
lint,9973,lint,lInt,16,11,5,8,8
lintel,9974,lintel,lIntL,4,2,2,2,2
lion,9975,lion,lY|n,5,2,3,4,1
lip,9979,lip,lIp,29,23,6,19,10
lipped,9980,lipped,lIpt,7,5,2,1,6
lipstick,9982,lipstick,lIpstIk,1,1,0,1,0
liqueur,9985,liqueur,lIkR,3,2,1,1,2
liquor,9989,liquor,lIkX,14,11,3,10,4
lira,9990,lira,lIrx,4,1,3,1,3
lisle,9991,lisle,lYl,24,22,2,14,10
lisp,9992,lisp,lIsp,5,4,1,1,4
list,9994,list,lIst,19,16,3,10,9
listen,9995,listen,lIsN,5,4,1,3,2
lists,9997,lists,lIsts,1,0,1,0,1
lit,9998,lit,lIt,37,26,11,23,14
literal,10000,literal,lItXL,4,2,2,2,2
lithe,10008,lithe,lYD,15,14,1,5,10
litre,10020,litre,litX,11,10,1,8,3
litter,10021,litter,lItX,13,10,3,8,5
little,10022,little,lItL,6,3,3,3,3
live,10028,live,lIv,15,13,2,7,8
liven,10033,liven,lYvxn,2,2,0,2,0
liver,10034,liver,lIvX,10,6,4,6,4
livery,10037,livery,lIvXi,1,0,1,0,1
lives,10038,lives,lYvz,5,5,0,5,0
llama,10043,llama,lamx,4,3,1,3,1
lo,10045,lo,lo,35,18,17,20,15
load,10046,load,lod,27,24,3,16,11
loaf,10047,loaf,lof,16,14,2,6,10
loam,10048,loam,lom,23,21,2,13,10
loan,10049,loan,lon,34,28,6,23,11
loath,10050,loath,loT,13,11,2,3,10
loathe,10051,loathe,loD,13,11,2,3,10
loaves,10055,loaves,lovz,2,2,0,2,0
lob,10056,lob,lab,20,17,3,14,6
lobar,10057,lobar,lobX,5,3,2,3,2
lobby,10058,lobby,labi,4,3,1,3,1
lobe,10059,lobe,lob,15,12,3,4,11
lobster,10060,lobster,labstX,1,1,0,1,0
local,10061,local,lokL,2,2,0,2,0
loch,10068,loch,lak,31,25,6,23,8
locker,10070,locker,lakX,9,8,1,5,4
locket,10071,locket,lak|t,4,4,0,4,0
lodge,10078,lodge,laJ,10,8,2,3,7
lodger,10080,lodger,laJX,6,5,1,3,3
loft,10081,loft,lcft,7,4,3,5,2
lofty,10082,lofty,lcfti,1,0,1,0,1
log,10083,log,lcg,13,12,1,8,5
loge,10086,loge,loZ,10,9,1,0,10
logy,10094,logy,logi,2,2,0,2,0
loin,10095,loin,lOn,11,11,0,9,2
loiter,10096,loiter,lOtX,7,6,1,6,1
loll,10097,loll,lal,10,10,0,5,5
long,10099,long,lcG,13,11,2,8,5
longer,10100,longer,lcGgX,2,2,0,2,0
look,10107,look,lUk,17,17,0,16,1
loom,10109,loom,lum,25,19,6,17,8
loon,10110,loon,lun,25,23,2,16,9
looney,10111,looney,luni,1,0,1,0,1
loop,10112,loop,lup,18,16,2,10,8
loose,10113,loose,lus,23,20,3,14,9
loosen,10114,loosen,lusN,4,2,2,2,2
loot,10115,loot,lut,26,24,2,18,8
lop,10116,lop,lap,22,18,4,17,5
lord,10119,lord,lord,13,11,2,10,3
lore,10120,lore,lor,33,29,4,21,12
lorn,10122,lorn,lorn,11,9,2,8,3
lorry,10123,lorry,lcri,2,2,0,1,1
lose,10124,lose,luz,17,14,3,9,8
loss,10126,loss,lcs,19,15,4,13,6
lost,10127,lost,lcst,9,7,2,6,3
lot,10128,lot,lat,31,26,5,26,5
lottery,10131,lottery,latXi,1,1,0,1,0
loud,10132,loud,lWd,12,10,2,9,3
lounge,10133,lounge,lWnJ,1,1,0,1,0
lour,10134,lour,lWr,12,10,2,9,3
louse,10135,louse,lWs,14,13,1,11,3
lousy,10136,lousy,lWzi,2,1,1,2,0
lout,10137,lout,lWt,20,17,3,17,3
louvre,10138,louvre,luvX,4,4,0,3,1
love,10140,love,l^v,11,10,1,5,6
lower,10143,lower,loX,16,13,3,5,11
lox,10146,lox,laks,8,5,3,6,2
loyal,10147,loyal,lOL,3,3,0,1,2
luau,10149,luau,luW,8,7,1,0,8
lubber,10150,lubber,l^bX,5,3,2,4,1
lucent,10155,lucent,lusNt,1,0,1,0,1
luck,10161,luck,l^k,26,23,3,19,7
lucky,10162,lucky,l^ki,3,1,2,2,1
lucre,10164,lucre,lukX,5,5,0,4,1
luff,10167,luff,l^f,20,18,2,14,6
lug,10168,lug,l^g,22,20,2,16,6
lull,10172,lull,l^l,15,15,0,9,6
lumber,10175,lumber,l^mbX,6,3,3,5,1
lump,10181,lump,l^mp,13,10,3,13,0
lunch,10184,lunch,l^nC,7,7,0,6,1
luncheon,10185,luncheon,l^nC|n,1,1,0,1,0
lung,10189,lung,l^G,18,15,3,12,6
lunge,10190,lunge,l^nJ,3,2,1,2,1
lurch,10192,lurch,lRC,8,8,0,6,2
lure,10193,lure,lUr,9,8,1,8,1
lurk,10195,lurk,lRk,20,18,2,18,2
lush,10197,lush,l^S,16,12,4,10,6
lust,10198,lust,l^st,13,11,2,11,2
lustre,10200,lustre,l^stX,6,2,4,4,2
lusty,10201,lusty,l^sti,4,3,1,2,2
lying,10207,lying,lYIG,3,0,3,3,0
lymph,10208,lymph,lImf,3,2,1,1,2
lynch,10210,lynch,lInC,10,7,3,9,1
lyre,10211,lyre,lYr,25,23,2,15,10
lyric,10212,lyric,lIrxk,1,0,1,0,1
m,10213,m,Em,15,11,4,7,8
ma,10214,ma,ma,14,9,5,1,13
mace,10220,mace,mes,29,25,4,18,11
mad,10235,mad,m@d,28,23,5,17,11
madam,10236,madam,m@dM,3,2,1,0,3
madden,10239,madden,m@dN,5,4,1,2,3
madder,10240,madder,m@dX,8,6,2,3,5
madding,10241,madding,m@dIG,2,2,0,2,0
made,10242,made,med,24,21,3,14,10
maggot,10254,maggot,m@g|t,3,2,1,2,1
magnate,10264,magnate,m@gnet,1,1,0,0,1
magnet,10266,magnet,m@gn|t,2,1,1,0,2
mail,10288,mail,mel,35,31,4,24,11
mailed,10289,mailed,meld,6,4,2,3,3
maim,10290,maim,mem,21,19,2,12,9
main,10291,main,men,31,27,4,21,10
maize,10296,maize,mez,19,16,3,9,10
major,10300,major,meJX,4,2,2,2,2
make,10304,make,mek,25,23,2,16,9
malay,10317,Malay,mxle,3,2,1,3,0
malice,10329,malice,m@lxs,5,5,0,5,0
malign,10331,malign,mxlYn,1,0,1,1,0
mall,10335,mall,mcl,24,20,4,20,4
mallet,10339,mallet,m@l|t,6,6,0,6,0
mallow,10340,mallow,m@lo,9,8,1,8,1
malt,10346,malt,mclt,7,6,1,6,1
mama,10348,mama,mamx,4,3,1,3,1
mammal,10350,mammal,m@mL,1,1,0,1,0
mammon,10353,mammon,m@mxn,4,4,0,3,1
mammoth,10354,mammoth,m@mxT,1,1,0,0,1
man,10355,man,m@n,26,21,5,15,11
manful,10376,manful,m@nfL,1,1,0,0,1
mange,10378,mange,menJ,5,2,3,2,3
manger,10379,manger,menJX,5,3,2,2,3
mangle,10380,mangle,m@GgL,10,9,1,9,1
mango,10381,mango,m@Ggo,2,2,0,1,1
mangy,10383,mangy,menJi,2,1,1,0,2
manna,10402,manna,m@nx,6,4,2,1,5
manned,10403,manned,m@nd,15,12,3,10,5
manner,10405,manner,m@nX,10,9,1,4,6
manse,10410,manse,m@ns,10,8,2,5,5
mansion,10412,mansion,m@nC|n,1,1,0,1,0
manta,10415,manta,m@ntx,3,2,1,0,3
manteau,10416,manteau,m@nto,3,3,0,1,2
mantel,10417,mantel,m@ntL,5,5,0,2,3
manx,10428,Manx,m@Gks,1,1,0,1,0
many,10429,many,mEni,7,5,2,3,4
maori,10431,Maori,mWri,4,4,0,3,1
map,10432,map,m@p,20,20,0,13,7
maple,10433,maple,mepL,2,1,1,1,1
mar,10434,mar,mar,26,16,10,13,13
marble,10438,marble,marbL,3,3,0,1,2
march,10440,march,marC,11,9,2,3,8
mare,10442,mare,mEr,23,21,2,18,5
marge,10444,marge,marJ,11,10,1,3,8
marina,10451,marina,mXinx,1,0,1,0,1
marine,10453,marine,mXin,7,5,2,4,3
mark,10459,mark,mark,20,14,6,7,13
marked,10461,marked,markt,5,2,3,0,5
market,10463,market,mark|t,1,0,1,0,1
markka,10464,markka,marka,3,2,1,0,3
marl,10467,marl,marl,10,8,2,1,9
maroon,10474,maroon,mXun,3,2,1,1,2
marquee,10476,marquee,marki,4,2,2,0,4
marquise,10479,marquise,markiz,1,0,1,0,1
marrow,10482,marrow,m@ro,9,8,1,7,2
marry,10483,marry,m@ri,11,10,1,10,1
mars,10484,Mars,marz,8,7,1,0,8
marsh,10485,marsh,marS,10,8,2,1,9
marshal,10486,marshal,marSL,4,3,1,1,3
mart,10489,mart,mart,19,13,6,8,11
marten,10490,marten,martN,5,4,1,3,2
martyr,10495,martyr,martX,7,6,1,5,2
marvel,10496,marvel,marvL,2,2,0,0,2
mash,10504,mash,m@S,20,18,2,13,7
mask,10505,mask,m@sk,8,6,2,6,2
mason,10507,mason,mesN,6,5,1,4,2
mass,10511,mass,m@s,26,20,6,16,10
massive,10517,massive,m@sIv,2,2,0,2,0
mast,10518,mast,m@st,14,11,3,10,4
master,10519,master,m@stX,8,4,4,6,2
mastery,10523,mastery,m@stXi,2,1,1,1,1
mat,10532,mat,m@t,30,27,3,21,9
match,10534,match,m@C,14,14,0,7,7
mate,10536,mate,met,28,26,2,19,9
math,10544,math,m@T,15,15,0,8,7
matter,10558,matter,m@tX,16,13,3,13,3
matting,10559,matting,m@tIG,4,4,0,4,0
mauve,10570,mauve,mov,13,12,1,6,7
maw,10573,maw,mc,22,18,4,11,11
may,10579,may,me,32,23,9,15,17
maya,10580,maya,mayx,1,1,0,0,1
mayapple,10581,mayapple,me@pL,1,0,1,0,1
maybe,10582,maybe,mebi,2,2,0,1,1
mayor,10586,mayor,meX,12,10,2,2,10
mazy,10589,mazy,mezi,6,5,1,4,2
me,10591,me,mi,32,25,7,18,14
mead,10592,mead,mid,20,19,1,14,6
meadow,10593,meadow,mEdo,4,3,1,0,4
meadowy,10595,meadowy,mEdoi,2,1,1,0,2
meagre,10596,meagre,migX,2,1,1,1,1
meal,10597,meal,mil,28,26,2,22,6
mean,10600,mean,min,23,21,2,17,6
meaning,10602,meaning,minIG,1,1,0,1,0
meant,10603,meant,mEnt,18,15,3,12,6
meat,10610,meat,mit,25,22,3,18,7
mecca,10611,mecca,mEkx,1,1,0,1,0
medal,10617,medal,mEdL,7,7,0,5,2
meddler,10619,meddler,mEdlX,2,2,0,1,1
medial,10622,medial,midiL,1,1,0,1,0
medley,10640,medley,mEdli,2,2,0,0,2
meek,10642,meek,mik,21,19,2,15,6
meeting,10644,meeting,mitIG,2,2,0,2,0
meld,10652,meld,mEld,10,9,1,7,3
melee,10653,melee,mele,3,2,1,1,2
mellow,10658,mellow,mElo,10,10,0,6,4
melt,10666,melt,mElt,15,13,2,11,4
member,10667,member,mEmbX,1,0,1,1,0
memo,10670,memo,mEmo,2,2,0,0,2
men,10678,men,mEn,27,22,5,20,7
menace,10679,menace,mEn|s,2,2,0,2,0
mend,10682,mend,mEnd,18,14,4,14,4
menial,10686,menial,miniL,2,2,0,2,0
mental,10695,mental,mEntL,7,5,2,6,1
mention,10698,mention,mEnC|n,4,4,0,4,0
meow,10701,meow,miW,7,5,2,1,6
mercer,10707,mercer,mRsX,6,6,0,2,4
mercy,10712,mercy,mRsi,2,2,0,1,1
mere,10713,mere,mIr,31,27,4,23,8
merge,10715,merge,mRJ,11,7,4,7,4
merger,10716,merger,mRJX,7,6,1,3,4
merry,10724,merry,mEri,11,9,2,9,2
mesa,10725,mesa,mesx,2,1,1,0,2
mesh,10728,mesh,mES,6,6,0,2,4
mess,10733,mess,mEs,18,17,1,14,4
met,10741,met,mEt,26,23,3,19,7
metal,10745,metal,mEtL,11,9,2,9,2
meteor,10760,meteor,mitiX,1,0,1,0,1
meter,10764,meter,mitX,11,8,3,8,3
mew,10777,mew,myu,11,5,6,8,3
mews,10778,mews,myuz,6,3,3,3,3
mica,10782,mica,mYkx,3,2,1,1,2
mice,10783,mice,mYs,22,20,2,15,7
mid,10794,mid,mId,26,20,6,15,11
midday,10795,midday,mIde,4,3,1,0,4
midden,10796,midden,mIdN,11,10,1,5,6
middle,10797,middle,mIdL,12,11,1,7,5
middling,10800,middling,mIdlIG,1,0,1,1,0
middy,10801,middy,mIdi,6,5,1,2,4
midge,10802,midge,mIJ,10,9,1,3,7
midget,10803,midget,mIJ|t,4,4,0,4,0
midst,10805,midst,mIdst,1,0,1,1,0
miff,10809,miff,mIf,10,9,1,3,7
might,10810,might,mYt,28,24,4,19,9
mighty,10811,mighty,mYti,2,1,1,0,2
mike,10818,mike,mYk,19,17,2,11,8
mil,10819,mil,mIl,31,29,2,23,8
milch,10820,milch,mIlk,5,3,2,3,2
mild,10821,mild,mYld,8,7,1,6,2
mile,10823,mile,mYl,28,24,4,20,8
millet,10839,millet,mIl|t,5,5,0,5,0
milling,10845,milling,mIlIG,6,5,1,6,0
mime,10850,mime,mYm,14,13,1,7,7
mince,10857,mince,mIns,8,7,1,4,4
mind,10859,mind,mYnd,12,11,1,8,4
mine,10860,mine,mYn,28,24,4,18,10
miner,10862,miner,mYnX,9,8,1,4,5
mingle,10867,mingle,mIGgL,8,7,1,8,0
minister,10874,minister,mIn|stX,2,1,1,2,0
mink,10879,mink,mIGk,13,11,2,11,2
minnow,10881,minnow,mIno,3,3,0,1,2
minster,10883,minster,mInstX,3,1,2,3,0
mint,10885,mint,mInt,12,10,2,7,5
minus,10888,minus,mYn|s,3,3,0,3,0
minute,10889,minute,mIn|t,4,3,1,3,1
minx,10892,minx,mIGks,5,3,2,4,1
mire,10896,mire,mYr,21,19,2,14,7
mirror,10897,mirror,mIrX,1,0,1,0,1
mirth,10898,mirth,mRT,13,11,2,10,3
miser,10930,miser,mYzX,7,7,0,5,2
miss,10953,miss,mIs,23,18,5,12,11
missal,10954,missal,mIsL,5,4,1,2,3
missing,10957,missing,mIsIG,2,2,0,1,1
missive,10959,missive,mIsIv,2,2,0,1,1
mist,10961,mist,mIst,16,11,5,10,6
mister,10964,mister,mIstX,7,4,3,4,3
misty,10970,misty,mIsti,5,2,3,1,4
mitre,10976,mitre,mYtX,11,10,1,7,4
mitt,10977,mitt,mIt,33,27,6,23,10
mitten,10978,mitten,mItN,8,6,2,5,3
mix,10979,mix,mIks,7,5,2,5,2
mizen,10981,mizen,mIzN,3,3,0,1,2
moan,10983,moan,mon,27,24,3,19,8
moat,10984,moat,mot,31,23,8,20,11
mob,10985,mob,mab,15,14,1,10,5
mobile,10986,mobile,mobL,5,4,1,2,3
mobster,10990,mobster,mabstX,2,2,0,2,0
mock,10992,mock,mak,24,20,4,17,7
modal,10993,modal,modL,9,8,1,5,4
mode,10994,mode,mod,24,20,4,15,9
model,10995,model,madL,9,9,0,8,1
mogul,11017,mogul,mogL,4,3,1,1,3
moil,11020,moil,mOl,14,13,1,14,0
moist,11022,moist,mOst,9,9,0,8,1
moisten,11023,moisten,mOsN,2,2,0,1,1
molar,11025,molar,molX,11,9,2,5,6
mold,11027,mold,mold,18,14,4,12,6
molder,11029,molder,moldX,5,2,3,3,2
mole,11031,mole,mol,33,28,5,22,11
moll,11038,moll,mal,16,14,2,10,6
molt,11043,molt,molt,15,12,3,8,7
molten,11044,molten,moltN,1,0,1,0,1
moly,11045,moly,moli,8,7,1,3,5
monday,11062,Monday,m^nde,2,1,1,1,1
money,11064,money,m^ni,10,10,0,6,4
monger,11066,monger,m^GgX,1,1,0,1,0
mongol,11067,Mongol,maGgL,2,2,0,2,0
monitor,11072,monitor,man|tX,1,1,0,0,1
monk,11074,monk,m^Gk,12,10,2,9,3
monkey,11075,monkey,m^Gki,1,0,1,0,1
monster,11105,monster,manstX,3,3,0,2,1
month,11110,month,m^nT,2,2,0,0,2
moo,11113,moo,mu,32,26,6,19,13
mood,11114,mood,mud,17,15,2,11,6
moody,11115,moody,mudi,3,2,1,1,2
moon,11116,moon,mun,21,19,2,16,5
moor,11117,moor,mor,29,25,4,20,9
mooring,11118,mooring,mUrIG,1,1,0,1,0
moose,11120,moose,mus,19,18,1,14,5
moot,11121,moot,mut,24,22,2,19,5
mop,11122,mop,map,16,15,1,11,5
mope,11123,mope,mop,17,15,2,10,7
moraine,11125,moraine,mXen,4,3,1,2,2
moral,11126,moral,mcrL,6,3,3,6,0
morale,11127,morale,mX@l,2,2,0,1,1
morass,11134,morass,mX@s,4,3,1,2,2
morgue,11142,morgue,morg,2,1,1,0,2
morn,11146,morn,morn,12,9,3,8,4
moron,11150,moron,moran,2,1,1,1,1
morose,11152,morose,mXos,1,1,0,0,1
morrow,11161,morrow,maro,12,11,1,3,9
morsel,11162,morsel,morsL,2,2,0,1,1
mortal,11163,mortal,mortL,7,4,3,4,3
mortally,11165,mortally,mortLi,1,0,1,0,1
mortar,11166,mortar,mortX,4,3,1,3,1
mosey,11176,mosey,mozi,6,6,0,5,1
mosque,11178,mosque,mask,4,3,1,2,2
moss,11180,moss,mcs,15,14,1,12,3
most,11181,most,most,13,12,1,11,2
mot,11182,mot,mo,30,21,9,15,15
moth,11185,moth,mcT,8,7,1,5,3
mother,11186,mother,m^DX,4,2,2,2,2
motile,11189,motile,motL,10,8,2,5,5
motor,11196,motor,motX,9,7,2,6,3
mottle,11199,mottle,matL,8,8,0,6,2
motto,11200,motto,mato,2,2,0,0,2
mound,11201,mound,mWnd,11,11,0,10,1
mount,11202,mount,mWnt,7,5,2,5,2
mountain,11203,mountain,mWntN,2,1,1,1,1
mouse,11208,mouse,mWs,14,12,2,11,3
mouser,11209,mouser,mWzX,1,1,0,1,0
mousey,11210,mousey,mWsi,3,2,1,1,2
mouth,11212,mouth,mWT,7,6,1,5,2
move,11215,move,muv,8,5,3,1,7
mover,11216,mover,muvX,3,2,1,1,2
movie,11217,movie,muvi,3,2,1,0,3
mow,11218,mow,mW,20,17,3,10,10
much,11219,much,m^C,17,14,3,6,11
muck,11222,muck,m^k,25,22,3,14,11
mud,11224,mud,m^d,20,19,1,10,10
muddle,11225,muddle,m^dL,12,11,1,8,4
muff,11230,muff,m^f,18,17,1,8,10
muffin,11231,muffin,m^fxn,2,2,0,2,0
muffle,11232,muffle,m^fL,6,5,1,2,4
mufti,11234,mufti,m^fti,1,1,0,1,0
mug,11235,mug,m^g,21,19,2,11,10
muggy,11236,muggy,m^gi,4,3,1,1,3
mulch,11242,mulch,m^lC,4,2,2,1,3
mulct,11243,mulct,m^lkt,1,1,0,0,1
mule,11244,mule,myul,6,4,2,3,3
mull,11247,mull,m^l,24,23,1,14,10
mullein,11248,mullein,m^lxn,3,2,1,2,1
mullet,11249,mullet,m^l|t,4,4,0,3,1
mullion,11252,mullion,m^lyxn,1,0,1,0,1
mum,11262,mum,m^m,23,21,2,12,11
mumble,11263,mumble,m^mbL,6,5,1,6,0
mummer,11264,mummer,m^mX,6,5,1,2,4
mummy,11267,mummy,m^mi,8,7,1,4,4
mumps,11268,mumps,m^mps,1,1,0,1,0
munch,11269,munch,m^nC,8,7,1,4,4
mundane,11270,mundane,m^nden,1,0,1,0,1
murder,11276,murder,mRdX,5,5,0,2,3
murk,11277,murk,mRk,17,14,3,14,3
murmur,11278,murmur,mRmX,4,4,0,1,3
muscle,11281,muscle,m^sL,11,10,1,5,6
mush,11287,mush,m^S,15,15,0,6,9
musk,11292,musk,m^sk,11,9,2,6,5
muss,11301,muss,m^s,25,21,4,13,12
must,11303,must,m^st,16,12,4,10,6
mustard,11305,mustard,m^stXd,2,1,1,1,1
muster,11306,muster,m^stX,7,4,3,4,3
musty,11307,musty,m^sti,6,5,1,4,2
mute,11314,mute,myut,6,4,2,3,3
mutt,11321,mutt,m^t,30,26,4,18,12
mutter,11322,mutter,m^tX,15,12,3,11,4
mutton,11323,mutton,m^tN,4,3,1,2,2
muzzle,11326,muzzle,m^zL,6,6,0,3,3
my,11327,my,mY,32,24,8,17,15
mynah,11331,mynah,mYnx,6,5,1,2,4
myrrh,11335,myrrh,mR,18,15,3,7,11
myrtle,11336,myrtle,mRtL,7,7,0,7,0
mystery,11339,mystery,mIstXi,4,2,2,2,2
mystic,11340,mystic,mIstIk,4,3,1,2,2
mystical,11341,mystical,mIstIkL,1,0,1,0,1
mystique,11345,mystique,mIstik,2,1,1,0,2
myth,11346,myth,mIT,15,14,1,8,7
n,11350,n,En,29,13,16,18,11
nab,11351,nab,n@b,15,15,0,10,5
nacre,11354,nacre,nekX,4,3,1,2,2
nag,11356,nag,n@g,17,16,1,12,5
nail,11359,nail,nel,26,23,3,22,4
name,11365,name,nem,16,14,2,12,4
nap,11368,nap,n@p,20,19,1,15,5
nape,11370,nape,nep,14,12,2,10,4
nard,11381,nard,nard,12,11,1,9,3
nares,11382,nares,n@riz,1,1,0,1,0
naris,11383,naris,n@rxs,1,0,1,1,0
narrow,11388,narrow,n@ro,6,5,1,6,0
nasal,11391,nasal,nezL,5,5,0,3,2
nasty,11395,nasty,n@sti,3,2,1,3,0
natal,11396,natal,netL,4,4,0,2,2
natty,11411,natty,n@ti,7,5,2,6,1
nature,11417,nature,neCX,3,3,0,1,2
naught,11418,naught,nct,20,18,2,18,2
nautch,11421,nautch,ncC,5,4,1,3,2
naval,11425,naval,nevL,5,4,1,1,4
navy,11431,navy,nevi,5,3,2,2,3
nay,11432,nay,ne,25,21,4,15,10
neap,11436,neap,nip,19,18,1,13,6
near,11437,near,nIr,25,23,2,19,6
neat,11440,neat,nit,25,23,2,19,6
neath,11441,neath,niT,10,9,1,4,6
neb,11443,neb,nEb,10,9,1,7,3
neck,11452,neck,nEk,13,13,0,10,3
nectar,11460,nectar,nEktX,4,4,0,4,0
needle,11462,needle,nidL,6,5,1,3,3
needs,11465,needs,nidz,3,2,1,0,3
needy,11466,needy,nidi,4,3,1,1,3
neighbor,11480,neighbor,nebX,5,5,0,3,2
neither,11482,neither,niDX,2,1,1,2,0
neon,11488,neon,nian,2,2,0,2,0
nerve,11503,nerve,nRv,6,5,1,5,1
nest,11505,nest,nEst,15,13,2,11,4
nestle,11506,nestle,nEsL,5,5,0,3,2
net,11508,net,nEt,26,23,3,20,6
nether,11509,nether,nEDX,7,7,0,6,1
nettle,11511,nettle,nEtL,8,7,1,6,2
neuter,11523,neuter,nutX,4,3,1,3,1
never,11530,never,nEvX,4,3,1,3,1
newel,11534,newel,nuL,9,7,2,2,7
newly,11537,newly,nuli,3,3,0,2,1
news,11539,news,nuz,16,12,4,9,7
newsy,11541,newsy,nuzi,7,5,2,5,2
newt,11542,newt,nut,26,24,2,19,7
next,11543,next,nEkst,2,1,1,1,1
nib,11546,nib,nIb,15,14,1,8,7
nibble,11547,nibble,nIbL,8,6,2,4,4
niche,11549,niche,nIC,16,14,2,10,6
nick,11550,nick,nIk,23,20,3,14,9
nickel,11551,nickel,nIkL,10,9,1,5,5
nicker,11553,nicker,nIkX,12,9,3,7,5
niece,11556,niece,nis,14,12,2,7,7
nigh,11561,nigh,nY,27,22,5,17,10
nil,11566,nil,nIl,26,25,1,20,6
nimble,11567,nimble,nImbL,3,2,1,2,1
nine,11571,nine,nYn,21,19,2,16,5
ninny,11575,ninny,nIni,5,5,0,4,1
ninth,11576,ninth,nYnT,1,0,1,0,1
nip,11578,nip,nIp,25,21,4,16,9
nipper,11579,nipper,nIpX,8,7,1,4,4
nipple,11580,nipple,nIpL,7,6,1,2,5
nippy,11581,nippy,nIpi,5,3,2,1,4
nisei,11583,nisei,nise,1,0,1,0,1
niter,11584,niter,nYtX,5,4,1,4,1
nix,11592,nix,nIks,8,6,2,5,3
noble,11595,noble,nobL,5,3,2,5,0
nod,11601,nod,nad,20,15,5,12,8
noddle,11602,noddle,nadL,10,9,1,6,4
noddy,11603,noddy,nadi,8,7,1,5,3
node,11604,node,nod,20,17,3,13,7
noel,11608,noel,noEl,2,0,2,1,1
noise,11610,noise,nOz,4,3,1,3,1
noisy,11612,noisy,nOzi,3,2,1,2,1
nonage,11621,nonage,nanIJ,1,1,0,1,0
none,11632,none,n^n,20,20,0,15,5
nones,11634,nones,nonz,2,0,2,0,2
noodle,11654,noodle,nudL,7,5,2,5,2
nook,11655,nook,nUk,11,11,0,11,0
noon,11656,noon,nun,19,18,1,13,6
noose,11658,noose,nus,15,14,1,9,6
nor,11659,nor,nor,28,22,6,18,10
norm,11661,norm,norm,8,5,3,3,5
normal,11662,normal,normL,3,1,2,1,2
normally,11665,normally,normLi,1,0,1,0,1
norse,11666,Norse,nors,8,7,1,5,3
north,11667,north,norT,4,3,1,1,3
nose,11674,nose,noz,18,15,3,9,9
nosy,11679,nosy,nozi,7,6,1,6,1
notable,11681,notable,notxbL,2,1,1,2,0
notch,11685,notch,naC,7,7,0,3,4
note,11686,note,not,26,24,2,19,7
noun,11700,noun,nWn,8,7,1,7,1
novel,11703,novel,navL,3,3,0,1,2
now,11712,now,nW,16,15,1,9,7
nozzle,11717,nozzle,nazL,4,4,0,2,2
nth,11718,nth,EnT,3,2,1,0,3
nub,11720,nub,n^b,19,17,2,13,6
nubble,11722,nubble,n^bL,8,7,1,5,3
nude,11726,nude,nud,15,13,2,8,7
nudge,11727,nudge,n^J,8,8,0,3,5
null,11734,null,n^l,17,16,1,12,5
numb,11738,numb,n^m,17,17,0,12,5
number,11739,number,n^mbX,3,2,1,3,0
nurse,11752,nurse,nRs,10,10,0,9,1
nurture,11755,nurture,nRCX,1,1,0,1,0
nut,11756,nut,n^t,25,23,2,18,7
nuts,11762,nuts,n^ts,2,1,1,0,2
nutty,11764,nutty,n^ti,6,5,1,4,2
nuzzle,11765,nuzzle,n^zL,7,7,0,5,2
nymph,11767,nymph,nImf,1,1,0,1,0
o,11768,o,o,27,4,23,18,9
oaf,11769,oaf,of,13,11,2,4,9
oafish,11770,oafish,ofIS,2,1,1,2,0
oak,11771,oak,ok,25,12,13,13,12
oakum,11773,oakum,okM,5,3,2,2,3
oar,11774,oar,or,32,13,19,21,11
oat,11777,oat,ot,25,14,11,16,9
oath,11778,oath,oT,12,9,3,3,9
obese,11785,obese,obis,1,0,1,0,1
obey,11786,obey,obe,6,5,1,3,3
obi,11789,obi,obi,6,4,2,2,4
obit,11790,obit,obIt,2,1,1,2,0
oblique,11804,oblique,oblik,1,0,1,1,0
oboe,11810,oboe,obo,5,3,2,2,3
obtain,11831,obtain,xbten,2,0,2,2,0
occlude,11842,occlude,xklud,1,0,1,1,0
occult,11843,occult,xk^lt,2,1,1,2,0
occur,11847,occur,xkR,2,1,1,2,0
ochre,11853,ochre,okX,9,7,2,6,3
odd,11865,odd,ad,15,5,10,13,2
odds,11867,odds,adz,4,3,1,3,1
ode,11868,ode,od,24,12,12,13,11
odor,11871,odor,odX,8,6,2,7,1
of,11874,of,xv,4,1,3,1,3
off,11875,off,cf,12,7,5,4,8
offend,11877,offend,xfEnd,7,5,2,6,1
offense,11878,offense,xfEns,3,1,2,2,1
offer,11880,offer,cfX,6,4,2,3,3
offering,11881,offering,cfXIG,1,0,1,1,0
offing,11890,offing,cfIG,3,2,1,2,1
offish,11891,offish,cfIS,3,2,1,2,1
oft,11894,oft,cft,7,3,4,3,4
ogle,11896,ogle,ogL,6,5,1,5,1
ogre,11897,ogre,ogX,7,7,0,6,1
ohm,11898,ohm,om,20,11,9,11,9
ohmic,11899,ohmic,omIk,1,1,0,0,1
oil,11900,oil,Ol,14,8,6,14,0
okay,11902,okay,oke,6,3,3,3,3
old,11904,old,old,11,1,10,10,1
oleo,11909,oleo,olio,3,0,3,3,0
olive,11914,olive,alIv,1,0,1,1,0
omen,11916,omen,omxn,6,2,4,6,0
omit,11918,omit,omIt,4,3,1,3,1
once,11924,once,w^ns,4,2,2,2,2
one,11926,one,w^n,18,17,1,17,1
oneness,11927,oneness,w^n|s,1,0,1,0,1
onto,11936,onto,cntu,2,2,0,2,0
onus,11937,onus,on|s,3,2,1,3,0
onyx,11939,onyx,anIks,1,0,1,1,0
ooze,11941,ooze,uz,10,3,7,9,1
oozy,11942,oozy,uzi,6,1,5,5,1
opal,11943,opal,opL,5,4,1,4,1
ope,11946,ope,op,20,10,10,10,10
open,11947,open,opxn,4,3,1,1,3
opener,11948,opener,opxnX,1,0,1,0,1
opine,11962,opine,opYn,3,2,1,2,1
opossum,11965,opossum,xpasM,2,1,1,1,1
oppose,11968,oppose,xpoz,3,1,2,2,1
oppress,11971,oppress,xprEs,2,0,2,2,0
opt,11974,opt,apt,2,2,0,2,0
opus,11986,opus,opxs,1,1,0,0,1
oracle,11987,oracle,crxkL,2,1,1,2,0
oral,11989,oral,orL,8,5,3,5,3
orate,11994,orate,oret,9,7,2,8,1
orb,12000,orb,orb,2,1,1,0,2
order,12011,order,ordX,5,2,3,4,1
ordure,12019,ordure,orJX,2,2,0,0,2
orgy,12031,orgy,orJi,1,1,0,0,1
oriel,12032,oriel,oriL,4,1,3,3,1
oriole,12042,oriole,oriol,2,2,0,2,0
ornate,12048,ornate,ornet,1,0,1,0,1
orris,12054,orris,cr|s,3,2,1,3,0
osier,12069,osier,oZX,5,5,0,5,0
osprey,12072,osprey,aspri,2,1,1,2,0
other,12083,other,^DX,5,4,1,5,0
otter,12085,otter,atX,6,4,2,6,0
ounce,12088,ounce,Wns,3,0,3,3,0
ours,12089,ours,Wrz,1,0,1,0,1
oust,12091,oust,Wst,5,2,3,4,1
ouster,12092,ouster,WstX,6,4,2,5,1
out,12093,out,Wt,18,8,10,15,3
outer,12108,outer,WtX,5,3,2,4,1
outfight,12111,outfight,WtfYt,2,2,0,1,1
outfit,12112,outfit,WtfIt,1,1,0,0,1
outing,12123,outing,WtIG,1,1,0,1,0
outre,12138,outre,utre,2,1,1,2,0
outright,12141,outright,WtrYt,2,1,1,2,0
oval,12156,oval,ovL,6,6,0,4,2
ovary,12158,ovary,ovXi,3,1,2,0,3
over,12161,over,ovX,10,7,3,6,4
overall,12164,overall,ovXcl,3,0,3,0,3
overalls,12165,overalls,ovXclz,1,0,1,0,1
overawe,12167,overawe,ovXc,3,1,2,0,3
overhaul,12181,overhaul,ovXhcl,1,0,1,0,1
overlap,12187,overlap,ovXl@p,1,1,0,0,1
overlay,12188,overlay,ovXle,2,1,1,0,2
overleap,12189,overleap,ovXlip,2,1,1,0,2
overly,12192,overly,ovXli,3,1,2,0,3
overplay,12195,overplay,ovXple,1,0,1,0,1
overt,12204,overt,ovRt,2,1,1,2,0
ovoid,12215,ovoid,ovOd,2,1,1,2,0
ovum,12217,ovum,ovM,3,3,0,1,2
owl,12218,owl,Wl,15,10,5,13,2
own,12221,own,on,27,13,14,18,9
ox,12223,ox,aks,6,2,4,6,0
oyster,12232,oyster,OstX,5,4,1,5,0
ozone,12233,ozone,ozon,1,0,1,1,0
p,12234,p,pi,34,22,12,18,16
pa,12235,pa,pa,14,6,8,2,12
pace,12237,pace,pes,30,22,8,18,12
pacer,12239,pacer,pesX,7,5,2,2,5
pack,12246,pack,p@k,30,27,3,19,11
package,12247,package,p@kIJ,1,1,0,1,0
packer,12248,packer,p@kX,8,7,1,4,4
packet,12249,packet,p@k|t,5,4,1,4,1
pact,12251,pact,p@kt,10,6,4,4,6
pad,12252,pad,p@d,26,22,4,15,11
padding,12253,padding,p@dIG,4,4,0,4,0
paddle,12254,paddle,p@dL,10,8,2,6,4
paddock,12255,paddock,p@dxk,1,1,0,1,0
paddy,12256,paddy,p@di,7,6,1,3,4
paean,12259,paean,pian,3,1,2,1,2
page,12261,page,peJ,16,14,2,7,9
paid,12266,paid,ped,22,18,4,13,9
pail,12267,pail,pel,34,32,2,25,9
pain,12268,pain,pen,32,29,3,22,10
paint,12270,paint,pent,12,9,3,9,3
pair,12271,pair,pEr,26,22,4,20,6
pal,12275,pal,p@l,20,19,1,10,10
palace,12276,palace,p@lxs,7,7,0,5,2
palate,12281,palate,p@l|t,7,7,0,6,1
paling,12292,paling,pelIG,4,4,0,4,0
pall,12295,pall,pcl,24,21,3,21,3
pallet,12298,pallet,p@lxt,5,5,0,2,3
pallid,12302,pallid,p@lxd,5,5,0,3,2
pallor,12303,pallor,p@lX,6,5,1,3,3
palm,12304,palm,pam,14,9,5,4,10
palmer,12306,palmer,pamX,6,5,1,1,5
palmy,12309,palmy,pami,5,4,1,0,5
palter,12317,palter,pcltX,4,3,1,4,0
pampa,12318,pampa,p@mpx,1,1,0,0,1
pamper,12319,pamper,p@mpX,3,3,0,2,1
pan,12322,pan,p@n,31,25,6,19,12
panda,12331,panda,p@ndx,1,1,0,0,1
pander,12334,pander,p@ndX,7,7,0,4,3
panel,12337,panel,p@nL,7,6,1,2,5
pang,12339,pang,p@G,17,17,0,8,9
pannier,12344,pannier,p@nyX,2,2,0,0,2
pansy,12348,pansy,p@nzi,1,1,0,0,1
pant,12349,pant,p@nt,17,12,5,10,7
panther,12354,panther,p@nTX,3,2,1,1,2
pantry,12357,pantry,p@ntri,3,2,1,2,1
pants,12358,pants,p@ns,11,8,3,7,4
panty,12359,panty,p@nti,7,3,4,4,3
pap,12360,pap,p@p,28,28,0,19,9
papa,12361,papa,papx,4,3,1,0,4
papal,12363,papal,pepL,4,4,0,3,1
paper,12366,paper,pepX,9,7,2,5,4
papery,12368,papery,pepXi,2,1,1,1,1
par,12376,par,par,27,18,9,14,13
para,12377,para,parx,9,7,2,0,9
parable,12378,parable,p@rxbL,3,2,1,3,0
parade,12382,parade,pXed,2,0,2,1,1
parcel,12414,parcel,parsL,3,2,1,0,3
parch,12415,parch,parC,10,8,2,4,6
pard,12417,pard,pard,19,16,3,10,9
pardon,12418,pardon,pardN,3,2,1,1,2
parent,12422,parent,p@rxnt,3,0,3,2,1
parfait,12428,parfait,parfe,2,2,0,0,2
paring,12431,paring,p@rIG,6,5,1,5,1
parish,12432,parish,p@rIS,3,3,0,2,1
parity,12434,parity,p@rxti,3,2,1,1,2
park,12435,park,park,18,12,6,9,9
parka,12436,parka,parkx,3,1,2,0,3
parkway,12437,parkway,parkwe,1,0,1,0,1
parlay,12439,parlay,parle,4,4,0,0,4
parley,12440,parley,parli,6,4,2,1,5
parlor,12444,parlor,parlX,3,3,0,1,2
parody,12448,parody,p@rxdi,1,1,0,0,1
parole,12449,parole,pXol,1,0,1,1,0
parquet,12452,parquet,parke,5,3,2,0,5
parrot,12456,parrot,p@rxt,6,4,2,4,2
parry,12457,parry,p@ri,10,9,1,8,2
parse,12458,parse,pars,12,8,4,3,9
parsley,12461,parsley,parsli,2,1,1,0,2
parson,12463,parson,parsN,4,2,2,1,3
part,12465,part,part,17,12,5,9,8
partial,12469,partial,parSL,3,2,1,1,2
partially,12471,partially,parSLi,1,0,1,0,1
partible,12472,partible,partxbL,1,1,0,1,0
partly,12483,partly,partli,4,2,2,1,3
partridge,12485,partridge,partrIJ,1,1,0,1,0
party,12487,party,parti,5,2,3,2,3
pasha,12489,pasha,paSx,3,2,1,0,3
pass,12490,pass,p@s,24,19,5,11,13
passable,12491,passable,p@sxbL,1,1,0,1,0
passage,12492,passage,p@sIJ,3,3,0,1,2
passe,12494,passe,p@se,4,2,2,1,3
passel,12495,passel,p@sL,10,9,1,5,5
passing,12500,passing,p@sIG,4,4,0,2,2
passive,12503,passive,p@sIv,3,3,0,1,2
passkey,12505,passkey,p@ski,2,2,0,1,1
past,12508,past,p@st,17,13,4,9,8
paste,12510,paste,pest,13,11,2,8,5
pastern,12513,pastern,p@stXn,4,2,2,2,2
pastiche,12516,pastiche,p@stiS,1,0,1,0,1
pastor,12518,pastor,p@stX,13,6,7,8,5
pastoral,12519,pastoral,p@stXL,2,1,1,0,2
pasture,12523,pasture,p@sCX,2,2,0,1,1
pasty,12524,pasty,p@sti,8,5,3,4,4
pat,12525,pat,p@t,39,30,9,24,15
patch,12526,patch,p@C,21,21,0,12,9
pate,12527,pate,pet,34,27,7,23,11
paten,12528,paten,p@tN,9,6,3,5,4
patent,12529,patent,p@tNt,3,1,2,1,2
patentee,12530,patentee,p@tNti,1,0,1,0,1
path,12534,path,p@T,14,14,0,5,9
patio,12545,patio,p@tio,1,0,1,0,1
patsy,12562,patsy,p@tsi,1,0,1,0,1
patter,12563,patter,p@tX,20,14,6,14,6
pattern,12564,pattern,p@tXn,3,1,2,2,1
patty,12565,patty,p@ti,17,12,5,10,7
paunch,12567,paunch,pcnC,5,4,1,4,1
pauper,12568,pauper,pcpX,2,2,0,2,0
pause,12569,pause,pcz,9,8,1,6,3
pave,12570,pave,pev,18,17,1,9,9
paving,12572,paving,pevIG,1,1,0,1,0
paw,12573,paw,pc,19,15,4,11,8
pawn,12574,pawn,pcn,21,15,6,17,4
pay,12575,pay,pe,33,20,13,17,16
payee,12578,payee,pei,11,9,2,1,10
payer,12579,payer,peX,14,11,3,3,11
peace,12582,peace,pis,19,17,2,10,9
peach,12584,peach,piC,22,18,4,13,9
peak,12586,peak,pik,31,25,6,20,11
peaked,12587,peaked,pikt,5,3,2,2,3
peal,12588,peal,pil,33,30,3,24,9
pearl,12590,pearl,pRl,21,19,2,15,6
pease,12592,pease,piz,21,17,4,12,9
peat,12594,peat,pit,31,26,5,20,11
pebble,12595,pebble,pEbL,4,4,0,1,3
peck,12600,peck,pEk,20,19,1,15,5
pedal,12607,pedal,pEdL,8,8,0,5,3
pedlar,12617,pedlar,pEdlX,1,1,0,1,0
peen,12620,peen,pin,31,26,5,19,12
peep,12621,peep,pip,28,26,2,18,10
peer,12623,peer,pIr,33,29,4,23,10
peeve,12624,peeve,piv,16,14,2,7,9
peg,12627,peg,pEg,10,10,0,5,5
pelf,12633,pelf,pElf,4,3,1,3,1
pellet,12636,pellet,pEl|t,5,3,2,4,1
pelt,12638,pelt,pElt,14,12,2,9,5
pen,12641,pen,pEn,29,25,4,21,8
penal,12642,penal,pinL,5,4,1,3,2
penance,12645,penance,pEn|ns,2,1,1,0,2
pence,12647,pence,pEns,12,10,2,8,4
penchant,12648,penchant,pEnC|nt,3,1,2,2,1
pencil,12649,pencil,pEnsL,2,1,1,1,1
pendant,12650,pendant,pEnd|nt,2,1,1,2,0
penis,12660,penis,pin|s,3,3,0,3,0
pennant,12666,pennant,pEn|nt,5,2,3,3,2
penni,12667,penni,pEni,8,5,3,3,5
pennies,12668,pennies,pEniz,1,0,1,0,1
pennon,12670,pennon,pEn|n,4,1,3,1,3
pension,12674,pension,pEnC|n,6,4,2,4,2
pent,12676,pent,pEnt,22,19,3,16,6
peon,12689,peon,pian,3,1,2,1,2
people,12691,people,pipL,5,4,1,3,2
pep,12692,pep,pEp,15,14,1,9,6
pepper,12693,pepper,pEpX,5,3,2,3,2
peppery,12694,peppery,pEpXi,2,1,1,1,1
per,12697,per,pR,19,12,7,8,11
perch,12709,perch,pRC,16,15,1,10,6
peril,12737,peril,pErL,7,5,2,2,5
perish,12746,perish,pErIS,3,3,0,3,0
perjure,12752,perjure,pRJX,5,3,2,2,3
perjury,12753,perjury,pRJXi,2,1,1,1,1
perk,12754,perk,pRk,22,20,2,16,6
persian,12782,Persian,pRZ|n,1,1,0,1,0
person,12787,person,pRsN,4,2,2,1,3
personal,12790,personal,pRsNL,1,0,1,0,1
pert,12805,pert,pRt,23,21,2,17,6
pervade,12813,pervade,pXved,1,0,1,0,1
pesky,12818,pesky,pEski,1,1,0,1,0
peso,12819,peso,peso,3,2,1,0,3
pest,12821,pest,pEst,19,16,3,14,5
pester,12822,pester,pEstX,7,5,2,5,2
pestle,12829,pestle,pEstL,7,5,2,5,2
pet,12830,pet,pEt,30,25,5,20,10
petal,12831,petal,pEtL,12,9,3,6,6
peter,12833,peter,pitX,8,6,2,7,1
petrel,12837,petrel,pEtrL,2,0,2,0,2
pettish,12844,pettish,pEtIS,2,2,0,2,0
petty,12845,petty,pEti,9,8,1,6,3
pew,12848,pew,pyu,9,5,4,7,2
phallus,12855,phallus,f@lxs,5,5,0,5,0
pharaoh,12859,pharaoh,fEro,7,4,3,3,4
phlegm,12891,phlegm,flEm,7,6,1,0,7
phloem,12893,phloem,floEm,1,0,1,0,1
phlox,12894,phlox,flaks,6,3,3,5,1
phone,12897,phone,fon,28,24,4,22,6
phoneme,12898,phoneme,fonim,1,0,1,0,1
phony,12907,phony,foni,8,6,2,5,3
phrase,12928,phrase,frez,13,10,3,6,7
pi,12944,pi,pY,32,21,11,18,14
piaster,12948,piaster,pi@stX,2,1,1,2,0
pice,12955,pice,pYs,22,17,5,14,8
pick,12956,pick,pIk,34,27,7,20,14
pickerel,12960,pickerel,pIkXL,1,0,1,0,1
picket,12961,picket,pIk|t,5,5,0,5,0
pickle,12963,pickle,pIkL,12,9,3,5,7
picky,12967,picky,pIki,10,7,3,2,8
picot,12969,picot,piko,2,1,1,0,2
picture,12971,picture,pIkCX,2,1,1,2,0
piddle,12973,piddle,pIdL,9,9,0,7,2
pied,12977,pied,pYd,20,17,3,12,8
pierce,12979,pierce,pIrs,4,3,1,2,2
piffle,12981,piffle,pIfL,2,2,0,0,2
pig,12982,pig,pIg,19,18,1,10,9
pike,12989,pike,pYk,23,20,3,15,8
piker,12990,piker,pYkX,4,3,1,3,1
pile,12993,pile,pYl,28,25,3,20,8
piled,12994,piled,pYld,5,3,2,3,2
pilfer,12995,pilfer,pIlfX,1,0,1,0,1
piling,12997,piling,pYlIG,3,3,0,3,0
pill,12998,pill,pIl,36,32,4,25,11
pillar,13000,pillar,pIlX,9,6,3,4,5
pillory,13003,pillory,pIlXi,1,0,1,0,1
pillow,13004,pillow,pIlo,5,4,1,3,2
pilot,13005,pilot,pYlxt,2,2,0,2,0
pimp,13008,pimp,pImp,8,4,4,6,2
pimple,13010,pimple,pImpL,4,3,1,3,1
pin,13011,pin,pIn,31,28,3,21,10
pincer,13013,pincer,pInCX,3,1,2,2,1
pinch,13014,pinch,pInC,10,6,4,7,3
pine,13016,pine,pYn,30,26,4,22,8
ping,13019,ping,pIG,18,17,1,8,10
pink,13022,pink,pIGk,16,10,6,12,4
pinkeye,13023,pinkeye,pIGkY,2,1,1,0,2
pinky,13024,pinky,pIGki,5,2,3,2,3
pinnace,13025,pinnace,pIn|s,1,1,0,1,0
pinnate,13027,pinnate,pInet,1,0,1,1,0
pint,13030,pint,pYnt,6,5,1,5,1
pious,13034,pious,pYxs,2,1,1,1,1
pip,13035,pip,pIp,30,29,1,20,10
pipe,13036,pipe,pYp,18,17,1,11,7
piping,13038,piping,pYpIG,1,1,0,1,0
piquet,13042,piquet,pIke,4,3,1,0,4
pirate,13044,pirate,pYrxt,2,2,0,2,0
pistil,13051,pistil,pIstL,2,2,0,2,0
pit,13054,pit,pIt,33,30,3,23,10
pitch,13055,pitch,pIC,24,21,3,13,11
pitcher,13056,pitcher,pICX,4,1,3,2,2
pith,13060,pith,pIT,14,13,1,4,10
pithy,13062,pithy,pITi,3,2,1,0,3
piton,13066,piton,pitan,2,0,2,0,2
pity,13069,pity,pIti,12,10,2,9,3
pivot,13070,pivot,pIvxt,4,3,1,4,0
pixy,13071,pixy,pIksi,2,0,2,0,2
place,13077,place,ples,7,4,3,2,5
placer,13081,placer,pl@sX,2,1,1,0,2
plague,13087,plague,pleg,5,4,1,0,5
plaid,13088,plaid,pl@d,11,9,2,4,7
plain,13089,plain,plen,10,6,4,4,6
plaint,13092,plaint,plent,4,1,3,2,2
plait,13095,plait,plet,14,10,4,5,9
plan,13096,plan,pl@n,8,6,2,2,6
planet,13097,planet,pl@n|t,1,0,1,0,1
plank,13100,plank,pl@Gk,7,5,2,6,1
plant,13102,plant,pl@nt,8,2,6,3,5
plantain,13103,plantain,pl@ntN,3,1,2,0,3
planter,13105,planter,pl@ntX,4,2,2,0,4
plaque,13106,plaque,pl@k,12,9,3,6,6
plash,13107,plash,pl@S,10,8,2,5,5
plaster,13109,plaster,pl@stX,5,2,3,2,3
plat,13112,plat,pl@t,15,10,5,3,12
plateau,13113,plateau,pl@to,4,3,1,1,3
platen,13114,platen,pl@tN,8,3,5,3,5
platinum,13117,platinum,pl@tNM,1,0,1,0,1
platter,13120,platter,pl@tX,10,4,6,4,6
play,13125,play,ple,16,9,7,7,9
plea,13128,plea,pli,17,10,7,8,9
plead,13129,plead,plid,8,7,1,1,7
please,13132,please,pliz,6,3,3,2,4
pleat,13135,pleat,plit,15,12,3,7,8
plebe,13136,plebe,plib,5,4,1,1,4
pled,13142,pled,plEd,8,7,1,4,4
pledge,13143,pledge,plEJ,4,3,1,3,1
pliable,13153,pliable,plYxbL,1,0,1,1,0
plight,13156,plight,plYt,11,8,3,6,5
plod,13158,plod,plad,8,7,1,3,5
plop,13159,plop,plap,8,6,2,6,2
plot,13160,plot,plat,12,10,2,6,6
plough,13161,plough,plW,6,6,0,2,4
plover,13162,plover,pl^vX,1,1,0,0,1
ploy,13164,ploy,plO,6,6,0,2,4
pluck,13165,pluck,pl^k,10,6,4,3,7
plucky,13166,plucky,pl^ki,2,0,2,1,1
plug,13167,plug,pl^g,8,6,2,3,5
plum,13168,plum,pl^m,10,7,3,3,7
plumber,13170,plumber,pl^mX,3,2,1,0,3
plume,13172,plume,plum,7,5,2,5,2
plump,13174,plump,pl^mp,6,3,3,4,2
plumy,13175,plumy,plumi,1,0,1,0,1
plunder,13176,plunder,pl^ndX,2,2,0,1,1
plunge,13177,plunge,pl^nJ,2,0,2,1,1
plunger,13178,plunger,pl^nJX,2,1,1,0,2
plunk,13179,plunk,pl^Gk,5,3,2,4,1
plus,13185,plus,pl^s,6,5,1,1,5
plush,13186,plush,pl^S,9,8,1,4,5
pluto,13187,Pluto,pluto,1,1,0,1,0
ply,13193,ply,plY,12,8,4,6,6
poach,13196,poach,poC,15,14,1,8,7
pock,13197,pock,pak,28,25,3,19,9
pocket,13198,pocket,pak|t,7,7,0,7,0
pod,13201,pod,pad,23,17,6,14,9
poem,13204,poem,poxm,1,1,0,0,1
poesy,13205,poesy,poxzi,1,0,1,1,0
poet,13206,poet,poxt,4,4,0,0,4
point,13213,point,pOnt,8,6,2,7,1
pointer,13215,pointer,pOntX,1,0,1,0,1
poise,13216,poise,pOz,5,4,1,4,1
poison,13217,poison,pOzN,2,0,2,0,2
poisoner,13218,poisoner,pOzNX,1,0,1,0,1
poke,13219,poke,pok,27,22,5,18,9
poker,13220,poker,pokX,8,6,2,4,4
pokey,13221,pokey,poki,5,4,1,1,4
polar,13222,polar,polX,12,11,1,7,5
pole,13227,pole,pol,33,29,4,24,9
polio,13234,polio,polio,3,1,2,2,1
polite,13236,polite,pxlYt,3,1,2,2,1
pollster,13250,pollster,polstX,3,2,1,3,0
pollute,13251,pollute,pxlut,3,3,0,2,1
polo,13253,polo,polo,7,5,2,3,4
pommel,13278,pommel,p^mL,3,3,0,0,3
pomp,13279,pomp,pamp,7,5,2,3,4
pond,13286,pond,pand,7,5,2,4,3
ponder,13287,ponder,pandX,5,4,1,4,1
pone,13288,pone,pon,29,26,3,22,7
pony,13296,pony,poni,6,5,1,3,3
poodle,13297,poodle,pudL,7,7,0,7,0
pool,13298,pool,pul,18,16,2,17,1
poop,13299,poop,pup,14,14,0,13,1
poor,13300,poor,por,31,25,6,21,10
pop,13301,pop,pap,29,23,6,19,10
pope,13303,pope,pop,22,21,1,16,6
poplar,13307,poplar,paplX,1,1,0,1,0
poppy,13310,poppy,papi,7,6,1,3,4
porch,13318,porch,porC,7,5,2,2,5
pored,13321,pored,pord,13,12,1,9,4
pork,13322,pork,pork,9,7,2,4,5
porous,13326,porous,por|s,1,1,0,1,0
porpoise,13328,porpoise,porpxs,1,1,0,1,0
port,13331,port,port,18,13,5,9,9
portable,13332,portable,portxbL,2,1,1,2,0
portal,13334,portal,portL,5,4,1,3,2
porter,13339,porter,portX,4,3,1,2,2
portly,13345,portly,portli,2,2,0,2,0
pose,13350,pose,poz,21,16,5,12,9
poser,13351,poser,pozX,5,4,1,0,5
poseur,13352,poseur,pozR,3,2,1,0,3
posh,13353,posh,paS,11,9,2,3,8
posit,13354,posit,paz|t,1,1,0,1,0
posse,13358,posse,pasi,4,4,0,1,3
possum,13365,possum,pasM,2,1,1,1,1
post,13366,post,post,15,13,2,10,5
postal,13368,postal,postL,5,4,1,3,2
poster,13373,poster,postX,7,4,3,4,3
postern,13376,postern,postXn,2,1,1,1,1
posture,13393,posture,pasCX,1,1,0,1,0
posy,13395,posy,pozi,11,8,3,6,5
pot,13396,pot,pat,34,29,5,25,9
potable,13397,potable,potxbL,2,1,1,2,0
potent,13404,potent,potNt,1,1,0,1,0
pother,13408,pother,paDX,4,4,0,2,2
pottage,13414,pottage,patIJ,1,1,0,1,0
potter,13415,potter,patX,9,6,3,5,4
pottery,13416,pottery,patXi,2,1,1,1,1
pouch,13417,pouch,pWC,10,10,0,8,2
poult,13418,poult,polt,13,12,1,7,6
pounce,13422,pounce,pWns,6,5,1,5,1
pound,13423,pound,pWnd,9,9,0,8,1
pout,13426,pout,pWt,20,18,2,18,2
powder,13428,powder,pWdX,2,1,1,1,1
power,13429,power,pWX,9,8,1,6,3
pox,13431,pox,paks,7,5,2,5,2
praetor,13439,praetor,pritX,1,0,1,1,0
prairie,13443,prairie,prEri,1,0,1,0,1
praise,13444,praise,prez,11,7,4,7,4
pram,13446,pram,pram,5,4,1,1,4
prance,13447,prance,pr@ns,3,2,1,3,0
prank,13448,prank,pr@Gk,7,6,1,7,0
prate,13450,prate,pret,12,9,3,10,2
prattle,13453,prattle,pr@tL,1,0,1,1,0
prawn,13454,prawn,prcn,7,6,1,3,4
pray,13455,pray,pre,15,10,5,9,6
prayer,13456,prayer,prEr,4,1,3,2,2
preach,13458,preach,priC,4,2,2,3,1
precis,13484,precis,presi,2,1,1,2,0
preen,13515,preen,prin,6,5,1,2,4
prefer,13522,prefer,prIfR,1,0,1,1,0
prelate,13538,prelate,prEl|t,1,0,1,1,0
prepare,13559,prepare,prIpEr,1,0,1,1,0
prepay,13561,prepay,pripe,1,0,1,1,0
preside,13587,preside,prIzYd,1,0,1,1,0
press,13592,press,prEs,6,5,1,4,2
pretty,13612,pretty,prIti,4,3,1,1,3
price,13622,price,prYs,10,7,3,4,6
prick,13624,prick,prIk,9,5,4,5,4
prickle,13625,prickle,prIkL,4,2,2,3,1
pride,13627,pride,prYd,12,9,3,4,8
prig,13629,prig,prIg,7,4,3,5,2
prim,13630,prim,prIm,10,7,3,4,6
primal,13632,primal,prYmL,1,0,1,0,1
prime,13636,prime,prYm,11,8,3,3,8
primer,13637,primer,prImX,2,1,1,0,2
primp,13643,primp,prImp,5,3,2,3,2
prince,13645,prince,prIns,3,2,1,2,1
prink,13649,prink,prIGk,7,4,3,6,1
print,13650,print,prInt,2,1,1,1,1
prior,13651,prior,prYX,9,8,1,4,5
prise,13655,prise,prYz,10,7,3,3,7
prism,13656,prism,prIzM,2,2,0,1,1
prison,13658,prison,prIzN,3,1,2,1,2
prisoner,13659,prisoner,prIzNX,1,0,1,0,1
prissy,13660,prissy,prIsi,4,4,0,1,3
prithee,13662,prithee,prIDi,3,3,0,0,3
private,13664,private,prYvxt,1,1,0,1,0
privet,13667,privet,prIvxt,4,2,2,4,0
privy,13669,privy,prIvi,3,3,0,0,3
pro,13670,pro,pro,14,10,4,8,6
probe,13677,probe,prob,5,3,2,2,3
prod,13699,prod,prad,9,7,2,4,5
proffer,13718,proffer,prafX,1,1,0,0,1
prone,13765,prone,pron,12,9,3,6,6
prong,13766,prong,prcG,3,2,1,2,1
proof,13772,proof,pruf,4,3,1,1,3
prop,13773,prop,prap,7,5,2,4,3
proper,13781,proper,prapX,3,1,2,0,3
prose,13806,prose,proz,9,5,4,3,6
prosper,13816,prosper,praspX,1,0,1,0,1
prosy,13826,prosy,prozi,3,0,3,2,1
proud,13847,proud,prWd,7,6,1,2,5
prove,13849,prove,pruv,5,4,1,2,3
prow,13868,prow,prW,7,5,2,2,5
prowl,13870,prowl,prWl,3,2,1,1,2
prude,13875,prude,prud,10,9,1,4,6
prune,13881,prune,prun,8,7,1,2,6
pry,13883,pry,prY,17,9,8,8,9
psalm,13884,psalm,sam,11,11,0,6,5
psalter,13885,Psalter,scltX,6,4,2,5,1
psyche,13888,Psyche,sYki,3,2,1,2,1
pub,13901,pub,p^b,15,15,0,8,7
puck,13910,puck,p^k,27,23,4,17,10
pucker,13911,pucker,p^kX,8,7,1,5,3
pudding,13912,pudding,pUdIG,1,1,0,1,0
puddle,13913,puddle,p^dL,10,10,0,8,2
pudgy,13915,pudgy,p^Ji,3,3,0,0,3
puff,13919,puff,p^f,14,14,0,7,7
pug,13920,pug,p^g,20,19,1,13,7
puke,13925,puke,pyuk,2,1,1,0,2
pukka,13926,pukka,p^kx,4,3,1,2,2
pule,13928,pule,pyul,6,3,3,4,2
pull,13929,pull,pUl,16,15,1,12,4
pullet,13930,pullet,pUl|t,3,3,0,3,0
pulley,13931,pulley,pUli,6,4,2,4,2
pulp,13935,pulp,p^lp,4,3,1,1,3
pulse,13940,pulse,p^ls,2,1,1,0,2
pump,13944,pump,p^mp,14,12,2,11,3
pun,13947,pun,p^n,29,26,3,20,9
punch,13948,punch,p^nC,8,7,1,6,2
puncheon,13949,puncheon,p^nC|n,2,2,0,2,0
punk,13961,punk,p^Gk,12,9,3,11,1
punt,13963,punt,p^nt,12,10,2,9,3
pup,13965,pup,p^p,21,17,4,11,10
puppy,13969,puppy,p^pi,6,5,1,2,4
purge,13978,purge,pRJ,14,10,4,7,7
purple,13990,purple,pRpL,2,2,0,2,0
purse,13994,purse,pRs,19,16,3,11,8
purser,13995,purser,pRsX,6,5,1,3,3
purvey,14000,purvey,pRve,1,1,0,1,0
pus,14002,pus,p^s,19,16,3,11,8
push,14003,push,pUS,5,5,0,2,3
pussy,14006,pussy,pUsi,2,2,0,1,1
put,14009,put,pUt,14,14,0,11,3
putsch,14016,putsch,pUC,9,9,0,6,3
putt,14017,putt,p^t,29,25,4,18,11
puttee,14018,puttee,p^ti,9,8,1,5,4
putter,14019,putter,p^tX,14,11,3,10,4
putty,14020,putty,p^ti,9,8,1,5,4
puzzle,14021,puzzle,p^zL,5,5,0,3,2
pyre,14029,pyre,pYr,22,19,3,15,7
pyx,14033,pyx,pIks,11,9,2,5,6
quack,14035,quack,kw@k,8,8,0,5,3
quad,14037,quad,kwad,8,5,3,4,4
quaff,14052,quaff,kwaf,4,3,1,0,4
quail,14055,quail,kwel,7,5,2,3,4
quaint,14056,quaint,kwent,2,0,2,1,1
quake,14057,quake,kwek,9,6,3,3,6
quaker,14058,quaker,kwekX,2,1,1,0,2
qualm,14063,qualm,kwam,4,3,1,1,3
quarrel,14069,quarrel,kwcrL,2,1,1,1,1
quarry,14070,quarry,kwcri,2,2,0,1,1
quart,14071,quart,kwort,9,3,6,4,5
quarter,14072,quarter,kwortX,3,2,1,0,3
quarto,14076,quarto,kworto,3,2,1,0,3
quartz,14077,quartz,kworts,3,2,1,0,3
quash,14078,quash,kwaS,5,4,1,2,3
quaver,14081,quaver,kwevX,3,2,1,2,1
quean,14082,quean,kwin,4,2,2,4,0
queer,14084,queer,kwIr,10,9,1,2,8
quell,14085,quell,kwEl,5,4,1,3,2
quench,14086,quench,kwEnC,2,1,1,2,0
query,14088,query,kwIri,5,3,2,3,2
quest,14089,quest,kwEst,2,1,1,2,0
quick,14094,quick,kwIk,14,11,3,4,10
quickie,14096,quickie,kwIki,2,1,1,0,2
quid,14097,quid,kwId,9,7,2,2,7
quiet,14099,quiet,kwY|t,1,0,1,0,1
quill,14102,quill,kwIl,13,10,3,4,9
quilt,14103,quilt,kwIlt,4,0,4,2,2
quince,14104,quince,kwIns,2,1,1,1,1
quint,14107,quint,kInt,10,8,2,7,3
quip,14111,quip,kwIp,10,8,2,4,6
quire,14112,quire,kwYr,6,3,3,3,3
quirk,14113,quirk,kwRk,6,5,1,2,4
quirt,14114,quirt,kwRt,8,5,3,3,5
quit,14116,quit,kwIt,17,12,5,5,12
quite,14117,quite,kwYt,10,7,3,3,7
quits,14118,quits,kwIts,3,1,2,0,3
quittance,14119,quittance,kwItNs,1,0,1,0,1
quiver,14120,quiver,kwIvX,1,1,0,1,0
quiz,14122,quiz,kwIz,7,7,0,1,6
quoit,14124,quoit,kwet,11,8,3,4,7
quorum,14126,quorum,kworM,1,1,0,0,1
quota,14127,quota,kwotx,1,0,1,0,1
quote,14129,quote,kwot,8,5,3,1,7
quoth,14130,quoth,kwoT,1,1,0,0,1
rabbet,14135,rabbet,r@b|t,4,4,0,3,1
rabbi,14136,rabbi,r@bY,1,1,0,0,1
rabble,14139,rabble,r@bL,11,10,1,6,5
rabid,14140,rabid,r@b|d,2,2,0,1,1
race,14143,race,res,29,22,7,17,12
raceme,14145,raceme,resim,2,1,1,1,1
racial,14147,racial,reSL,2,2,0,1,1
rack,14149,rack,r@k,29,26,3,18,11
racquet,14152,racquet,r@k|t,5,4,1,5,0
racy,14153,racy,resi,5,2,3,2,3
radar,14154,radar,redar,1,1,0,0,1
radish,14167,radish,r@dIS,2,2,0,2,0
radon,14170,radon,redan,2,1,1,1,1
raffle,14172,raffle,r@fL,7,7,0,3,4
raft,14173,raft,r@ft,14,8,6,9,5
rafter,14174,rafter,r@ftX,2,0,2,1,1
rag,14175,rag,r@g,28,24,4,17,11
rage,14177,rage,reJ,19,16,3,7,12
ragout,14180,ragout,r@gu,1,0,1,0,1
raid,14182,raid,red,29,24,5,18,11
rail,14183,rail,rel,36,30,6,25,11
railing,14184,railing,relIG,4,3,1,4,0
rain,14188,rain,ren,38,28,10,24,14
rainy,14190,rainy,reni,6,5,1,3,3
raise,14191,raise,rez,30,22,8,17,13
raisin,14192,raisin,rezN,7,5,2,5,2
rajah,14193,rajah,raJx,1,1,0,0,1
rake,14194,rake,rek,30,26,4,19,11
rally,14196,rally,r@li,9,8,1,8,1
ram,14197,ram,r@m,31,24,7,19,12
ramble,14198,ramble,r@mbL,6,3,3,5,1
ramie,14201,ramie,r@mi,6,5,1,3,3
ramp,14204,ramp,r@mp,14,10,4,10,4
ran,14210,ran,r@n,28,23,5,15,13
ranch,14211,ranch,r@nC,5,3,2,2,3
rancor,14215,rancor,r@GkX,6,4,2,4,2
rand,14216,rand,r@nd,15,11,4,12,3
ranee,14218,ranee,rani,5,5,0,5,0
rang,14219,rang,r@G,21,20,1,10,11
range,14220,range,renJ,8,3,5,4,4
ranger,14221,ranger,renJX,3,2,1,2,1
rank,14222,rank,r@Gk,20,10,10,16,4
rankle,14223,rankle,r@GkL,6,4,2,3,3
rant,14226,rant,r@nt,13,9,4,7,6
rap,14227,rap,r@p,31,26,5,18,13
rape,14229,rape,rep,26,21,5,15,11
rapid,14230,rapid,r@p|d,1,1,0,1,0
rapt,14238,rapt,r@pt,5,2,3,1,4
rapture,14239,rapture,r@pCX,2,2,0,2,0
rare,14240,rare,rEr,22,20,2,17,5
rarity,14244,rarity,r@rxti,1,1,0,1,0
rascal,14245,rascal,r@skL,2,1,1,1,1
rascally,14247,rascally,r@skLi,1,0,1,0,1
rash,14248,rash,r@S,26,20,6,15,11
rasher,14249,rasher,r@SX,2,1,1,0,2
rasp,14250,rasp,r@sp,7,3,4,4,3
rat,14252,rat,r@t,37,31,6,23,14
ratchet,14253,ratchet,r@C|t,4,4,0,4,0
rate,14254,rate,ret,39,29,10,28,11
rather,14255,rather,r@DX,3,3,0,2,1
rating,14258,rating,retIG,3,2,1,3,0
ratio,14259,ratio,reSo,1,1,0,0,1
rattle,14270,rattle,r@tL,9,7,2,5,4
ravage,14277,ravage,r@vIJ,2,2,0,1,1
rave,14278,rave,rev,26,22,4,15,11
ravel,14279,ravel,r@vL,9,7,2,6,3
raven,14280,raven,revxn,4,3,1,4,0
ravish,14285,ravish,r@vIS,3,3,0,2,1
raw,14286,raw,rc,19,14,5,12,7
ray,14287,ray,re,38,19,19,22,16
rayon,14288,rayon,rean,3,0,3,2,1
razor,14289,razor,rezX,3,2,1,1,2
razz,14291,razz,r@z,17,16,1,7,10
reach,14292,reach,riC,20,17,3,10,10
read,14296,read,rid,28,25,3,18,10
reading,14299,reading,ridIG,1,1,0,1,0
ready,14300,ready,rEdi,6,4,2,4,2
real,14302,real,riL,16,12,4,4,12
really,14308,really,rili,4,3,1,2,2
realm,14309,realm,rElm,2,1,1,2,0
ream,14312,ream,rim,24,21,3,13,11
reamer,14313,reamer,rimX,5,3,2,3,2
reap,14314,reap,rip,27,25,2,16,11
rear,14315,rear,rIr,32,29,3,21,11
reason,14317,reason,rizN,6,5,1,6,0
rebel,14321,rebel,rEbL,7,6,1,5,2
recede,14336,recede,rIsid,3,3,0,1,2
receipt,14337,receipt,rIsit,5,4,1,1,4
receive,14339,receive,rIsiv,4,4,0,2,2
recital,14354,recital,rIsYtL,1,0,1,0,1
recite,14356,recite,rIsYt,3,1,2,0,3
rectal,14392,rectal,rEktL,4,4,0,2,2
recto,14400,recto,rEkto,2,2,0,0,2
rector,14401,rector,rEktX,7,6,1,4,3
rectory,14403,rectory,rEktXi,1,0,1,0,1
recur,14407,recur,rIkR,3,2,1,1,2
red,14408,red,rEd,29,21,8,21,8
redden,14410,redden,rEdN,6,5,1,3,3
reddish,14411,reddish,rEdIS,2,2,0,2,0
redound,14418,redound,rIdWnd,1,1,0,1,0
reduce,14421,reduce,rIdus,4,3,1,3,1
reef,14425,reef,rif,22,19,3,11,11
reefer,14426,reefer,rifX,2,1,1,0,2
reek,14427,reek,rik,30,25,5,20,10
reel,14428,reel,ril,34,28,6,20,14
reeve,14429,reeve,riv,21,19,2,11,10
refer,14432,refer,rIfR,3,2,1,1,2
referee,14434,referee,rEfXi,1,1,0,1,0
refine,14438,refine,rIfYn,3,3,0,3,0
regal,14466,regal,rigL,6,4,2,4,2
regime,14476,regime,reZim,1,1,0,1,0
rehearsal,14499,rehearsal,rIhRsL,2,1,1,1,1
rehearse,14500,rehearse,rIhRs,2,1,1,1,1
reject,14508,reject,rIJEkt,1,0,1,1,0
relay,14520,relay,rile,3,2,1,0,3
release,14521,release,rIlis,2,2,0,0,2
relic,14528,relic,rElIk,3,2,1,1,2
relict,14529,relict,rElIkt,1,0,1,0,1
relief,14530,relief,rIlif,2,2,0,0,2
relieve,14531,relieve,rIliv,3,3,0,1,2
relish,14536,relish,rElIS,2,2,0,1,1
rely,14538,rely,rIlY,3,1,2,1,2
remand,14540,remand,rIm@nd,1,1,0,0,1
remind,14547,remind,rImYnd,2,2,0,1,1
remiss,14549,remiss,rImIs,1,1,0,0,1
remit,14551,remit,rImIt,3,2,1,1,2
remote,14561,remote,rImot,2,1,1,1,1
renal,14566,renal,rinL,5,4,1,3,2
rend,14569,rend,rEnd,19,13,6,14,5
render,14570,render,rEndX,4,3,1,3,1
renew,14575,renew,rInu,1,1,0,0,1
rent,14581,rent,rEnt,17,15,2,12,5
rental,14582,rental,rEntL,7,6,1,6,1
repair,14585,repair,rIpEr,2,1,1,1,1
repay,14590,repay,ripe,3,1,2,1,2
repeal,14591,repeal,rIpil,3,3,0,1,2
repeat,14592,repeat,rIpit,3,2,1,1,2
repel,14593,repel,rIpEl,2,2,0,0,2
repine,14600,repine,rIpYn,2,2,0,2,0
replete,14604,replete,rIplit,2,1,1,1,1
reply,14607,reply,rIplY,1,0,1,0,1
reptile,14625,reptile,rEptL,2,2,0,2,0
reside,14658,reside,rIzYd,3,1,2,1,2
resign,14665,resign,rIzYn,5,4,1,3,2
resigned,14667,resigned,rIzYnd,4,2,2,1,3
resin,14669,resin,rEzN,5,5,0,4,1
resound,14677,resound,rIzWnd,2,2,0,1,1
rest,14693,rest,rEst,20,17,3,18,2
retch,14715,retch,rEC,13,11,2,7,6
rev,14738,rev,rEv,10,9,1,4,6
reveal,14740,reveal,rIvil,2,2,0,1,1
reveille,14741,reveille,rEvLi,2,1,1,0,2
revel,14742,revel,rEvL,9,7,2,5,4
reversal,14750,reversal,rIvRsL,2,1,1,1,1
reverse,14751,reverse,rIvRs,3,2,1,1,2
revert,14753,revert,rIvRt,2,2,0,0,2
revery,14754,revery,rEvXi,2,2,0,1,1
revile,14756,revile,rIvYl,3,3,0,0,3
revise,14757,revise,rIvYz,2,2,0,0,2
revival,14760,revival,rIvYvL,1,0,1,0,1
revive,14761,revive,rIvYv,3,2,1,0,3
rheum,14780,rheum,rum,24,20,4,15,9
rhyme,14792,rhyme,rYm,25,20,5,14,11
rial,14795,rial,ricl,3,1,2,0,3
rib,14796,rib,rIb,19,18,1,8,11
ribbon,14799,ribbon,rIb|n,2,2,0,2,0
rice,14801,rice,rYs,23,18,5,13,10
rich,14802,rich,rIC,21,20,1,10,11
rick,14804,rick,rIk,34,27,7,20,14
rid,14807,rid,rId,29,25,4,16,13
riddance,14808,riddance,rIdNs,2,1,1,0,2
ridden,14809,ridden,rIdN,10,8,2,5,5
riddle,14810,riddle,rIdL,8,6,2,4,4
ride,14811,ride,rYd,30,24,6,18,12
rider,14812,rider,rYdX,6,4,2,3,3
ridge,14813,ridge,rIJ,14,13,1,3,11
riding,14817,riding,rYdIG,7,7,0,7,0
riel,14818,riel,riEl,2,1,1,0,2
rife,14819,rife,rYf,18,16,2,7,11
rifle,14821,rifle,rYfL,6,3,3,3,3
rift,14822,rift,rIft,12,8,4,9,3
rig,14823,rig,rIg,26,21,5,13,13
right,14825,right,rYt,35,28,7,23,12
rightful,14827,rightful,rYtfL,1,0,1,0,1
rigor,14832,rigor,rIgX,7,5,2,4,3
rile,14833,rile,rYl,26,24,2,16,10
rill,14834,rill,rIl,38,30,8,26,12
rim,14835,rim,rIm,26,22,4,15,11
rimy,14836,rimy,rYmi,4,3,1,3,1
rind,14837,rind,rYnd,10,8,2,9,1
ring,14838,ring,rIG,23,21,2,11,12
rink,14841,rink,rIGk,19,11,8,15,4
rinse,14842,rinse,rIns,5,4,1,4,1
riot,14843,riot,rYxt,2,1,1,1,1
rip,14844,rip,rIp,32,28,4,20,12
ripe,14846,ripe,rYp,20,17,3,10,10
ripple,14849,ripple,rIpL,7,4,3,4,3
rise,14851,rise,rYz,21,17,4,10,11
risen,14852,risen,rIzN,8,7,1,6,2
riser,14853,riser,rYzX,8,7,1,5,3
rising,14856,rising,rYzIG,3,3,0,3,0
risk,14857,risk,rIsk,9,5,4,5,4
risque,14858,risque,rIske,1,0,1,0,1
rival,14862,rival,rYvL,5,3,2,3,2
rive,14864,rive,rYv,24,19,5,13,11
riven,14865,riven,rIvxn,6,3,3,5,1
river,14866,river,rIvX,4,4,0,3,1
rivet,14867,rivet,rIvxt,7,5,2,5,2
riving,14868,riving,rYvIG,6,3,3,6,0
riyal,14870,riyal,riycl,1,0,1,0,1
roach,14871,roach,roC,18,16,2,6,12
road,14872,road,rod,29,26,3,17,12
roam,14875,roam,rom,28,24,4,16,12
roan,14876,roan,ron,35,28,7,23,12
roar,14877,roar,ror,31,28,3,19,12
roast,14878,roast,rost,12,11,1,11,1
rob,14879,rob,rab,17,16,1,14,3
robe,14881,robe,rob,18,15,3,6,12
robin,14882,robin,rab|n,2,2,0,2,0
rock,14885,rock,rak,23,20,3,19,4
rocker,14886,rocker,rakX,4,3,1,2,2
rocket,14887,rocket,rak|t,5,5,0,5,0
rod,14888,rod,rad,21,18,3,18,3
roe,14891,roe,ro,38,17,21,22,16
roger,14894,roger,raJX,4,4,0,2,2
rogue,14895,rogue,rog,18,15,3,6,12
roguery,14896,roguery,rogXi,2,2,0,2,0
roister,14898,roister,rOstX,2,1,1,2,0
role,14899,role,rol,34,30,4,21,13
roller,14900,roller,rolX,9,8,1,6,3
rollick,14901,rollick,ralIk,3,2,1,3,0
roman,14902,roman,romxn,4,3,1,4,0
romp,14907,romp,ramp,3,3,0,3,0
rood,14908,rood,rud,24,19,5,16,8
roof,14909,roof,ruf,13,11,2,5,8
rook,14910,rook,rUk,17,14,3,15,2
rookie,14911,rookie,rUki,2,1,1,1,1
roost,14914,roost,rust,7,5,2,5,2
root,14915,root,rut,30,26,4,21,9
rope,14917,rope,rop,27,23,4,15,12
rosary,14918,rosary,rozXi,3,2,1,2,1
rose,14919,rose,roz,26,22,4,13,13
rosin,14924,rosin,razN,5,5,0,4,1
roster,14925,roster,rastX,1,1,0,1,0
rosy,14927,rosy,rozi,7,4,3,5,2
rot,14928,rot,rat,29,26,3,25,4
rotary,14929,rotary,rotXi,4,3,1,3,1
rote,14934,rote,rot,35,29,6,21,14
rotor,14936,rotor,rotX,6,4,2,2,4
rotten,14937,rotten,ratN,5,4,1,3,2
rouble,14940,rouble,rubL,4,4,0,3,1
roue,14941,roue,rUe,2,1,1,0,2
rouge,14942,rouge,ruZ,8,7,1,0,8
rough,14943,rough,r^f,20,17,3,11,9
roughen,14945,roughen,r^fxn,2,1,1,1,1
round,14948,round,rWnd,12,10,2,12,0
rouse,14953,rouse,rWz,10,7,3,8,2
rout,14955,rout,rWt,21,18,3,19,2
rove,14957,rove,rov,26,20,6,13,13
rover,14958,rover,rovX,6,3,3,3,3
rowdy,14960,rowdy,rWdi,3,3,0,3,0
rowel,14961,rowel,rWL,9,8,1,7,2
royal,14962,royal,rOL,3,3,0,3,0
rub,14963,rub,r^b,23,18,5,14,9
rubber,14964,rubber,r^bX,4,3,1,1,3
rubble,14966,rubble,r^bL,13,10,3,7,6
ruby,14970,ruby,rubi,3,3,0,1,2
rudder,14971,rudder,r^dX,4,4,0,2,2
ruddy,14972,ruddy,r^di,6,6,0,3,3
rue,14975,rue,ru,37,22,15,25,12
ruffed,14976,ruffed,r^ft,8,6,2,3,5
ruffian,14977,ruffian,r^fixn,1,0,1,0,1
ruffle,14978,ruffle,r^fL,10,8,2,5,5
rug,14979,rug,r^g,22,20,2,15,7
ruin,14982,ruin,ruIn,1,0,1,0,1
rule,14985,rule,rul,23,18,5,14,9
ruler,14986,ruler,rulX,3,2,1,1,2
rum,14987,rum,r^m,29,23,6,20,9
rumba,14988,rumba,r^mbx,1,1,0,0,1
rumble,14989,rumble,r^mbL,12,8,4,9,3
rummy,14994,rummy,r^mi,10,9,1,6,4
rumor,14995,rumor,rumX,4,3,1,2,2
rump,14996,rump,r^mp,14,11,3,11,3
rumple,14997,rumple,r^mpL,3,1,2,1,2
run,15000,run,r^n,26,23,3,16,10
rune,15006,rune,run,25,21,4,16,9
rung,15007,rung,r^G,17,17,0,10,7
runic,15008,runic,runIk,1,1,0,1,0
runnel,15010,runnel,r^nL,10,9,1,4,6
runny,15012,runny,r^ni,12,11,1,7,5
runt,15014,runt,r^nt,15,10,5,9,6
rupee,15016,rupee,rupi,2,1,1,0,2
rupiah,15017,rupiah,rupix,1,0,1,0,1
rupture,15018,rupture,r^pCX,1,1,0,1,0
ruse,15020,ruse,rus,19,16,3,10,9
rush,15021,rush,r^S,15,12,3,8,7
rusk,15022,rusk,r^sk,8,7,1,6,2
russet,15023,russet,r^s|t,2,1,1,1,1
rust,15025,rust,r^st,19,14,5,13,6
rustle,15032,rustle,r^sL,10,10,0,5,5
rut,15033,rut,r^t,28,25,3,18,10
rye,15037,rye,rY,37,20,17,23,14
s,15038,s,Es,21,12,9,11,10
sable,15040,sable,sebL,10,8,2,9,1
sabre,15042,sabre,sebX,8,8,0,4,4
sac,15043,sac,s@k,28,23,5,20,8
sachet,15047,sachet,s@Se,2,1,1,1,1
sad,15057,sad,s@d,25,21,4,15,10
sadden,15058,sadden,s@dN,6,5,1,3,3
saddle,15059,saddle,s@dL,7,4,3,3,4
safe,15065,safe,sef,11,10,1,3,8
sag,15068,sag,s@g,22,18,4,15,7
saga,15069,saga,sagx,1,1,0,0,1
sage,15072,sage,seJ,19,15,4,11,8
said,15075,said,sEd,21,17,4,16,5
sail,15076,sail,sel,34,27,7,25,9
sailor,15077,sailor,selX,8,7,1,4,4
saint,15078,saint,sent,6,4,2,4,2
sake,15079,sake,sek,28,23,5,20,8
saki,15080,saki,saki,10,7,3,6,4
salad,15082,salad,s@lxd,3,3,0,3,0
salary,15085,salary,s@lXi,4,3,1,3,1
sallow,15091,sallow,s@lo,12,9,3,10,2
sally,15092,sally,s@li,15,13,2,11,4
salmon,15093,salmon,s@mxn,7,7,0,7,0
saloon,15094,saloon,sxlun,2,2,0,1,1
salt,15095,salt,sclt,11,8,3,7,4
salute,15101,salute,sxlut,3,3,0,2,1
salvage,15102,salvage,s@lvIJ,2,1,1,2,0
salve,15104,salve,s@v,12,12,0,5,7
salver,15105,salver,s@lvX,2,2,0,1,1
salvo,15106,salvo,s@lvo,2,1,1,0,2
same,15108,same,sem,21,19,2,13,8
sample,15109,sample,s@mpL,2,1,1,2,0
sand,15118,sand,s@nd,13,9,4,10,3
sandal,15119,sandal,s@ndL,7,4,3,5,2
sane,15124,sane,sen,33,27,6,24,9
sang,15125,sang,s@G,19,17,2,11,8
sank,15133,sank,s@Gk,17,11,6,15,2
sans,15134,sans,s@nz,2,2,0,1,1
sap,15136,sap,s@p,27,24,3,19,8
sappy,15140,sappy,s@pi,4,3,1,1,3
sash,15148,sash,s@S,20,16,4,12,8
sassy,15150,sassy,s@si,3,3,0,1,2
sat,15151,sat,s@t,32,28,4,24,8
satan,15152,Satan,setN,4,3,1,2,2
satchel,15155,satchel,s@CL,1,1,0,0,1
sate,15156,sate,set,36,26,10,25,11
sateen,15157,sateen,s@tin,1,1,0,0,1
satin,15161,satin,s@tN,8,7,1,6,2
satrap,15167,satrap,setr@p,1,0,1,1,0
saturn,15171,Saturn,s@tXn,3,2,1,2,1
satyr,15173,satyr,setX,9,8,1,4,5
sauce,15174,sauce,scs,10,8,2,6,4
saucer,15176,saucer,scsX,1,0,1,0,1
saunter,15178,saunter,scntX,2,2,0,2,0
saute,15180,saute,scte,2,0,2,1,1
sauterne,15181,sauterne,sotRn,2,1,1,2,0
savage,15182,savage,s@vIJ,2,1,1,2,0
save,15184,save,sev,22,18,4,13,9
saviour,15185,saviour,sevyX,1,0,1,0,1
savor,15186,savor,sevX,8,6,2,3,5
saw,15187,saw,sc,23,18,5,11,12
say,15190,say,se,37,23,14,17,20
scab,15191,scab,sk@b,4,3,1,3,1
scald,15194,scald,skcld,1,1,0,1,0
scale,15195,scale,skel,10,8,2,4,6
scalp,15199,scalp,sk@lp,2,1,1,0,2
scalpel,15200,scalpel,sk@lpL,1,0,1,0,1
scamp,15201,scamp,sk@mp,5,3,2,3,2
scamper,15202,scamper,sk@mpX,1,0,1,0,1
scan,15203,scan,sk@n,7,5,2,2,5
scandal,15204,scandal,sk@ndL,2,0,2,2,0
scant,15207,scant,sk@nt,3,1,2,2,1
scar,15209,scar,skar,10,8,2,3,7
scarce,15211,scarce,skErs,1,0,1,0,1
scare,15214,scare,skEr,11,8,3,5,6
scarf,15216,scarf,skarf,2,0,2,0,2
scatter,15220,scatter,sk@tX,1,1,0,1,0
scene,15224,scene,sin,29,27,2,18,11
scenic,15226,scenic,sinIk,3,3,0,3,0
scepter,15227,scepter,sEptX,3,2,1,3,0
scheme,15231,scheme,skim,6,3,3,2,4
schilling,15232,schilling,SIlIG,4,4,0,4,0
schism,15233,schism,sIzM,3,2,1,1,2
scholar,15238,scholar,skalX,2,0,2,2,0
school,15240,school,skul,8,7,1,3,5
science,15243,science,sY|ns,1,0,1,0,1
scion,15250,scion,sY|n,5,2,3,3,2
scoff,15253,scoff,skaf,6,5,1,0,6
scold,15254,scold,skold,3,1,2,3,0
scone,15255,scone,skon,9,6,3,3,6
scoop,15256,scoop,skup,9,7,2,6,3
scope,15257,scope,skop,7,5,2,3,4
scorch,15258,scorch,skorC,2,1,1,0,2
score,15259,score,skor,14,10,4,7,7
scorn,15260,scorn,skorn,6,3,3,3,3
scot,15263,scot,skat,14,10,4,5,9
scotch,15264,scotch,skaC,4,4,0,0,4
scots,15265,Scots,skats,1,0,1,0,1
scour,15268,scour,skWr,7,5,2,1,6
scourge,15269,scourge,skRJ,5,4,1,2,3
scout,15270,scout,skWt,10,9,1,3,7
scow,15271,scow,skW,7,2,5,2,5
scowl,15272,scowl,skWl,8,6,2,1,7
scrap,15275,scrap,skr@p,4,4,0,1,3
scrape,15276,scrape,skrep,3,2,1,1,2
scratch,15277,scratch,skr@C,2,2,0,0,2
scrawl,15278,scrawl,skrcl,4,3,1,3,1
scream,15280,scream,skrim,6,4,2,2,4
screech,15281,screech,skriC,3,3,0,0,3
screen,15282,screen,skrin,2,2,0,0,2
screw,15283,screw,skru,4,3,1,3,1
scrim,15286,scrim,skrIm,4,2,2,1,3
scrimp,15288,scrimp,skrImp,4,0,4,2,2
scrip,15289,scrip,skrIp,7,4,3,2,5
script,15290,script,skrIpt,2,0,2,1,1
scroll,15293,scroll,skrol,2,2,0,1,1
scud,15301,scud,sk^d,6,5,1,3,3
scuffle,15302,scuffle,sk^fL,2,2,0,1,1
scull,15303,scull,sk^l,8,6,2,1,7
scum,15308,scum,sk^m,9,6,3,5,4
scupper,15309,scupper,sk^pX,2,1,1,2,0
scurf,15310,scurf,skRf,6,5,1,1,5
scurry,15312,scurry,skRi,7,3,4,2,5
scurvy,15313,scurvy,skRvi,1,0,1,0,1
scuttle,15315,scuttle,sk^tL,2,1,1,1,1
scythe,15316,scythe,sYD,11,10,1,5,6
seal,15317,seal,sil,31,28,3,20,11
seam,15319,seam,sim,22,18,4,10,12
seaman,15320,seaman,simxn,4,4,0,4,0
seamy,15322,seamy,simi,2,0,2,0,2
sear,15324,sear,sIr,33,26,7,25,8
search,15325,search,sRC,11,9,2,6,5
season,15327,season,sizN,3,2,1,1,2
seat,15329,seat,sit,32,28,4,21,11
secede,15332,secede,sIsid,1,1,0,1,0
sect,15346,sect,sEkt,5,3,2,0,5
sector,15350,sector,sEktX,9,6,3,8,1
sedge,15358,sedge,sEJ,13,11,2,9,4
seduce,15362,seduce,sIdus,3,2,1,3,0
seek,15364,seek,sik,31,25,6,19,12
seemly,15365,seemly,simli,1,0,1,0,1
seep,15366,seep,sip,31,26,5,19,12
seesaw,15367,seesaw,sisc,1,0,1,0,1
seethe,15368,seethe,siD,16,15,1,5,11
seize,15375,seize,siz,22,17,5,9,13
seizure,15376,seizure,siZX,3,3,0,1,2
select,15378,select,sxlEkt,2,1,1,2,0
self,15382,self,sElf,7,5,2,4,3
selvedge,15385,selvedge,sElvIJ,1,1,0,1,0
selves,15386,selves,sElvz,2,1,1,2,0
semen,15390,semen,simxn,4,4,0,4,0
semite,15400,Semite,sEmYt,1,0,1,1,0
sen,15403,sen,sEn,28,23,5,20,8
senate,15404,senate,sEn|t,5,3,2,3,2
senator,15405,senator,sEn|tX,2,0,2,0,2
send,15407,send,sEnd,18,13,5,13,5
senna,15413,senna,sEnx,5,4,1,1,4
sense,15415,sense,sEns,13,11,2,7,6
sensory,15423,sensory,sEnsXi,2,1,1,0,2
sepal,15435,sepal,sipL,4,2,2,3,1
serene,15461,serene,sXin,4,3,1,4,0
serf,15462,serf,sRf,8,6,2,3,5
serge,15463,serge,sRJ,15,11,4,10,5
sermon,15467,sermon,sRmxn,7,6,1,7,0
serrate,15469,serrate,sXet,5,4,1,5,0
serried,15471,serried,sErid,1,1,0,1,0
serum,15472,serum,sIrM,3,2,1,1,2
serve,15474,serve,sRv,14,10,4,7,7
servile,15476,servile,sRvL,4,3,1,1,3
sessile,15481,sessile,sEsL,5,5,0,4,1
set,15482,set,sEt,32,24,8,22,10
settee,15484,settee,sEti,6,5,1,3,3
setter,15485,setter,sEtX,15,9,6,9,6
settle,15486,settle,sEtL,10,9,1,6,4
settler,15488,settler,sEtlX,2,0,2,0,2
seven,15489,seven,sEvxn,2,2,0,2,0
sever,15492,sever,sEvX,8,5,3,5,3
several,15493,several,sEvXL,1,0,1,0,1
sew,15495,sew,so,29,21,8,14,15
sewer,15497,sewer,suX,9,6,3,1,8
sewing,15498,sewing,soIG,5,4,1,5,0
sewn,15499,sewn,son,27,23,4,22,5
sex,15500,sex,sEks,6,5,1,4,2
shabby,15507,shabby,S@bi,7,5,2,4,3
shack,15508,shack,S@k,22,20,2,16,6
shackle,15509,shackle,S@kL,5,4,1,4,1
shad,15510,shad,S@d,20,18,2,15,5
shade,15511,shade,Sed,18,17,1,12,6
shadow,15513,shadow,S@do,3,2,1,0,3
shaft,15514,shaft,S@ft,5,4,1,5,0
shag,15515,shag,S@g,15,15,0,11,4
shake,15516,shake,Sek,24,22,2,17,7
shaky,15518,shaky,Seki,1,0,1,0,1
shale,15519,shale,Sel,27,26,1,21,6
shall,15520,shall,S@l,13,10,3,6,7
shallow,15522,shallow,S@lo,12,10,2,7,5
sham,15523,sham,S@m,15,13,2,10,5
shamble,15524,shamble,S@mbL,3,2,1,3,0
shame,15525,shame,Sem,17,16,1,11,6
shank,15529,shank,S@Gk,12,9,3,11,1
shape,15530,shape,Sep,16,15,1,10,6
shard,15531,shard,Sard,12,11,1,9,3
share,15532,share,SEr,22,20,2,18,4
shark,15533,shark,Sark,10,8,2,7,3
sharp,15534,sharp,Sarp,5,4,1,2,3
shatter,15536,shatter,S@tX,10,9,1,9,1
shave,15537,shave,Sev,16,16,0,10,6
shaven,15538,shaven,Sevxn,2,2,0,2,0
shaves,15539,shaves,S@vz,3,3,0,3,0
shawl,15540,shawl,Scl,16,15,1,16,0
she,15541,she,Si,31,21,10,19,12
sheaf,15542,sheaf,Sif,14,13,1,7,7
shear,15543,shear,SIr,26,24,2,21,5
shears,15544,shears,SIrz,1,0,1,0,1
sheath,15545,sheath,SiT,11,10,1,4,7
sheathe,15546,sheathe,SiD,11,9,2,3,8
sheaths,15547,sheaths,SiDz,2,1,1,0,2
sheave,15548,sheave,SIv,10,9,1,5,5
sheaves,15549,sheaves,Sivz,6,5,1,5,1
shed,15550,shed,SEd,17,16,1,14,3
sheen,15551,sheen,Sin,21,20,1,14,7
sheep,15552,sheep,Sip,20,19,1,13,7
sheet,15554,sheet,Sit,23,21,2,16,7
shelf,15555,shelf,SElf,6,3,3,3,3
shell,15556,shell,SEl,21,18,3,16,5
shelter,15559,shelter,SEltX,1,1,0,1,0
shelve,15560,shelve,SElv,5,3,2,2,3
shelves,15561,shelves,SElvz,3,1,2,2,1
shepherd,15562,shepherd,SEpXd,1,1,0,1,0
sherry,15565,sherry,SEri,8,6,2,7,1
shew,15566,shew,So,23,17,6,14,9
shield,15568,shield,Sild,4,4,0,4,0
shift,15569,shift,SIft,6,5,1,6,0
shill,15570,shill,SIl,25,23,2,21,4
shimmer,15571,shimmer,SImX,4,4,0,2,2
shimmy,15572,shimmy,SImi,3,3,0,2,1
shin,15573,shin,SIn,20,19,1,16,4
shine,15574,shine,SYn,21,17,4,17,4
shiner,15575,shiner,SYnX,5,4,1,3,2
shingle,15576,shingle,SIGgL,6,5,1,6,0
shiny,15579,shiny,SYni,3,2,1,1,2
ship,15580,ship,SIp,19,19,0,15,4
shire,15583,shire,SYr,16,14,2,14,2
shirk,15584,shirk,SRk,16,14,2,14,2
shirr,15585,shirr,SR,13,11,2,7,6
shirt,15586,shirt,SRt,15,14,1,13,2
shiver,15587,shiver,SIvX,4,3,1,2,2
shoal,15588,shoal,Sol,24,23,1,19,5
shoat,15589,shoat,Sot,22,19,3,16,6
shock,15590,shock,Sak,21,20,1,17,4
shod,15591,shod,Sad,18,15,3,13,5
shoddy,15592,shoddy,Sadi,5,4,1,4,1
shoe,15593,shoe,Su,25,22,3,19,6
shone,15595,shone,Son,23,20,3,17,6
shook,15596,shook,SUk,15,15,0,13,2
shop,15597,shop,Sap,16,15,1,12,4
shore,15598,shore,Sor,28,23,5,21,7
shorn,15599,shorn,Sorn,11,9,2,8,3
short,15600,short,Sort,10,7,3,6,4
shorten,15603,shorten,SortN,1,0,1,0,1
shot,15606,shot,Sat,23,23,0,20,3
should,15607,should,SUd,10,10,0,8,2
shoulder,15608,shoulder,SoldX,2,2,0,2,0
shout,15609,shout,SWt,15,14,1,14,1
shove,15610,shove,S^v,7,6,1,3,4
shovel,15611,shovel,S^vL,4,3,1,1,3
shower,15612,shower,SWX,6,6,0,5,1
showman,15613,showman,Somxn,4,3,1,4,0
showy,15614,showy,Soi,6,4,2,0,6
shrank,15615,shrank,Sr@Gk,8,6,2,8,0
shrapnel,15616,shrapnel,Sr@pnL,1,1,0,1,0
shred,15617,shred,SrEd,8,6,2,6,2
shrew,15618,shrew,Sru,9,6,3,7,2
shrewd,15619,shrewd,Srud,7,5,2,4,3
shriek,15620,shriek,Srik,6,4,2,5,1
shrift,15621,shrift,SrIft,4,2,2,4,0
shrike,15622,shrike,SrYk,3,3,0,0,3
shrill,15623,shrill,SrIl,8,5,3,7,1
shrilly,15624,shrilly,SrIli,1,0,1,0,1
shrimp,15625,shrimp,SrImp,2,2,0,2,0
shrine,15626,shrine,SrYn,5,4,1,3,2
shrink,15627,shrink,SrIGk,6,5,1,6,0
shrive,15628,shrive,SrYv,6,5,1,3,3
shrivel,15629,shrivel,SrIvL,1,1,0,1,0
shriven,15630,shriven,SrIvxn,3,2,1,3,0
shriving,15631,shriving,SrYvIG,3,2,1,3,0
shroud,15632,shroud,SrWd,4,4,0,2,2
shrove,15633,shrove,Srov,5,4,1,4,1
shrub,15634,shrub,Sr^b,4,3,1,3,1
shrug,15635,shrug,Sr^g,3,2,1,2,1
shrunk,15636,shrunk,Sr^Gk,4,4,0,4,0
shuck,15637,shuck,S^k,17,17,0,14,3
shudder,15638,shudder,S^dX,2,2,0,1,1
shuffle,15639,shuffle,S^fL,4,4,0,2,2
shun,15640,shun,S^n,19,18,1,15,4
shunt,15641,shunt,S^nt,6,4,2,4,2
shut,15642,shut,S^t,21,18,3,15,6
shutter,15643,shutter,S^tX,10,8,2,7,3
shuttle,15644,shuttle,S^tL,5,4,1,1,4
shy,15645,shy,SY,23,20,3,17,6
sibyl,15648,sibyl,sIbL,7,6,1,4,3
sick,15649,sick,sIk,29,23,6,18,11
sicken,15650,sicken,sIk|n,1,1,0,1,0
sickle,15651,sickle,sIkL,13,11,2,8,5
side,15652,side,sYd,23,17,6,15,8
siding,15656,siding,sYdIG,4,3,1,4,0
sidle,15657,sidle,sYdL,7,5,2,3,4
siege,15658,siege,siJ,15,14,1,4,11
sieve,15661,sieve,sIv,14,13,1,6,8
sift,15662,sift,sIft,9,7,2,6,3
sigh,15663,sigh,sY,35,24,11,17,18
sign,15664,sign,sYn,31,24,7,24,7
silk,15684,silk,sIlk,10,7,3,4,6
sill,15685,sill,sIl,35,26,9,24,11
silly,15686,silly,sIli,12,11,1,7,5
silo,15687,silo,sYlo,3,2,1,3,0
silt,15688,silt,sIlt,19,15,4,12,7
silver,15689,silver,sIlvX,1,1,0,1,0
similar,15692,similar,sImLX,2,1,1,0,2
simmer,15697,simmer,sImX,5,3,2,3,2
simper,15700,simper,sImpX,3,2,1,0,3
simple,15701,simple,sImpL,6,6,0,4,2
sin,15709,sin,sIn,31,25,6,21,10
since,15710,since,sIns,8,7,1,4,4
sing,15714,sing,sIG,22,17,5,14,8
singe,15715,singe,sInJ,7,5,2,4,3
single,15716,single,sIGgL,6,5,1,6,0
sinister,15721,sinister,sIn|stX,1,1,0,1,0
sink,15722,sink,sIGk,17,12,5,14,3
sinus,15725,sinus,sYn|s,2,2,0,2,0
sip,15726,sip,sIp,28,25,3,21,7
sir,15728,sir,sR,23,15,8,7,16
sire,15729,sire,sYr,20,17,3,14,6
sisal,15733,sisal,sYsL,3,3,0,1,2
sister,15734,sister,sIstX,3,1,2,1,2
sit,15735,sit,sIt,36,28,8,25,11
six,15738,six,sIks,8,7,1,5,3
size,15741,size,sYz,12,10,2,6,6
sizzle,15743,sizzle,sIzL,6,6,0,2,4
skate,15744,skate,sket,11,10,1,5,6
skein,15745,skein,sken,10,8,2,5,5
sketch,15747,sketch,skEC,3,2,1,1,2
skew,15748,skew,skyu,5,2,3,3,2
skewer,15749,skewer,skyuX,1,0,1,0,1
ski,15750,ski,ski,9,3,6,4,5
skid,15751,skid,skId,10,8,2,2,8
skiff,15752,skiff,skIf,10,10,0,2,8
skill,15753,skill,skIl,15,13,2,5,10
skim,15755,skim,skIm,12,10,2,3,9
skimp,15756,skimp,skImp,4,1,3,2,2
skin,15757,skin,skIn,13,11,2,4,9
skip,15760,skip,skIp,15,10,5,5,10
skipper,15761,skipper,skIpX,4,2,2,3,1
skirt,15763,skirt,skRt,10,8,2,2,8
skit,15764,skit,skIt,14,12,2,4,10
skulk,15766,skulk,sk^lk,3,1,2,1,2
skunk,15767,skunk,sk^Gk,5,4,1,4,1
sky,15768,sky,skY,6,5,1,3,3
slab,15769,slab,sl@b,11,10,1,4,7
slack,15770,slack,sl@k,19,17,2,9,10
slag,15772,slag,sl@g,14,12,2,6,8
slain,15773,slain,slen,11,8,3,7,4
slake,15774,slake,slek,12,9,3,5,7
slam,15776,slam,sl@m,13,12,1,3,10
slang,15778,slang,sl@G,11,10,1,2,9
slant,15779,slant,sl@nt,4,2,2,3,1
slap,15780,slap,sl@p,17,15,2,5,12
slash,15781,slash,sl@S,15,12,3,7,8
slat,15782,slat,sl@t,18,16,2,4,14
slate,15783,slate,slet,18,15,3,8,10
slattern,15784,slattern,sl@tXn,1,0,1,1,0
slav,15786,Slav,slav,5,5,0,1,4
slave,15787,slave,slev,9,6,3,3,6
slaver,15788,slaver,sl@vX,1,1,0,1,0
slaw,15792,slaw,slc,10,7,3,3,7
slay,15793,slay,sle,19,12,7,9,10
sled,15795,sled,slEd,10,8,2,7,3
sledge,15796,sledge,slEJ,6,4,2,4,2
sleek,15797,sleek,slik,12,10,2,6,6
sleep,15798,sleep,slip,13,10,3,5,8
sleet,15799,sleet,slit,17,15,2,8,9
sleeve,15800,sleeve,sliv,7,6,1,2,5
sleight,15801,sleight,slYt,18,15,3,8,10
slept,15803,slept,slEpt,1,1,0,1,0
sleuth,15804,sleuth,sluT,5,3,2,1,4
slew,15805,slew,slu,15,10,5,7,8
slice,15806,slice,slYs,8,5,3,3,5
slick,15807,slick,slIk,15,11,4,5,10
slicker,15808,slicker,slIkX,7,5,2,3,4
slid,15809,slid,slId,9,8,1,2,7
slide,15810,slide,slYd,10,8,2,4,6
sliding,15811,sliding,slYdIG,1,0,1,1,0
slim,15812,slim,slIm,11,10,1,3,8
slime,15813,slime,slYm,9,7,2,2,7
sling,15814,sling,slIG,16,12,4,8,8
slink,15815,slink,slIGk,8,4,4,6,2
slip,15816,slip,slIp,17,14,3,6,11
slipper,15818,slipper,slIpX,7,5,2,2,5
slippery,15819,slippery,slIpXi,1,0,1,0,1
slit,15821,slit,slIt,18,15,3,7,11
slither,15822,slither,slIDX,3,3,0,0,3
sliver,15823,sliver,slIvX,6,5,1,3,3
sloe,15825,sloe,slo,16,10,6,9,7
sloop,15827,sloop,slup,14,11,3,6,8
slop,15828,slop,slap,15,12,3,7,8
slope,15829,slope,slop,9,7,2,3,6
sloppy,15830,sloppy,slapi,1,0,1,0,1
slot,15831,slot,slat,17,15,2,9,8
sloth,15832,sloth,slcT,3,2,1,1,2
sludge,15835,sludge,sl^J,7,7,0,1,6
slug,15836,slug,sl^g,10,9,1,4,6
sluice,15838,sluice,slus,5,3,2,1,4
slum,15839,slum,sl^m,14,12,2,5,9
slumber,15840,slumber,sl^mbX,1,0,1,1,0
slump,15841,slump,sl^mp,5,3,2,4,1
slung,15842,slung,sl^G,14,11,3,6,8
slunk,15843,slunk,sl^Gk,8,6,2,7,1
slur,15844,slur,slR,9,8,1,3,6
slush,15845,slush,sl^S,10,9,1,4,6
slut,15846,slut,sl^t,13,13,0,2,11
sly,15847,sly,slY,17,11,6,7,10
smack,15848,smack,sm@k,9,7,2,5,4
small,15849,small,smcl,5,4,1,2,3
smart,15850,smart,smart,2,1,1,2,0
smash,15851,smash,sm@S,4,2,2,3,1
smear,15853,smear,smIr,8,6,2,7,1
smell,15854,smell,smEl,7,4,3,3,4
smelled,15855,smelled,smEld,3,1,2,1,2
smelt,15856,smelt,smElt,5,2,3,3,2
smile,15858,smile,smYl,5,4,1,2,3
smirch,15859,smirch,smRC,3,2,1,1,2
smirk,15860,smirk,smRk,5,4,1,1,4
smite,15861,smite,smYt,8,5,3,5,3
smith,15862,smith,smIT,3,1,2,1,2
smithy,15864,smithy,smITi,1,0,1,0,1
smitten,15866,smitten,smItN,1,0,1,1,0
smock,15867,smock,smak,6,4,2,3,3
smog,15868,smog,smcg,2,2,0,0,2
smoke,15869,smoke,smok,7,6,1,3,4
smooth,15870,smooth,smuD,1,0,1,1,0
smote,15872,smote,smot,6,5,1,3,3
smother,15873,smother,sm^DX,1,0,1,1,0
smoulder,15874,smoulder,smoldX,1,0,1,1,0
smudge,15875,smudge,sm^J,4,4,0,1,3
smug,15876,smug,sm^g,8,6,2,3,5
smuggle,15877,smuggle,sm^gL,2,1,1,1,1
smut,15878,smut,sm^t,7,6,1,2,5
smutch,15879,smutch,sm^C,6,4,2,2,4
snack,15880,snack,sn@k,10,8,2,5,5
snaffle,15881,snaffle,sn@fL,2,2,0,2,0
snag,15882,snag,sn@g,9,7,2,5,4
snail,15883,snail,snel,5,3,2,4,1
snake,15884,snake,snek,6,5,1,3,3
snap,15885,snap,sn@p,9,7,2,3,6
snare,15887,snare,snEr,6,6,0,4,2
snarl,15888,snarl,snarl,1,0,1,1,0
snatch,15889,snatch,sn@C,4,4,0,0,4
sneak,15890,sneak,snik,7,5,2,3,4
sneaker,15891,sneaker,snikX,2,1,1,1,1
sneer,15892,sneer,snIr,11,9,2,6,5
sneeze,15893,sneeze,sniz,3,2,1,1,2
snicker,15894,snicker,snIkX,4,3,1,3,1
snide,15895,snide,snYd,3,2,1,2,1
sniff,15896,sniff,snIf,7,6,1,2,5
sniffle,15897,sniffle,snIfL,4,3,1,2,2
snigger,15898,snigger,snIgX,1,1,0,0,1
snip,15899,snip,snIp,11,8,3,4,7
snipe,15900,snipe,snYp,5,5,0,1,4
snippy,15901,snippy,snIpi,2,0,2,1,1
snitch,15902,snitch,snIC,7,6,1,3,4
snivel,15903,snivel,snIvL,3,2,1,2,1
snob,15904,snob,snab,4,2,2,3,1
snoop,15905,snoop,snup,9,8,1,5,4
snooze,15906,snooze,snuz,3,2,1,1,2
snore,15907,snore,snor,9,6,3,6,3
snort,15909,snort,snort,4,2,2,3,1
snout,15910,snout,snWt,3,3,0,3,0
snub,15911,snub,sn^b,6,4,2,3,3
snuff,15912,snuff,sn^f,6,5,1,2,4
snuffle,15913,snuffle,sn^fL,5,4,1,3,2
snug,15914,snug,sn^g,6,5,1,2,4
snuggle,15915,snuggle,sn^gL,3,2,1,1,2
soak,15916,soak,sok,23,18,5,18,5
soap,15917,soap,sop,21,17,4,16,5
soar,15919,soar,sor,32,22,10,24,8
sob,15920,sob,sab,18,16,2,13,5
sober,15921,sober,sobX,3,3,0,2,1
soccer,15924,soccer,sakX,6,5,1,3,3
sock,15934,sock,sak,26,22,4,19,7
socket,15935,socket,sak|t,6,6,0,6,0
sod,15936,sod,sad,20,17,3,13,7
soda,15937,soda,sodx,2,2,0,1,1
sodden,15938,sodden,sadN,4,3,1,2,2
soever,15940,soever,soEvX,1,0,1,1,0
sofa,15941,sofa,sofx,1,1,0,0,1
soft,15942,soft,scft,5,3,2,3,2
soggy,15945,soggy,sagi,3,3,0,0,3
soil,15946,soil,sOl,13,10,3,12,1
sojourn,15948,sojourn,soJRn,1,1,0,1,0
sol,15949,sol,sol,29,23,6,20,9
solar,15951,solar,solX,13,11,2,7,6
sold,15953,sold,sold,15,12,3,10,5
solder,15954,solder,sadX,7,6,1,4,3
soldier,15955,soldier,solJX,1,0,1,0,1
solely,15957,solely,soli,11,10,1,7,4
solicit,15964,solicit,sxlIs|t,1,0,1,1,0
solo,15972,solo,solo,9,7,2,5,4
solve,15978,solve,sclv,1,1,0,0,1
some,15983,some,s^m,23,19,4,16,7
son,15988,son,s^n,26,24,2,20,6
song,15991,song,scG,11,10,1,8,3
sonic,15992,sonic,sanIk,5,5,0,5,0
sonnet,15993,sonnet,san|t,3,3,0,3,0
soon,15996,soon,sun,24,21,3,18,6
soot,15997,soot,sUt,11,11,0,11,0
sooth,15998,sooth,suT,11,9,2,5,6
soothe,15999,soothe,suD,9,7,2,3,6
sop,16001,sop,sap,23,20,3,18,5
sorrel,16012,sorrel,scrL,4,3,1,4,0
sorrow,16013,sorrow,saro,3,3,0,2,1
sorry,16014,sorry,sari,4,4,0,1,3
sort,16015,sort,sort,14,8,6,10,4
sortie,16016,sortie,sorti,2,1,1,1,1
sot,16017,sot,sat,32,28,4,27,5
sough,16020,sough,sW,21,17,4,10,11
sought,16021,sought,sct,24,19,5,18,6
sound,16023,sound,sWnd,10,9,1,10,0
soup,16024,soup,sup,22,16,6,16,6
sour,16025,sour,sWr,10,7,3,7,3
source,16026,source,sors,8,7,1,5,3
souse,16027,souse,sWs,8,7,1,5,3
south,16028,south,sWT,5,4,1,2,3
soy,16037,soy,sO,13,12,1,4,9
spa,16038,spa,spa,6,3,3,1,5
space,16039,space,spes,6,4,2,2,4
spade,16042,spade,sped,9,7,2,3,6
span,16044,span,sp@n,9,8,1,2,7
spank,16049,spank,sp@Gk,4,3,1,4,0
spar,16050,spar,spar,12,8,4,3,9
spare,16051,spare,spEr,13,12,1,5,8
sparing,16052,sparing,sp@rIG,2,0,2,2,0
spark,16053,spark,spark,5,2,3,2,3
sparkle,16054,sparkle,sparkL,1,0,1,0,1
sparse,16056,sparse,spars,3,1,2,1,2
spat,16060,spat,sp@t,12,8,4,3,9
spate,16061,spate,spet,15,12,3,6,9
spatter,16063,spatter,sp@tX,5,2,3,4,1
spawn,16066,spawn,spcn,8,7,1,2,6
spay,16067,spay,spe,14,7,7,5,9
speak,16068,speak,spik,11,9,2,5,6
spear,16069,spear,spIr,15,13,2,7,8
speck,16080,speck,spEk,8,7,1,1,7
spectre,16084,spectre,spEktX,1,0,1,1,0
sped,16091,sped,spEd,11,8,3,3,8
speech,16092,speech,spiC,3,2,1,1,2
speed,16093,speed,spid,8,7,1,3,5
spell,16096,spell,spEl,9,8,1,3,6
spend,16098,spend,spEnd,5,3,2,3,2
spent,16100,spent,spEnt,3,1,2,2,1
sperm,16101,sperm,spRm,4,3,1,0,4
spew,16103,spew,spyu,3,1,2,2,1
sphere,16104,sphere,sfIr,6,4,2,6,0
spice,16110,spice,spYs,9,6,3,2,7
spider,16112,spider,spYdX,1,0,1,1,0
spike,16114,spike,spYk,10,8,2,1,9
spill,16115,spill,spIl,13,9,4,5,8
spilled,16116,spilled,spIld,3,2,1,1,2
spilt,16118,spilt,spIlt,6,3,3,3,3
spin,16119,spin,spIn,12,10,2,3,9
spinal,16121,spinal,spYnL,2,1,1,0,2
spine,16124,spine,spYn,18,13,5,6,12
spiral,16127,spiral,spYrL,2,1,1,0,2
spire,16128,spire,spYr,14,9,5,3,11
spit,16137,spit,spIt,16,11,5,4,12
spite,16138,spite,spYt,15,12,3,3,12
spittle,16139,spittle,spItL,1,0,1,0,1
splash,16141,splash,spl@S,2,0,2,2,0
splatter,16142,splatter,spl@tX,3,1,2,2,1
splay,16143,splay,sple,4,1,3,2,2
splice,16149,splice,splYs,2,0,2,1,1
splint,16150,splint,splInt,3,1,2,1,2
splinter,16151,splinter,splIntX,1,0,1,0,1
split,16152,split,splIt,3,0,3,1,2
splurge,16154,splurge,splRJ,1,0,1,1,0
splutter,16155,splutter,spl^tX,2,1,1,1,1
spoil,16156,spoil,spOl,6,3,3,1,5
spoiled,16157,spoiled,spOld,3,2,1,1,2
spoilt,16158,spoilt,spOlt,3,2,1,1,2
spoke,16159,spoke,spok,9,7,2,4,5
sponge,16163,sponge,sp^nJ,1,0,1,0,1
spoof,16168,spoof,spuf,3,3,0,0,3
spook,16169,spook,spuk,7,7,0,0,7
spool,16170,spool,spul,9,8,1,3,6
spoon,16171,spoon,spun,11,10,1,2,9
spoor,16172,spoor,spUr,5,5,0,0,5
spore,16174,spore,spor,13,10,3,6,7
sport,16175,sport,sport,7,3,4,6,1
spot,16177,spot,spat,13,10,3,5,8
spout,16179,spout,spWt,11,9,2,4,7
sprain,16180,sprain,spren,2,1,1,1,1
sprang,16181,sprang,spr@G,3,3,0,0,3
sprat,16182,sprat,spr@t,4,3,1,0,4
sprawl,16183,sprawl,sprcl,1,1,0,1,0
spray,16184,spray,spre,7,4,3,2,5
spread,16185,spread,sprEd,1,0,1,0,1
spree,16186,spree,spri,5,3,2,3,2
sprig,16187,sprig,sprIg,2,1,1,1,1
spring,16189,spring,sprIG,5,4,1,2,3
sprint,16192,sprint,sprInt,2,1,1,2,0
sprite,16193,sprite,sprYt,5,3,2,1,4
sprout,16195,sprout,sprWt,3,2,1,0,3
sprung,16197,sprung,spr^G,3,3,0,1,2
spry,16198,spry,sprY,5,2,3,1,4
spud,16199,spud,sp^d,6,6,0,2,4
spume,16200,spume,spyum,1,0,1,0,1
spun,16201,spun,sp^n,11,8,3,3,8
spunk,16202,spunk,sp^Gk,6,4,2,6,0
spur,16203,spur,spR,11,5,6,3,8
spurge,16204,spurge,spRJ,8,4,4,4,4
spurn,16206,spurn,spRn,12,11,1,2,10
spurt,16207,spurt,spRt,12,10,2,2,10
sputter,16208,sputter,sp^tX,4,2,2,4,0
spy,16210,spy,spY,15,6,9,5,10
squab,16211,squab,skwab,6,4,2,1,5
squabble,16212,squabble,skwabL,1,0,1,0,1
squad,16213,squad,skwad,5,4,1,1,4
squall,16216,squall,skwcl,4,3,1,1,3
squalor,16217,squalor,skwalX,1,0,1,1,0
square,16219,square,skwEr,3,1,2,1,2
squash,16220,squash,skwaS,5,3,2,2,3
squat,16221,squat,skwat,6,4,2,1,5
squaw,16222,squaw,skwc,2,0,2,0,2
squawk,16223,squawk,skwck,3,2,1,0,3
squeak,16224,squeak,skwik,3,3,0,0,3
squeal,16225,squeal,skwil,3,3,0,0,3
squeeze,16228,squeeze,skwiz,2,2,0,0,2
squib,16230,squib,skwIb,2,2,0,0,2
squid,16231,squid,skwId,4,2,2,1,3
squire,16233,squire,skwYr,4,2,2,3,1
squirm,16234,squirm,skwRm,2,2,0,0,2
squirrel,16235,squirrel,skwRL,2,2,0,0,2
squirt,16236,squirt,skwRt,5,3,2,1,4
stab,16237,stab,st@b,7,6,1,3,4
stable,16243,stable,stebL,4,2,2,3,1
stack,16245,stack,st@k,16,13,3,6,10
staff,16247,staff,st@f,5,5,0,0,5
stag,16248,stag,st@g,9,6,3,5,4
stage,16249,stage,steJ,11,8,3,2,9
stagger,16250,stagger,st@gX,4,3,1,1,3
stagy,16255,stagy,steJi,2,1,1,1,1
staid,16256,staid,sted,13,12,1,2,11
stain,16257,stain,sten,17,14,3,5,12
stair,16258,stair,stEr,12,10,2,5,7
stake,16259,stake,stek,17,14,3,4,13
stale,16261,stale,stel,17,14,3,4,13
stalk,16262,stalk,stck,9,7,2,1,8
stalked,16263,stalked,stckt,1,0,1,0,1
stall,16264,stall,stcl,10,9,1,3,7
stammer,16270,stammer,st@mX,3,3,0,0,3
stamp,16271,stamp,st@mp,4,3,1,3,1
stance,16273,stance,st@ns,1,1,0,0,1
stand,16276,stand,st@nd,3,1,2,2,1
stank,16282,stank,st@Gk,7,4,3,6,1
staple,16285,staple,stepL,3,3,0,2,1
star,16286,star,star,12,7,5,3,9
starch,16288,starch,starC,4,3,1,0,4
stark,16290,stark,stark,7,5,2,2,5
start,16292,start,start,7,4,3,2,5
startle,16293,startle,startL,1,0,1,0,1
starve,16295,starve,starv,4,3,1,0,4
state,16297,state,stet,16,12,4,6,10
statue,16307,statue,st@Cu,2,1,1,0,2
stature,16310,stature,st@CX,3,3,0,0,3
statute,16312,statute,st@Cut,1,0,1,0,1
stave,16314,stave,stev,10,8,2,2,8
stay,16316,stay,ste,17,7,10,4,13
stead,16317,stead,stEd,11,9,2,3,8
steady,16318,steady,stEdi,3,2,1,2,1
steal,16319,steal,stil,11,9,2,2,9
stealth,16320,stealth,stElT,1,1,0,0,1
steam,16321,steam,stim,8,5,3,3,5
steed,16322,steed,stid,10,9,1,3,7
steep,16324,steep,stip,10,8,2,3,7
steeple,16325,steeple,stipL,4,2,2,3,1
steer,16326,steer,stIr,15,12,3,7,8
stein,16329,stein,stYn,10,7,3,4,6
stellar,16330,stellar,stElX,2,1,1,1,1
stem,16331,stem,stEm,4,4,0,0,4
stencil,16333,stencil,stEnsL,1,0,1,1,0
step,16337,step,stEp,6,6,0,0,6
sterile,16346,sterile,stErL,1,0,1,0,1
stern,16352,stern,stRn,10,5,5,4,6
sternal,16353,sternal,stRnL,2,1,1,1,1
stew,16357,stew,stu,13,5,8,5,8
stick,16359,stick,stIk,18,13,5,4,14
sticky,16361,sticky,stIki,2,1,1,1,1
stiff,16362,stiff,stIf,10,9,1,3,7
stile,16368,stile,stYl,10,8,2,2,8
still,16370,still,stIl,17,14,3,5,12
stilt,16372,stilt,stIlt,7,3,4,4,3
stilton,16374,Stilton,stIltN,1,0,1,0,1
sting,16379,sting,stIG,14,10,4,6,8
stink,16381,stink,stIGk,6,3,3,4,2
stint,16382,stint,stInt,3,2,1,2,1
stipple,16384,stipple,stIpL,3,2,1,3,0
stir,16387,stir,stR,9,6,3,3,6
stitch,16389,stitch,stIC,7,7,0,2,5
stoat,16390,stoat,stot,10,8,2,2,8
stock,16391,stock,stak,12,9,3,2,10
stocky,16398,stocky,staki,4,2,2,2,2
stodgy,16400,stodgy,staJi,2,2,0,1,1
stoic,16401,stoic,stoIk,4,1,3,0,4
stoical,16402,stoical,stoIkL,1,0,1,0,1
stoke,16404,stoke,stok,19,13,6,4,15
stole,16405,stole,stol,15,11,4,2,13
stone,16412,stone,ston,14,11,3,4,10
stood,16413,stood,stUd,4,4,0,0,4
stooge,16414,stooge,stuJ,4,3,1,0,4
stool,16415,stool,stul,12,10,2,3,9
stoop,16416,stoop,stup,12,9,3,5,7
stop,16417,stop,stap,11,8,3,5,6
store,16420,store,stor,18,12,6,6,12
storied,16422,storied,storid,1,0,1,0,1
stork,16423,stork,stork,7,4,3,2,5
storm,16424,storm,storm,4,3,1,1,3
story,16425,story,stori,5,2,3,1,4
stout,16427,stout,stWt,6,5,1,4,2
stove,16428,stove,stov,8,6,2,0,8
stow,16429,stow,sto,14,6,8,3,11
strafe,16431,strafe,stref,4,3,1,0,4
straight,16433,straight,stret,8,4,4,1,7
straighten,16434,straighten,stretN,1,0,1,0,1
strain,16437,strain,stren,9,4,5,3,6
strand,16438,strand,str@nd,1,0,1,1,0
strange,16439,strange,strenJ,3,0,3,1,2
stranger,16440,stranger,strenJX,1,0,1,0,1
strap,16444,strap,str@p,6,4,2,3,3
straw,16455,straw,strc,3,2,1,0,3
stray,16456,stray,stre,10,4,6,4,6
streak,16457,streak,strik,6,6,0,0,6
stream,16458,stream,strim,6,5,1,1,5
street,16460,street,strit,6,5,1,1,5
stress,16465,stress,strEs,2,1,1,1,1
stretch,16466,stretch,strEC,1,1,0,0,1
strew,16467,strew,stru,6,3,3,2,4
strewn,16468,strewn,strun,2,1,1,0,2
stria,16469,stria,strix,3,3,0,0,3
stride,16475,stride,strYd,7,5,2,2,5
strife,16478,strife,strYf,5,5,0,0,5
strike,16479,strike,strYk,7,7,0,0,7
string,16480,string,strIG,7,4,3,1,6
stringer,16482,stringer,strIGX,2,1,1,0,2
stringy,16483,stringy,strIGi,2,1,1,0,2
strip,16484,strip,strIp,6,5,1,2,4
stripe,16485,stripe,strYp,8,7,1,1,7
strive,16487,strive,strYv,5,5,0,0,5
strode,16492,strode,strod,4,4,0,0,4
stroke,16493,stroke,strok,7,6,1,0,7
stroll,16494,stroll,strol,6,4,2,2,4
strong,16495,strong,strcG,3,2,1,0,3
strop,16500,strop,strap,4,3,1,0,4
strove,16503,strove,strov,5,4,1,0,5
struck,16504,struck,str^k,8,6,2,2,6
strum,16507,strum,str^m,4,4,0,0,4
strung,16509,strung,str^G,7,6,1,2,5
strut,16510,strut,str^t,5,5,0,0,5
stub,16512,stub,st^b,11,7,4,3,8
stubble,16513,stubble,st^bL,4,2,2,1,3
stubby,16515,stubby,st^bi,4,3,1,0,4
stucco,16516,stucco,st^ko,1,0,1,0,1
stuck,16517,stuck,st^k,16,11,5,3,13
stud,16518,stud,st^d,12,11,1,2,10
studied,16520,studied,st^did,1,0,1,0,1
study,16523,study,st^di,6,4,2,2,4
stuff,16524,stuff,st^f,10,8,2,2,8
stuffy,16525,stuffy,st^fi,3,2,1,0,3
stumble,16528,stumble,st^mbL,2,0,2,1,1
stump,16529,stump,st^mp,2,2,0,2,0
stun,16530,stun,st^n,13,10,3,3,10
stung,16531,stung,st^G,12,8,4,5,7
stunk,16532,stunk,st^Gk,8,5,3,6,2
stunt,16533,stunt,st^nt,2,1,1,1,1
stupor,16540,stupor,stupX,1,0,1,0,1
sturdy,16541,sturdy,stRdi,2,2,0,2,0
sturgeon,16542,sturgeon,stRJ|n,1,0,1,1,0
stutter,16543,stutter,st^tX,1,1,0,1,0
sty,16544,sty,stY,11,7,4,4,7
suave,16550,suave,swav,9,9,0,1,8
sub,16552,sub,s^b,17,15,2,11,6
subtile,16605,subtile,s^tL,5,4,1,3,2
subtly,16607,subtly,s^tli,1,0,1,1,0
succor,16619,succor,s^kX,8,7,1,3,5
succumb,16622,succumb,sxk^m,2,1,1,2,0
such,16623,such,s^C,12,11,1,6,6
suck,16625,suck,s^k,25,20,5,15,10
suckle,16626,suckle,s^kL,10,9,1,6,4
sudden,16631,sudden,s^dN,3,3,0,2,1
suds,16632,suds,s^dz,1,1,0,0,1
sue,16633,sue,su,34,26,8,20,14
suede,16634,suede,swed,7,5,2,3,4
suet,16635,suet,su|t,1,0,1,0,1
suffer,16636,suffer,s^fX,7,6,1,3,4
suit,16652,suit,sut,27,24,3,19,8
suite,16657,suite,swit,9,7,2,4,5
suiting,16658,suiting,sutIG,1,0,1,1,0
suitor,16659,suitor,sutX,7,5,2,4,3
sulfa,16660,sulfa,s^lfx,1,1,0,0,1
sulk,16663,sulk,s^lk,7,5,2,4,3
sullen,16664,sullen,s^lxn,2,2,0,2,0
sully,16665,sully,s^li,8,7,1,7,1
sulphur,16667,sulphur,s^lfX,2,1,1,0,2
sumach,16673,sumach,sum@k,1,0,1,1,0
summary,16676,summary,s^mXi,1,0,1,0,1
summer,16678,summer,s^mX,7,5,2,2,5
summit,16679,summit,s^mxt,1,1,0,0,1
summon,16680,summon,s^mxn,7,6,1,5,2
summons,16681,summons,s^mxnz,1,0,1,0,1
sundae,16683,sundae,s^nde,2,2,0,1,1
sunder,16684,sunder,s^ndX,6,4,2,5,1
sung,16688,sung,s^G,20,16,4,13,7
sunk,16689,sunk,s^Gk,17,11,6,14,3
sup,16693,sup,s^p,17,14,3,9,8
supine,16718,supine,sUpYn,1,0,1,1,0
supper,16719,supper,s^pX,7,4,3,2,5
supple,16721,supple,s^pL,6,5,1,2,4
supply,16728,supply,sxplY,1,0,1,1,0
support,16729,support,sxport,2,0,2,2,0
suppose,16730,suppose,sxpoz,2,0,2,1,1
supposed,16731,supposed,sxpozd,1,0,1,0,1
suppress,16734,suppress,sxprEs,1,0,1,1,0
sure,16742,sure,SUr,9,8,1,7,2
surgeon,16747,surgeon,sRJ|n,3,2,1,3,0
surgery,16748,surgery,sRJXi,1,1,0,1,0
surly,16750,surly,sRli,7,5,2,6,1
surrey,16760,surrey,sRi,13,9,4,6,7
surround,16762,surround,sXWnd,1,0,1,1,0
surtout,16764,surtout,sRtu,3,2,1,2,1
survey,16766,survey,sRve,3,2,1,1,2
suture,16776,suture,suCX,2,1,1,0,2
svelte,16778,svelte,svElt,2,1,1,2,0
swab,16779,swab,swab,10,8,2,3,7
swaddle,16780,swaddle,swadL,2,1,1,2,0
swag,16781,swag,sw@g,8,5,3,5,3
swage,16782,swage,sweJ,7,3,4,4,3
swagger,16783,swagger,sw@gX,2,1,1,1,1
swain,16785,swain,swen,12,9,3,6,6
swallow,16786,swallow,swalo,1,0,1,1,0
swam,16787,swam,sw@m,4,4,0,1,3
swamp,16788,swamp,swamp,1,0,1,0,1
swan,16789,swan,swan,11,10,1,1,10
swank,16790,swank,sw@Gk,3,2,1,3,0
swap,16792,swap,swap,14,12,2,3,11
sward,16793,sward,sword,7,4,3,3,4
swarm,16794,swarm,sworm,6,4,2,2,4
swart,16795,swart,swort,10,7,3,6,4
swash,16797,swash,swaS,10,9,1,2,8
swat,16799,swat,swat,16,13,3,7,9
swath,16800,swath,swaT,7,7,0,0,7
swathe,16801,swathe,swaD,7,7,0,0,7
sway,16802,sway,swe,9,4,5,5,4
swear,16803,swear,swEr,11,9,2,8,3
sweat,16804,sweat,swEt,9,5,4,3,6
sweater,16805,sweater,swEtX,3,0,3,1,2
swede,16806,swede,swid,8,6,2,5,3
sweep,16808,sweep,swip,9,7,2,4,5
sweeten,16811,sweeten,switN,1,0,1,0,1
swell,16813,swell,swEl,10,8,2,6,4
swelter,16814,swelter,swEltX,2,0,2,1,1
swept,16815,swept,swEpt,3,1,2,2,1
swerve,16817,swerve,swRv,3,2,1,1,2
swift,16818,swift,swIft,1,0,1,1,0
swig,16819,swig,swIg,10,9,1,3,7
swill,16820,swill,swIl,15,13,2,7,8
swim,16821,swim,swIm,11,11,0,3,8
swine,16823,swine,swYn,10,8,2,6,4
swing,16824,swing,swIG,12,10,2,5,7
swipe,16825,swipe,swYp,6,5,1,2,4
swirl,16826,swirl,swRl,5,5,0,2,3
swish,16827,swish,swIS,9,8,1,2,7
swiss,16828,Swiss,swIs,6,6,0,0,6
switch,16829,switch,swIC,11,10,1,5,6
swivel,16830,swivel,swIvL,2,1,1,2,0
swoon,16832,swoon,swun,6,5,1,2,4
swoop,16833,swoop,swup,10,9,1,6,4
sword,16834,sword,sord,13,11,2,9,4
swore,16836,swore,swor,11,5,6,6,5
sworn,16837,sworn,sworn,6,4,2,2,4
swum,16838,swum,sw^m,6,5,1,3,3
swung,16839,swung,sw^G,5,4,1,3,2
sylph,16851,sylph,sIlf,5,4,1,1,4
syringe,16889,syringe,sXInJ,1,0,1,1,0
t,16898,t,ti,33,23,10,19,14
tab,16899,tab,t@b,17,15,2,9,8
tabby,16900,tabby,t@bi,10,8,2,5,5
table,16902,table,tebL,9,7,2,8,1
tableau,16903,tableau,t@blo,1,0,1,1,0
tabour,16911,tabour,tebX,7,7,0,4,3
tacit,16917,tacit,t@s|t,1,1,0,1,0
tack,16920,tack,t@k,37,27,10,23,14
tackle,16921,tackle,t@kL,12,10,2,5,7
tacky,16922,tacky,t@ki,13,11,2,4,9
tact,16923,tact,t@kt,10,5,5,4,6
tactile,16926,tactile,t@ktL,4,1,3,2,2
taffy,16930,taffy,t@fi,5,5,0,1,4
tag,16931,tag,t@g,21,20,1,14,7
tail,16932,tail,tel,30,26,4,26,4
tailor,16934,tailor,telX,6,5,1,3,3
taint,16935,taint,tent,8,7,1,7,1
take,16936,take,tek,25,23,2,22,3
talc,16938,talc,t@lk,5,4,1,0,5
talent,16939,talent,t@l|nt,2,1,1,1,1
talk,16942,talk,tck,23,20,3,18,5
tall,16944,tall,tcl,27,22,5,22,5
tallow,16945,tallow,t@lo,10,8,2,8,2
tally,16946,tally,t@li,13,12,1,7,6
talon,16951,talon,t@l|n,3,2,1,2,1
tam,16952,tam,t@m,24,21,3,16,8
tame,16956,tame,tem,19,18,1,16,3
tamp,16957,tamp,t@mp,11,6,5,8,3
tamper,16958,tamper,t@mpX,5,4,1,3,2
tan,16959,tan,t@n,25,23,2,17,8
tang,16962,tang,t@G,18,16,2,10,8
tangle,16968,tangle,t@GgL,9,8,1,8,1
tango,16969,tango,t@Ggo,2,2,0,1,1
tank,16970,tank,t@Gk,16,11,5,11,5
tankard,16971,tankard,t@GkXd,1,0,1,0,1
tanker,16972,tanker,t@GkX,7,4,3,5,2
tanner,16973,tanner,t@nX,6,5,1,4,2
tannin,16974,tannin,t@n|n,3,3,0,3,0
tap,16980,tap,t@p,26,23,3,17,9
tape,16981,tape,tep,16,14,2,12,4
taper,16982,taper,tepX,7,6,1,4,3
taps,16987,taps,t@ps,7,4,3,5,2
tar,16989,tar,tar,20,16,4,15,5
tardy,16991,tardy,tardi,2,1,1,2,0
tare,16992,tare,tEr,23,20,3,20,3
tarn,16995,tarn,tarn,6,5,1,4,2
tarry,16999,tarry,t@ri,14,12,2,10,4
tart,17000,tart,tart,14,8,6,9,5
tartan,17001,tartan,tartN,5,4,1,3,2
tartar,17002,tartar,tartX,6,5,1,4,2
task,17004,task,t@sk,9,7,2,5,4
tassel,17005,tassel,t@sL,9,9,0,6,3
taste,17006,taste,test,9,8,1,7,2
tasty,17007,tasty,testi,2,1,1,1,1
tat,17008,tat,t@t,31,26,5,20,11
tatter,17009,tatter,t@tX,15,13,2,11,4
tatting,17011,tatting,t@tIG,2,2,0,2,0
tattle,17012,tattle,t@tL,14,12,2,9,5
tattoo,17013,tattoo,t@tu,3,2,1,0,3
taught,17014,taught,tct,22,19,3,16,6
taunt,17015,taunt,tcnt,12,11,1,10,2
taupe,17016,taupe,top,23,19,4,14,9
taurus,17017,Taurus,tcr|s,2,1,1,1,1
taw,17019,taw,tc,22,16,6,11,11
tawny,17021,tawny,tcni,5,5,0,4,1
tax,17022,tax,t@ks,9,6,3,3,6
taxi,17024,taxi,t@ksi,2,0,2,0,2
tb,17030,TB,tibi,4,4,0,1,3
teach,17031,teach,tiC,13,11,2,6,7
teak,17032,teak,tik,28,25,3,21,7
teal,17033,teal,til,30,27,3,23,7
team,17034,team,tim,19,17,2,12,7
tease,17037,tease,tiz,16,12,4,7,9
teasel,17038,teasel,tizL,4,2,2,3,1
teat,17040,teat,tIt,31,25,6,21,10
teens,17053,teens,tinz,3,2,1,1,2
teeny,17054,teeny,tini,11,11,0,7,4
teeter,17055,teeter,titX,6,6,0,6,0
teeth,17056,teeth,tiT,12,11,1,5,7
teethe,17057,teethe,tiD,11,10,1,4,7
tell,17079,tell,tEl,21,20,1,19,2
temper,17084,temper,tEmpX,5,4,1,1,4
temple,17092,temple,tEmpL,4,3,1,0,4
tempo,17094,tempo,tEmpo,3,3,0,0,3
temporal,17095,temporal,tEmpXL,2,0,2,0,2
tempt,17099,tempt,tEmpt,4,3,1,1,3
ten,17102,ten,tEn,27,22,5,21,6
tenant,17108,tenant,tEn|nt,3,1,2,1,2
tend,17109,tend,tEnd,16,11,5,11,5
tender,17111,tender,tEndX,7,5,2,4,3
tendon,17116,tendon,tEnd|n,2,1,1,0,2
tenet,17119,tenet,tEn|t,6,4,2,2,4
tennis,17121,tennis,tEn|s,4,3,1,1,3
tenon,17122,tenon,tEn|n,7,4,3,2,5
tenor,17123,tenor,tEnX,9,6,3,1,8
tense,17126,tense,tEns,12,9,3,6,6
tensile,17127,tensile,tEnsL,5,3,2,4,1
tension,17128,tension,tEnC|n,6,4,2,4,2
tent,17130,tent,tEnt,19,17,2,13,6
tenure,17137,tenure,tEnyX,2,1,1,0,2
tepee,17138,tepee,tipi,3,3,0,0,3
term,17144,term,tRm,13,13,0,9,4
tern,17152,tern,tRn,19,17,2,15,4
terrain,17154,terrain,tXen,4,4,0,3,1
terrier,17158,terrier,tEriX,1,0,1,0,1
terror,17163,terror,tErX,5,2,3,1,4
terse,17164,terse,tRs,11,11,0,7,4
test,17167,test,tEst,18,14,4,14,4
tester,17172,tester,tEstX,5,3,2,3,2
testes,17173,testes,tEstiz,1,0,1,0,1
testy,17179,testy,tEsti,5,3,2,2,3
tether,17182,tether,tEDX,7,7,0,5,2
text,17185,text,tEkst,2,1,1,1,1
thai,17190,Thai,tY,34,22,12,18,16
than,17192,than,D@n,12,11,1,11,1
thane,17193,thane,Ten,14,14,0,14,0
thank,17194,thank,T@Gk,11,10,1,11,0
that,17196,that,D@t,14,13,1,13,1
thatch,17197,thatch,T@C,6,6,0,6,0
thaw,17198,thaw,Tc,15,12,3,11,4
the,17199,the,Dx,7,6,1,2,5
thee,17202,thee,Di,24,22,2,18,6
theft,17203,theft,TEft,4,4,0,4,0
their,17204,their,DEr,17,15,2,14,3
theirs,17205,theirs,DErz,1,0,1,0,1
theistic,17207,theistic,TiIstIk,2,1,1,2,0
them,17208,them,DEm,5,4,1,3,2
theme,17209,theme,Tim,8,8,0,6,2
then,17211,then,DEn,17,16,1,15,2
thence,17212,thence,TEns,6,6,0,6,0
theorem,17218,theorem,TIrM,2,2,0,1,1
theory,17221,theory,TIri,7,5,2,6,1
thermal,17235,thermal,TRmL,1,1,0,1,0
these,17245,these,Diz,9,7,2,8,1
thew,17248,thew,Tu,21,20,1,18,3
they,17249,they,De,20,20,0,15,5
thick,17251,thick,TIk,13,12,1,10,3
thicken,17252,thicken,TIk|n,2,2,0,1,1
thicket,17253,thicket,TIk|t,4,4,0,3,1
thief,17255,thief,Tif,8,8,0,6,2
thieve,17256,thieve,Tiv,9,7,2,6,3
thieves,17258,thieves,Tivz,5,3,2,4,1
thigh,17259,thigh,TY,19,18,1,17,2
thimble,17260,thimble,TImbL,2,2,0,2,0
thin,17261,thin,TIn,16,14,2,13,3
thine,17262,thine,DYn,15,14,1,14,1
thing,17263,thing,TIG,11,10,1,8,3
think,17264,think,TIGk,13,10,3,11,2
thinner,17265,thinner,TInX,4,2,2,2,2
third,17266,third,TRd,7,7,0,6,1
thirst,17267,thirst,TRst,6,4,2,6,0
this,17270,this,DIs,4,4,0,4,0
thistle,17271,thistle,TIsL,1,1,0,1,0
thither,17272,thither,TIDX,5,5,0,4,1
thole,17273,thole,Tol,14,14,0,14,0
thong,17274,thong,TcG,9,7,2,7,2
thorn,17279,thorn,Torn,9,9,0,8,1
thorough,17280,thorough,TRo,4,4,0,3,1
thorp,17283,thorp,Torp,2,2,0,1,1
those,17284,those,Doz,9,8,1,8,1
thou,17285,thou,DW,14,14,0,9,5
though,17286,though,Do,20,18,2,14,6
thought,17287,thought,Tct,11,9,2,9,2
thrall,17289,thrall,Trcl,6,6,0,4,2
thrash,17290,thrash,Tr@S,5,4,1,4,1
thread,17291,thread,TrEd,6,5,1,5,1
threat,17292,threat,TrEt,3,3,0,1,2
three,17293,three,Tri,9,8,1,7,2
threw,17299,threw,Tru,10,8,2,7,3
thrice,17300,thrice,TrYs,4,3,1,3,1
thrift,17301,thrift,TrIft,3,2,1,3,0
thrill,17302,thrill,TrIl,7,6,1,6,1
thrive,17303,thrive,TrYv,5,4,1,3,2
thriven,17304,thriven,TrIvxn,3,2,1,3,0
thriving,17305,thriving,TrYvIG,3,2,1,3,0
throat,17306,throat,Trot,6,4,2,2,4
throb,17307,throb,Trab,1,0,1,1,0
throe,17308,throe,Tro,14,10,4,9,5
throne,17310,throne,Tron,8,6,2,5,3
throng,17311,throng,TrcG,4,2,2,3,1
throve,17315,throve,Trov,8,6,2,4,4
thrum,17316,thrum,Tr^m,6,4,2,5,1
thrush,17317,thrush,Tr^S,5,4,1,3,2
thrust,17318,thrust,Tr^st,3,2,1,3,0
thud,17319,thud,T^d,7,7,0,5,2
thug,17320,thug,T^g,12,12,0,10,2
thumb,17322,thumb,T^m,15,13,2,12,3
thump,17323,thump,T^mp,9,8,1,8,1
thunder,17324,thunder,T^ndX,3,2,1,3,0
thus,17328,thus,D^s,6,5,1,6,0
thwack,17329,thwack,Tw@k,2,2,0,2,0
thwart,17330,thwart,Twort,4,2,2,4,0
thy,17331,thy,DY,23,21,2,17,6
thyme,17332,thyme,tYm,21,19,2,11,10
tic,17339,tic,tIk,30,26,4,23,7
ticket,17340,ticket,tIk|t,4,3,1,4,0
tickle,17342,tickle,tIkL,10,7,3,6,4
tidal,17343,tidal,tYdL,6,4,2,3,3
tide,17345,tide,tYd,22,17,5,10,12
tidy,17347,tidy,tYdi,6,5,1,3,3
tier,17348,tier,tIr,29,27,2,23,6
tiff,17349,tiff,tIf,11,9,2,5,6
tight,17353,tight,tYt,30,25,5,18,12
tights,17355,tights,tYts,4,3,1,1,3
tile,17357,tile,tYl,29,26,3,20,9
till,17358,till,tIl,35,28,7,26,9
tiller,17360,tiller,tIlX,7,6,1,3,4
tilt,17361,tilt,tIlt,15,11,4,10,5
tilth,17362,tilth,tIlT,4,3,1,1,3
timber,17363,timber,tImbX,2,2,0,2,0
timbre,17365,timbre,t@mbX,4,3,1,3,1
timbrel,17366,timbrel,tImbrL,1,1,0,1,0
times,17368,times,tYmz,1,0,1,0,1
tin,17376,tin,tIn,30,25,5,21,9
tinct,17377,tinct,tIGkt,2,2,0,0,2
tincture,17378,tincture,tIGkCX,1,0,1,0,1
tinder,17379,tinder,tIndX,3,3,0,3,0
tine,17380,tine,tYn,33,28,5,23,10
tinge,17382,tinge,tInJ,7,5,2,4,3
tingle,17383,tingle,tIGgL,8,7,1,7,1
tinker,17384,tinker,tIGkX,4,3,1,1,3
tinkle,17385,tinkle,tIGkL,7,5,2,3,4
tinny,17386,tinny,tIni,11,10,1,8,3
tinsel,17388,tinsel,tInsL,2,2,0,2,0
tint,17390,tint,tInt,14,11,3,9,5
tiny,17393,tiny,tYni,7,6,1,5,2
tip,17394,tip,tIp,25,23,2,18,7
tipple,17396,tipple,tIpL,8,5,3,5,3
tirade,17400,tirade,tYred,2,0,2,1,1
tire,17401,tire,tYr,26,22,4,16,10
tired,17402,tired,tYrd,3,0,3,0,3
tissue,17404,tissue,tISu,2,1,1,2,0
titan,17405,titan,tYtN,5,4,1,2,3
tithe,17409,tithe,tYD,13,12,1,4,9
title,17412,title,tYtL,10,8,2,5,5
titled,17413,titled,tYtLd,1,0,1,0,1
titter,17415,titter,tItX,9,7,2,6,3
tittle,17417,tittle,tItL,10,9,1,6,4
to,17420,to,tu,31,22,9,18,13
toad,17421,toad,tod,20,16,4,10,10
toady,17422,toady,todi,4,3,1,2,2
toast,17423,toast,tost,11,10,1,9,2
toddle,17429,toddle,tadL,8,7,1,6,2
toddy,17430,toddy,tadi,9,8,1,7,2
toe,17431,toe,to,31,19,12,16,15
toffy,17433,toffy,tafi,2,2,0,1,1
tog,17434,tog,tag,8,7,1,4,4
toga,17435,toga,togx,2,2,0,1,1
togs,17438,togs,tagz,2,1,1,0,2
toil,17439,toil,tOl,15,13,2,14,1
told,17445,told,told,11,8,3,9,2
toll,17450,toll,tol,33,29,4,24,9
tomb,17453,tomb,tum,22,19,3,13,9
tome,17457,tome,tom,22,20,2,14,8
ton,17461,ton,t^n,28,25,3,20,8
tonal,17462,tonal,tonL,5,3,2,3,2
tone,17464,tone,ton,33,27,6,23,10
tong,17465,tong,tcG,12,11,1,7,5
tongs,17466,tongs,taGz,1,1,0,0,1
tongue,17467,tongue,t^G,16,15,1,10,6
tonic,17468,tonic,tanIk,5,5,0,5,0
tonsil,17472,tonsil,tansL,3,3,0,3,0
too,17476,too,tu,31,22,9,18,13
took,17477,took,tUk,18,18,0,17,1
tool,17478,tool,tul,23,20,3,15,8
toot,17479,toot,tut,27,23,4,17,10
tooth,17480,tooth,tuT,14,10,4,5,9
toothed,17482,toothed,tuTt,2,0,2,0,2
top,17484,top,tap,21,17,4,16,5
toper,17487,toper,topX,3,1,2,1,2
topic,17488,topic,tapIk,3,2,1,2,1
topping,17492,topping,tapIG,1,1,0,0,1
topple,17493,topple,tapL,4,3,1,1,3
tops,17494,tops,taps,5,4,1,3,2
toque,17496,toque,tok,29,25,4,20,9
tor,17497,tor,tor,36,27,9,22,14
torah,17498,Torah,torx,7,6,1,0,7
torch,17499,torch,torC,8,6,2,1,7
torn,17502,torn,torn,16,14,2,9,7
torpor,17508,torpor,torpX,2,1,1,0,2
torque,17509,torque,tork,11,8,3,4,7
torrid,17512,torrid,tcr|d,1,1,0,0,1
tort,17515,tort,tort,15,13,2,7,8
torture,17519,torture,torCX,2,1,1,0,2
tory,17520,Tory,tori,13,10,3,6,7
toss,17521,toss,tcs,10,9,1,5,5
tot,17522,tot,tat,26,24,2,22,4
total,17523,total,totL,8,7,1,5,3
tote,17527,tote,tot,30,23,7,18,12
totem,17528,totem,totM,2,1,1,0,2
touch,17529,touch,t^C,12,11,1,5,7
touchy,17532,touchy,t^Ci,3,2,1,1,2
tough,17533,tough,t^f,17,15,2,10,7
toupee,17534,toupee,tupe,1,1,0,1,0
tour,17535,tour,tUr,8,8,0,7,1
tousle,17540,tousle,tWzL,2,1,1,1,1
tout,17541,tout,tWt,20,17,3,17,3
towel,17543,towel,tWL,9,7,2,5,4
tower,17544,tower,tWX,8,8,0,5,3
town,17546,town,tWn,14,14,0,11,3
toy,17556,toy,tO,12,10,2,4,8
trace,17557,trace,tres,13,11,2,4,9
track,17560,track,tr@k,10,7,3,3,7
tract,17561,tract,tr@kt,5,1,4,3,2
tractor,17566,tractor,tr@ktX,1,0,1,0,1
trade,17567,trade,tred,13,9,4,4,9
trader,17568,trader,tredX,2,1,1,0,2
trail,17577,trail,trel,13,10,3,5,8
train,17578,train,tren,15,12,3,9,6
trait,17579,trait,tret,19,15,4,9,10
traitor,17580,traitor,tretX,3,2,1,1,2
tram,17583,tram,tr@m,11,7,4,5,6
trammel,17584,trammel,tr@mL,4,2,2,0,4
tramp,17585,tramp,tr@mp,8,3,5,4,4
trample,17586,trample,tr@mpL,2,0,2,0,2
trance,17587,trance,tr@ns,3,3,0,2,1
trap,17640,trap,tr@p,13,8,5,4,9
traps,17646,traps,tr@ps,4,2,2,2,2
trash,17648,trash,tr@S,7,6,1,4,3
travel,17652,travel,tr@vL,3,2,1,2,1
trawl,17656,trawl,trcl,10,9,1,5,5
tray,17657,tray,tre,19,11,8,9,10
treacle,17659,treacle,trikL,2,2,0,2,0
tread,17660,tread,trEd,12,9,3,5,7
treadle,17661,treadle,trEdL,3,2,1,0,3
treason,17663,treason,trizN,1,0,1,1,0
treat,17666,treat,trit,10,7,3,3,7
treaty,17668,treaty,triti,1,0,1,0,1
treble,17669,treble,trEbL,6,4,2,3,3
tree,17671,tree,tri,16,11,5,8,8
trek,17673,trek,trEk,6,5,1,1,5
tremble,17675,tremble,trEmbL,1,0,1,0,1
trench,17680,trench,trEnC,4,3,1,3,1
trend,17682,trend,trEnd,5,2,3,3,2
tress,17686,tress,trEs,11,9,2,4,7
trestle,17687,trestle,trEsL,4,2,2,1,3
triad,17688,triad,trY@d,1,0,1,0,1
trial,17689,trial,trYL,10,7,3,0,10
tribal,17693,tribal,trYbL,5,3,2,2,3
tribe,17694,tribe,trYb,9,7,2,1,8
trice,17701,trice,trYs,15,13,2,4,11
trick,17705,trick,trIk,13,10,3,5,8
trickle,17706,trickle,trIkL,7,5,2,5,2
tried,17712,tried,trYd,16,11,5,5,11
trifle,17714,trifle,trYfL,4,2,2,2,2
trig,17716,trig,trIg,9,7,2,4,5
trigger,17717,trigger,trIgX,2,0,2,1,1
trill,17719,trill,trIl,15,13,2,8,7
trim,17722,trim,trIm,9,8,1,4,5
trine,17724,trine,trYn,13,10,3,4,9
trio,17728,trio,trio,4,2,2,1,3
trip,17729,trip,trIp,14,10,4,5,9
tripe,17731,tripe,trYp,15,11,4,4,11
triple,17732,triple,trIpL,5,2,3,3,2
trite,17740,trite,trYt,17,13,4,6,11
triune,17747,triune,trYun,1,0,1,0,1
trivet,17748,trivet,trIvxt,2,1,1,2,0
trod,17755,trod,trad,7,5,2,2,5
trodden,17756,trodden,tradN,1,0,1,0,1
troll,17757,troll,trol,9,5,4,4,5
troop,17761,troop,trup,10,9,1,3,7
trope,17763,trope,trop,9,6,3,3,6
tropic,17765,tropic,trapIk,1,0,1,1,0
trot,17767,trot,trat,8,6,2,3,5
troth,17768,troth,trcT,6,5,1,3,3
trouble,17770,trouble,tr^bL,5,4,1,3,2
trough,17771,trough,trcf,2,2,0,0,2
trounce,17772,trounce,trWns,1,1,0,1,0
trousseau,17774,trousseau,truso,1,0,1,0,1
trout,17775,trout,trWt,8,6,2,3,5
trow,17776,trow,tro,17,12,5,8,9
trowel,17777,trowel,trWL,4,2,2,2,2
troy,17778,troy,trO,6,5,1,0,6
truce,17780,truce,trus,9,6,3,1,8
truck,17781,truck,tr^k,9,5,4,2,7
truckle,17782,truckle,tr^kL,5,4,1,2,3
trudge,17785,trudge,tr^J,4,4,0,2,2
true,17786,TRUE,tru,18,11,7,8,10
truffle,17787,truffle,tr^fL,4,3,1,2,2
trump,17789,trump,tr^mp,2,1,1,2,0
trunk,17796,trunk,tr^Gk,3,2,1,2,1
truss,17797,truss,tr^s,7,6,1,0,7
trust,17798,trust,tr^st,6,3,3,4,2
trustee,17799,trustee,tr^sti,1,0,1,0,1
truth,17801,truth,truT,5,3,2,1,4
try,17802,try,trY,19,10,9,6,13
tryst,17803,tryst,trIst,4,3,1,4,0
tub,17804,tub,t^b,17,16,1,11,6
tuba,17805,tuba,tubx,4,3,1,0,4
tube,17806,tube,tub,12,8,4,2,10
tuber,17807,tuber,tubX,5,4,1,1,4
tuck,17815,tuck,t^k,28,24,4,20,8
tucker,17816,tucker,t^kX,3,2,1,2,1
tufa,17818,tufa,tufx,2,2,0,0,2
tuft,17819,tuft,t^ft,2,1,1,1,1
tug,17820,tug,t^g,18,18,0,12,6
tumble,17824,tumble,t^mbL,8,5,3,7,1
tumbril,17827,tumbril,t^mbrL,2,1,1,1,1
tumor,17830,tumor,tumX,4,3,1,1,3
tuna,17833,tuna,tunx,3,2,1,0,3
tune,17835,tune,tun,27,23,4,18,9
tunic,17838,tunic,tunIk,2,2,0,2,0
tunnel,17840,tunnel,t^nL,7,6,1,4,3
tunny,17841,tunny,t^ni,12,11,1,9,3
tuque,17842,tuque,tuk,19,17,2,11,8
turban,17843,turban,tRbxn,2,2,0,0,2
turbid,17844,turbid,tRb|d,2,2,0,1,1
turbine,17845,turbine,tRb|n,4,3,1,2,2
turbot,17847,turbot,tRbxt,1,1,0,0,1
tureen,17849,tureen,tXin,4,4,0,3,1
turf,17850,turf,tRf,7,7,0,3,4
turgid,17851,turgid,tRJ|d,1,1,0,1,0
turk,17853,Turk,tRk,23,21,2,18,5
turkey,17854,turkey,tRki,3,1,2,1,2
turnkey,17858,turnkey,tRnki,1,0,1,0,1
turtle,17865,turtle,tRtL,8,8,0,8,0
tusk,17867,tusk,t^sk,9,6,3,5,4
tusked,17868,tusked,t^skt,1,0,1,0,1
tussle,17869,tussle,t^sL,7,7,0,5,2
tussock,17870,tussock,t^sxk,1,0,1,0,1
tutor,17872,tutor,tutX,8,7,1,5,3
tv,17875,TV,tivi,3,3,0,0,3
twaddle,17876,twaddle,twadL,4,2,2,4,0
twain,17877,twain,twen,6,5,1,4,2
twang,17878,twang,tw@G,1,0,1,1,0
tweak,17879,tweak,twik,4,2,2,2,2
tweed,17880,tweed,twid,4,3,1,2,2
tweet,17881,tweet,twit,6,6,0,3,3
twice,17886,twice,twYs,2,2,0,1,1
twiddle,17887,twiddle,twIdL,1,1,0,1,0
twig,17888,twig,twIg,8,7,1,4,4
twill,17890,twill,twIl,10,8,2,5,5
twin,17891,twin,twIn,9,6,3,2,7
twine,17892,twine,twYn,8,6,2,5,3
twinge,17893,twinge,twInJ,2,0,2,1,1
twinkle,17894,twinkle,twIGkL,2,0,2,2,0
twirl,17895,twirl,twRl,3,3,0,2,1
twist,17896,twist,twIst,3,2,1,2,1
twit,17897,twit,twIt,11,7,4,4,7
twitch,17898,twitch,twIC,7,6,1,3,4
twitter,17899,twitter,twItX,2,0,2,1,1
tyke,17903,tyke,tYk,25,24,1,16,9
type,17906,type,tYp,18,16,2,9,9
umbel,17928,umbel,^mbL,8,2,6,7,1
umber,17929,umber,^mbX,6,3,3,5,1
unable,17938,unable,^nebL,1,1,0,1,0
unchain,17966,unchain,^nCen,1,1,0,1,0
under,17988,under,^ndX,4,1,3,3,1
undo,18045,undo,^ndu,2,2,0,0,2
unknown,18106,unknown,^non,1,0,1,1,0
unnerve,18119,unnerve,^nRv,1,0,1,1,0
untie,18149,untie,^ntY,2,2,0,1,1
unto,18152,unto,^ntu,4,4,0,2,2
up,18160,up,^p,7,3,4,5,2
upend,18167,upend,^pEnd,2,2,0,2,0
upon,18178,upon,xpcn,3,2,1,2,1
upper,18179,upper,^pX,5,3,2,4,1
upraise,18185,upraise,^prez,2,1,1,2,0
upright,18187,upright,^prYt,2,2,0,1,1
uproot,18191,uproot,^prut,1,1,0,0,1
urban,18208,urban,Rb|n,5,3,2,4,1
urbane,18209,urbane,Rben,2,1,1,1,1
urchin,18214,urchin,RC|n,2,2,0,2,0
urge,18220,urge,RJ,11,6,5,7,4
ursine,18228,ursine,RsYn,2,1,1,2,0
us,18230,us,^s,10,5,5,9,1
use,18234,use,yuz,13,9,4,9,4
usher,18237,usher,^SX,3,3,0,3,0
utile,18248,utile,yutL,1,0,1,1,0
utter,18255,utter,^tX,12,6,6,12,0
v,18259,v,vi,22,19,3,19,3
vague,18277,vague,veg,4,4,0,1,3
vail,18278,vail,vel,24,22,2,21,3
vain,18279,vain,ven,19,18,1,15,4
valet,18290,valet,v@l|t,3,3,0,3,0
valid,18293,valid,v@lxd,5,5,0,4,1
valley,18298,valley,v@li,11,10,1,9,2
valor,18299,valor,v@lX,4,4,0,2,2
valve,18307,valve,v@lv,3,2,1,0,3
valved,18308,valved,v@lvd,2,1,1,0,2
vamp,18311,vamp,v@mp,6,6,0,6,0
van,18313,van,v@n,12,11,1,11,1
vandal,18315,vandal,v@ndL,4,4,0,4,0
vapid,18324,vapid,v@pxd,1,1,0,1,0
vapor,18327,vapor,vepX,4,4,0,4,0
varia,18332,varia,vErix,3,1,2,0,3
variance,18336,variance,vErixns,2,1,1,0,2
variant,18337,variant,vErixnt,1,1,0,0,1
varied,18341,varied,vErid,3,2,1,1,2
various,18347,various,vErixs,2,0,2,0,2
vary,18351,vary,vEri,10,7,3,8,2
vase,18353,vase,ves,16,15,1,13,3
vassal,18355,vassal,v@sL,7,7,0,6,1
vast,18356,vast,v@st,13,10,3,10,3
vasty,18357,vasty,v@sti,4,3,1,3,1
vat,18358,vat,v@t,17,15,2,15,2
vatic,18359,vatic,v@tIk,1,0,1,1,0
vault,18362,vault,vclt,6,6,0,5,1
vaunt,18363,vaunt,vcnt,10,9,1,9,1
veal,18364,veal,vil,20,17,3,18,2
vector,18365,vector,vEktX,5,5,0,5,0
veer,18368,veer,vIr,20,17,3,17,3
veery,18369,veery,vIri,9,6,3,6,3
veiling,18379,veiling,velIG,2,2,0,2,0
veined,18380,veined,vend,2,1,1,1,1
velar,18381,velar,vilX,3,2,1,2,1
vellum,18383,vellum,vElM,1,1,0,0,1
venal,18390,venal,vinL,6,4,2,4,2
venally,18392,venally,vinLi,1,0,1,0,1
vend,18394,vend,vEnd,14,11,3,10,4
vendee,18395,vendee,vEndi,2,1,1,0,2
vender,18396,vender,vEndX,6,5,1,3,3
venial,18405,venial,viniL,2,1,1,1,1
venom,18407,venom,vEnM,4,4,0,1,3
venous,18409,venous,vin|s,3,3,0,3,0
vent,18410,vent,vEnt,16,14,2,12,4
venture,18416,venture,vEnCX,4,4,0,3,1
verb,18423,verb,vRb,6,5,1,2,4
verbal,18424,verbal,vRbL,3,2,1,0,3
verdure,18435,verdure,vRJX,3,2,1,2,1
verge,18436,verge,vRJ,9,7,2,5,4
vermeil,18443,vermeil,vRmL,3,3,0,1,2
vermin,18448,vermin,vRmxn,3,2,1,3,0
vernal,18451,vernal,vRnL,6,6,0,4,2
verse,18456,verse,vRs,15,12,3,10,5
versed,18457,versed,vRst,10,8,2,8,2
version,18461,version,vRZ|n,4,3,1,4,0
verso,18462,verso,vRso,3,2,1,0,3
verve,18475,verve,vRv,6,6,0,3,3
vesper,18479,vesper,vEspX,1,1,0,0,1
vessel,18481,vessel,vEsL,6,5,1,4,2
vest,18482,vest,vEst,19,16,3,14,5
vestal,18483,vestal,vEstL,5,3,2,2,3
vestee,18484,vestee,vEsti,5,3,2,2,3
vestry,18490,vestry,vEstri,1,0,1,0,1
vesture,18491,vesture,vEsCX,3,3,0,2,1
vet,18492,vet,vEt,16,14,2,13,3
vetch,18493,vetch,vEC,6,5,1,5,1
vex,18498,vex,vEks,3,2,1,3,0
via,18500,via,vYx,7,5,2,1,6
viable,18502,viable,vYxbL,2,1,1,2,0
vial,18505,vial,vYL,10,6,4,1,9
vicar,18513,vicar,vIkX,7,6,1,5,2
vice,18517,vice,vYs,16,14,2,10,6
victor,18531,victor,vIktX,3,1,2,1,2
victory,18534,victory,vIktXi,1,0,1,0,1
victual,18535,victual,vItL,5,5,0,3,2
vide,18537,vide,vYdi,2,2,0,1,1
video,18539,video,vIdio,1,1,0,1,0
vie,18540,vie,vY,25,18,7,17,8
vier,18541,vier,vYX,9,6,3,1,8
view,18543,view,vyu,6,5,1,6,0
vigil,18546,vigil,vIJL,2,2,0,0,2
vigor,18550,vigor,vIgX,4,4,0,3,1
viking,18551,Viking,vYkIG,1,1,0,1,0
vile,18552,vile,vYl,22,19,3,15,7
vilely,18553,vilely,vYli,5,4,1,3,2
villa,18557,villa,vIlx,3,1,2,0,3
villain,18559,villain,vIl|n,2,2,0,1,1
villein,18560,villein,vIlxn,3,2,1,0,3
villi,18562,villi,vIlY,2,2,0,1,1
villous,18563,villous,vIlxs,2,1,1,0,2
vim,18564,vim,vIm,6,6,0,5,1
vine,18570,vine,vYn,21,19,2,14,7
vinous,18573,vinous,vYn|s,4,4,0,4,0
vinyl,18576,vinyl,vYnL,7,5,2,3,4
violable,18578,violable,vYLxbL,1,0,1,1,0
viper,18587,viper,vYpX,4,3,1,2,2
viral,18589,viral,vYrL,4,3,1,1,3
vireo,18590,vireo,vIrio,2,1,1,1,1
virgin,18591,virgin,vRJ|n,3,3,0,3,0
virgo,18593,Virgo,vRgo,1,1,0,0,1
virile,18596,virile,vIrL,5,4,1,1,4
virtu,18598,virtu,vRtu,2,2,0,1,1
virtual,18599,virtual,vRCuL,1,0,1,0,1
virtue,18600,virtue,vRCu,2,1,1,0,2
virus,18605,virus,vYr|s,2,1,1,2,0
vision,18619,vision,vIZ|n,2,2,0,2,0
visor,18625,visor,vYzX,6,5,1,4,2
vital,18633,vital,vYtL,6,4,2,2,4
vitals,18638,vitals,vYtLz,1,0,1,0,1
vocal,18660,vocal,vokL,2,2,0,2,0
vogue,18669,vogue,vog,4,4,0,2,2
voice,18671,voice,vOs,7,6,1,4,3
voiced,18672,voiced,vOst,8,7,1,7,1
void,18673,void,vOd,4,2,2,2,2
voile,18674,voile,vOl,12,11,1,10,2
vole,18680,vole,vol,21,20,1,18,3
volley,18682,volley,vali,7,7,0,7,0
volt,18684,volt,volt,9,7,2,7,2
volute,18698,volute,vxlut,2,2,0,2,0
vomit,18699,vomit,vamxt,1,1,0,1,0
vote,18706,vote,vot,15,13,2,12,3
vouch,18708,vouch,vWC,6,4,2,4,2
vow,18710,vow,vW,14,11,3,10,4
vowel,18711,vowel,vWL,7,6,1,5,2
vulgar,18718,vulgar,v^lgX,1,1,0,0,1
vulture,18730,vulture,v^lCX,2,2,0,1,1
wabble,18732,wabble,wabL,8,8,0,4,4
wacky,18733,wacky,w@ki,5,5,0,3,2
wad,18734,wad,wad,22,17,5,17,5
waddle,18736,waddle,wadL,12,9,3,6,6
wade,18737,wade,wed,24,21,3,16,8
wadi,18739,wadi,wadi,6,5,1,4,2
wafer,18740,wafer,wefX,4,3,1,1,3
waffle,18741,waffle,wafL,6,6,0,1,5
waft,18742,waft,waft,3,2,1,1,2
wag,18743,wag,w@g,14,12,2,13,1
wage,18744,wage,weJ,17,13,4,8,9
wager,18745,wager,weJX,4,3,1,1,3
waggle,18748,waggle,w@gL,4,2,2,2,2
waif,18753,waif,wef,13,11,2,4,9
wail,18754,wail,wel,32,28,4,24,8
wain,18755,wain,wen,29,26,3,21,8
waist,18758,waist,west,8,7,1,7,1
wait,18762,wait,wet,27,22,5,18,9
waive,18764,waive,wev,21,18,3,11,10
waiver,18765,waiver,wevX,7,5,2,3,4
wake,18766,wake,wek,26,22,4,18,8
walk,18768,walk,wck,15,14,1,12,3
wall,18769,wall,wcl,23,19,4,18,5
walleye,18773,walleye,wclY,2,1,1,0,2
wallow,18777,wallow,walo,4,3,1,4,0
waltz,18781,waltz,wcls,3,2,1,1,2
wan,18783,wan,wan,14,12,2,11,3
wand,18784,wand,wand,9,6,3,6,3
wander,18785,wander,wandX,6,5,1,5,1
wangle,18787,wangle,w@GgL,8,6,2,7,1
want,18788,want,wcnt,9,8,1,8,1
wanton,18789,wanton,wcntN,1,0,1,0,1
war,18791,war,wor,29,20,9,19,10
warble,18792,warble,worbL,1,1,0,1,0
ward,18795,ward,word,21,15,6,11,10
warden,18796,warden,wordN,3,2,1,1,2
warder,18797,warder,wordX,4,2,2,2,2
ware,18799,ware,wEr,25,21,4,19,6
warm,18805,warm,worm,11,8,3,4,7
warmth,18808,warmth,wormT,1,0,1,0,1
warn,18809,warn,worn,15,13,2,9,6
warp,18810,warp,worp,7,6,1,1,6
wart,18817,wart,wort,15,11,4,9,6
wary,18820,wary,w@ri,11,10,1,9,2
was,18821,was,wxz,1,1,0,1,0
wash,18822,wash,wcS,7,4,3,2,5
washer,18824,washer,wcSX,3,2,1,0,3
washy,18827,washy,wcSi,2,1,1,0,2
wasp,18828,wasp,wasp,2,2,0,1,1
wassail,18829,wassail,wasL,8,8,0,3,5
watch,18833,watch,wcC,5,5,0,2,3
water,18834,water,wctX,3,2,1,1,2
watery,18845,watery,wctXi,1,0,1,0,1
watt,18846,watt,wat,25,21,4,21,4
wattle,18847,wattle,watL,8,7,1,3,5
wavy,18848,wavy,wevi,4,3,1,2,2
wax,18849,wax,w@ks,4,3,1,3,1
way,18851,way,we,30,20,10,17,13
we,18854,we,wi,30,22,8,18,12
weak,18855,weak,wik,22,19,3,16,6
weal,18857,weal,wil,28,24,4,21,7
weald,18858,weald,wild,10,8,2,8,2
wealth,18859,wealth,wElT,6,5,1,1,5
wean,18860,wean,win,25,21,4,17,8
wearable,18862,wearable,w@rxbL,2,1,1,2,0
wearer,18863,wearer,w@rX,1,1,0,0,1
weary,18865,weary,wIri,11,8,3,8,3
weasel,18867,weasel,wizL,3,2,1,2,1
weather,18868,weather,wEDX,6,6,0,6,0
weave,18875,weave,wiv,16,13,3,9,7
web,18876,web,wEb,10,8,2,3,7
webbed,18877,webbed,wEbd,4,2,2,0,4
wed,18878,wed,wEd,25,22,3,16,9
wedge,18880,wedge,wEJ,12,11,1,6,6
weed,18883,weed,wid,24,20,4,17,7
weeny,18884,weeny,wini,5,4,1,3,2
weep,18885,weep,wip,18,16,2,12,6
weevil,18886,weevil,wivL,3,1,2,1,2
weft,18887,weft,wEft,10,9,1,5,5
weird,18888,weird,wIrd,5,5,0,2,3
welch,18889,welch,wElC,7,6,1,1,6
weld,18891,weld,wEld,16,13,3,8,8
well,18894,well,wEl,31,22,9,20,11
welsh,18895,welsh,wElS,5,4,1,0,5
welt,18896,welt,wElt,21,17,4,10,11
welter,18897,welter,wEltX,3,1,2,2,1
wen,18899,wen,wEn,29,24,5,20,9
wench,18900,wench,wEnC,8,6,2,4,4
wend,18901,wend,wEnd,18,15,3,12,6
went,18902,went,wEnt,19,17,2,11,8
wept,18903,wept,wEpt,7,5,2,2,5
were,18904,were,wX,5,5,0,0,5
west,18906,west,wEst,19,17,2,14,5
wet,18908,wet,wEt,29,22,7,18,11
whack,18910,whack,hw@k,3,2,1,3,0
whale,18911,whale,hwel,7,4,3,3,4
whaler,18912,whaler,hwelX,1,0,1,0,1
wharf,18913,wharf,worf,7,5,2,1,6
what,18916,what,hwat,7,5,2,3,4
wheal,18920,wheal,hwil,7,5,2,2,5
wheat,18921,wheat,hwit,9,8,1,3,6
wheeze,18924,wheeze,hwiz,3,3,0,0,3
whelk,18925,whelk,hwElk,2,2,0,0,2
whelm,18926,whelm,hwElm,3,2,1,1,2
whelp,18927,whelp,hwElp,3,2,1,1,2
when,18928,when,hwEn,6,3,3,2,4
whence,18929,whence,hwEns,2,0,2,1,1
where,18932,where,hwEr,7,4,3,4,3
wherry,18943,wherry,hwEri,1,0,1,0,1
whet,18944,whet,hwEt,8,7,1,2,6
which,18946,which,hwIC,11,9,2,4,7
whicker,18949,whicker,hwIkX,3,1,2,1,2
whiff,18950,whiff,hwIf,7,7,0,0,7
whig,18952,Whig,hwIg,10,9,1,3,7
while,18953,while,hwYl,8,5,3,2,6
whim,18956,whim,hwIm,9,8,1,2,7
whimper,18957,whimper,hwImpX,1,1,0,0,1
whine,18962,whine,hwYn,7,5,2,3,4
whip,18964,whip,hwIp,10,9,1,2,8
whirl,18971,whirl,hwRl,8,5,3,4,4
whirr,18975,whirr,hwR,3,1,2,0,3
whish,18976,whish,hwIS,9,8,1,2,7
whisk,18977,whisk,hwIsk,4,2,2,0,4
whisker,18978,whisker,hwIskX,4,2,2,0,4
whisky,18979,whisky,hwIski,2,1,1,0,2
whisper,18980,whisper,hwIspX,2,2,0,0,2
whist,18981,whist,hwIst,4,3,1,1,3
whistle,18982,whistle,hwIsL,3,3,0,0,3
whit,18983,whit,hwIt,17,13,4,4,13
white,18984,white,hwYt,11,7,4,3,8
whiten,18989,whiten,hwYtN,2,0,2,1,1
whither,18992,whither,hwIDX,3,1,2,2,1
whittle,18998,whittle,hwItL,2,1,1,0,2
whizz,18999,whizz,hwIz,10,9,1,2,8
who,19000,who,hu,31,25,6,19,12
whom,19005,whom,hum,17,16,1,12,5
whoop,19008,whoop,hwup,3,2,1,2,1
whore,19010,whore,hor,30,24,6,19,11
whose,19012,whose,huz,16,14,2,11,5
why,19015,why,hwY,6,1,5,1,5
wick,19016,wick,wIk,26,23,3,16,10
wicked,19017,wicked,wIk|d,2,2,0,1,1
wicker,19018,wicker,wIkX,8,6,2,6,2
wicket,19019,wicket,wIk|t,4,4,0,3,1
wide,19021,wide,wYd,26,23,3,15,11
widen,19022,widen,wYdN,2,1,1,1,1
widow,19024,widow,wIdo,5,3,2,0,5
widower,19025,widower,wIdoX,1,0,1,0,1
width,19026,width,wIdT,2,1,1,0,2
wiener,19027,wiener,winX,2,1,1,0,2
wife,19028,wife,wYf,15,14,1,6,9
wig,19030,wig,wIg,20,16,4,11,9
wiggle,19032,wiggle,wIgL,5,4,1,4,1
wight,19033,wight,wYt,26,23,3,17,9
wild,19036,wild,wYld,10,8,2,7,3
wile,19041,wile,wYl,29,24,5,18,11
will,19044,will,wIl,34,28,6,24,10
willing,19046,willing,wIlIG,5,5,0,5,0
willow,19048,willow,wIlo,8,6,2,3,5
willowy,19049,willowy,wIloi,1,0,1,0,1
wilt,19051,wilt,wIlt,14,10,4,10,4
wilton,19052,Wilton,wIltN,1,0,1,0,1
wily,19053,wily,wYli,4,3,1,2,2
wimple,19054,wimple,wImpL,3,3,0,3,0
win,19055,win,wIn,31,25,6,19,12
wince,19056,wince,wIns,9,7,2,5,4
winch,19057,winch,wInC,11,8,3,6,5
wind,19058,wind,wInd,11,8,3,3,8
winder,19061,winder,wYndX,2,2,0,2,0
window,19067,window,wIndo,5,1,4,0,5
windrow,19069,windrow,wIndro,1,0,1,0,1
windy,19072,windy,wIndi,3,2,1,1,2
wine,19073,wine,wYn,30,26,4,21,9
wing,19075,wing,wIG,18,15,3,8,10
winged,19076,winged,wIGd,4,3,1,0,4
wink,19078,wink,wIGk,14,10,4,10,4
winkle,19079,winkle,wIGkL,4,2,2,3,1
winnow,19080,winnow,wIno,8,6,2,1,7
wipe,19085,wipe,wYp,14,12,2,5,9
wire,19086,wire,wYr,22,19,3,13,9
wise,19090,wise,wYz,15,13,2,5,10
wish,19092,wish,wIS,13,11,2,5,8
wisp,19093,wisp,wIsp,2,2,0,2,0
wit,19096,wit,wIt,31,25,6,21,10
witch,19097,witch,wIC,20,15,5,11,9
with,19100,with,wIT,13,12,1,4,9
wither,19103,wither,wIDX,9,7,2,6,3
withers,19104,withers,wIDXz,1,0,1,0,1
within,19106,within,wItIn,1,1,0,0,1
withy,19109,withy,wIDi,4,4,0,1,3
witted,19112,witted,wIt|d,1,1,0,1,0
witting,19114,witting,wItIG,2,2,0,1,1
witty,19115,witty,wIti,7,6,1,4,3
wive,19116,wive,wYv,19,17,2,9,10
wives,19117,wives,wYvz,5,3,2,3,2
woad,19120,woad,wod,22,18,4,16,6
woe,19121,woe,wo,23,18,5,14,9
woful,19123,woful,wofL,1,1,0,1,0
woke,19124,woke,wok,18,16,2,14,4
wold,19126,wold,wold,15,13,2,13,2
wolf,19127,wolf,wUlf,3,1,2,0,3
womb,19134,womb,wum,9,8,1,8,1
wonder,19138,wonder,w^ndX,5,4,1,5,0
woo,19141,woo,wu,24,23,1,18,6
wood,19142,wood,wUd,15,13,2,11,4
wooden,19145,wooden,wUdN,3,2,1,1,2
woods,19149,woods,wUdz,3,1,2,0,3
woodsy,19151,woodsy,wUdzi,1,0,1,0,1
woof,19153,woof,wUf,6,5,1,3,3
wool,19154,wool,wUl,13,11,2,9,4
wooly,19157,wooly,wUli,6,5,1,4,2
woozy,19158,woozy,wuzi,3,2,1,3,0
word,19159,word,wRd,19,18,1,12,7
work,19161,work,wRk,20,18,2,14,6
world,19168,world,wRld,5,4,1,4,1
worm,19171,worm,wRm,10,10,0,4,6
worry,19175,worry,wRi,12,10,2,4,8
worse,19176,worse,wRs,14,12,2,6,8
worsen,19177,worsen,wRsN,3,2,1,1,2
worst,19179,worst,wRst,10,7,3,7,3
wort,19181,wort,wRt,20,18,2,13,7
worth,19182,worth,wRT,13,12,1,7,6
worthy,19184,worthy,wRDi,2,1,1,1,1
wound,19185,wound,wWnd,10,10,0,10,0
wove,19186,wove,wov,12,11,1,8,4
wraith,19188,wraith,reT,15,14,1,4,11
wrangle,19189,wrangle,r@GgL,8,7,1,7,1
wrasse,19191,wrasse,r@s,23,18,5,12,11
wrath,19192,wrath,r@T,17,17,0,7,10
wreath,19193,wreath,riT,17,17,0,7,10
wreathe,19194,wreathe,riD,15,14,1,5,10
wreck,19195,wreck,rEk,18,17,1,13,5
wren,19196,wren,rEn,26,22,4,18,8
wrench,19197,wrench,rEnC,10,5,5,6,4
wrestle,19198,wrestle,rEsL,8,7,1,5,3
wriggle,19201,wriggle,rIgL,8,7,1,4,4
wrinkle,19202,wrinkle,rIGkL,5,3,2,4,1
wrist,19203,wrist,rIst,16,11,5,11,5
writ,19206,writ,rIt,37,32,5,23,14
writer,19207,writer,rYtX,7,6,1,4,3
writhe,19208,writhe,rYD,14,13,1,4,10
writing,19209,writing,rYtIG,5,5,0,5,0
written,19210,written,rItN,8,6,2,5,3
wrong,19211,wrong,rcG,13,10,3,10,3
wroth,19214,wroth,rcT,10,6,4,7,3
wrought,19215,wrought,rct,23,19,4,20,3
x,19216,x,Eks,8,4,4,6,2
y,19230,y,wY,32,21,11,18,14
yacht,19231,yacht,yat,16,16,0,15,1
yak,19235,yak,y@k,14,13,1,11,3
yam,19236,yam,y@m,12,10,2,9,3
yammer,19237,yammer,y@mX,3,2,1,2,1
yank,19238,yank,y@Gk,12,9,3,10,2
yankee,19239,Yankee,y@Gki,3,2,1,2,1
yanqui,19240,yanqui,yaGki,1,1,0,1,0
yap,19241,yap,y@p,13,13,0,11,2
yard,19242,yard,yard,10,10,0,9,1
yarn,19244,yarn,yarn,5,4,1,3,2
yarrow,19245,yarrow,y@ro,6,5,1,6,0
yawl,19246,yawl,ycl,16,15,1,14,2
yawn,19247,yawn,ycn,12,11,1,10,2
yaws,19248,yaws,ycz,6,6,0,4,2
ye,19250,ye,yi,21,19,2,18,3
yea,19251,yea,ye,17,17,0,15,2
yean,19252,yean,yin,15,14,1,14,1
year,19253,year,yIr,18,17,1,18,0
yearn,19256,yearn,yRn,10,9,1,10,0
yeast,19257,yeast,yist,4,3,1,4,0
yell,19258,yell,yEl,19,16,3,14,5
yellow,19259,yellow,yElo,7,6,1,5,2
yelp,19260,yelp,yElp,4,3,1,2,2
yen,19261,yen,yEn,20,19,1,17,3
yeoman,19262,yeoman,yomxn,4,3,1,4,0
yes,19263,yes,yEs,9,8,1,6,3
yet,19265,yet,yEt,15,15,0,12,3
yield,19267,yield,yild,4,4,0,4,0
yodel,19268,yodel,yodL,2,2,0,1,1
yoga,19269,yoga,yogx,2,2,0,1,1
yogi,19271,yogi,yogi,3,3,0,2,1
yoke,19272,yoke,yok,12,10,2,10,2
yokel,19273,yokel,yokL,4,3,1,2,2
yon,19274,yon,yan,10,9,1,8,2
yonder,19275,yonder,yandX,3,3,0,3,0
yore,19276,yore,yor,19,17,2,17,2
young,19277,young,y^G,7,7,0,7,0
younker,19279,younker,y^GkX,3,3,0,3,0
yours,19280,yours,yorz,1,0,1,0,1
youth,19282,youth,yuT,7,6,1,3,4
yowl,19283,yowl,yWl,8,7,1,8,0
yucca,19287,yucca,y^kx,2,2,0,2,0
yule,19289,yule,yul,16,12,4,12,4
yummy,19291,yummy,y^mi,4,4,0,4,0
z,19292,z,zi,22,18,4,20,2
zany,19293,zany,zeni,1,1,0,1,0
zeal,19294,zeal,zil,15,13,2,14,1
zealot,19295,zealot,zEl|t,1,1,0,1,0
zed,19299,zed,zEd,10,10,0,9,1
zen,19301,Zen,zEn,15,14,1,14,1
zephyr,19304,zephyr,zEfX,1,1,0,1,0
zero,19306,zero,zIro,1,1,0,1,0
zest,19307,zest,zEst,11,11,0,11,0
zinc,19309,zinc,zIGk,11,9,2,10,1
zing,19310,zing,zIG,9,8,1,7,2
zion,19312,Zion,zY|n,3,2,1,3,0
zip,19313,zip,zIp,14,13,1,12,2
zipper,19314,zipper,zIpX,6,5,1,4,2
zither,19317,zither,zIDX,5,5,0,4,1
zonal,19322,zonal,zonL,3,2,1,1,2
zone,19324,zone,zon,17,13,4,15,2
zoned,19325,zoned,zond,3,2,1,0,3
zoo,19326,zoo,zu,20,19,1,18,2
zooid,19328,zooid,zoOd,1,1,0,0,1
zoom,19332,zoom,zum,8,7,1,7,1