node,ortho,phono,original,replace,delete_insert,pos_l50,pos_m50,Item,NumSylls,NumPhones,Duration,OrthUP,PhonND,OrthND,FreqSUBTLEX,FreqCOCA,FreqCOCAspok,FreqGoogle,PhonUP
5428,eaten,itN,3,1,2,2,1,eaten,2,4,469,5,54,7,927,3526,325,3412832,5
14302,real,riL,16,12,4,4,12,real,1,3,371,5,192,32,22583,83094,24403,297702750,4
7606,halves,h@vz,7,4,3,4,3,halves,1,4,500,6,18,8,56,1160,24,1070410,4
18932,where,hwEr,7,4,3,4,3,where,1,3,332,6,115,6,93341,258804,73309,360478571,4
14348,recession,rIsES|n,1,0,1,0,1,recession,3,7,519,10,4,4,23,7666,3122,1637070,8
7041,gawky,gcki,1,0,1,0,1,gawky,2,4,412,5,17,1,14,66,3,32782,4
3583,complete,kxmplit,1,0,1,0,1,complete,2,7,457,9,2,4,2636,23661,3034,149315377,8
5163,dolly,dali,13,12,1,11,2,dolly,2,4,529,6,103,21,306,872,145,2268877,5
18673,void,vOd,4,2,2,2,2,void,1,3,461,5,18,6,209,1839,206,32492676,4
17586,trample,tr@mpL,2,0,2,0,2,trample,2,7,544,8,8,4,41,142,22,527795,8
9268,jabber,J@bX,3,2,1,2,1,jabber,2,4,489,6,9,4,25,41,3,2858295,4
8495,inanity,In@n|ti,1,0,1,1,0,inanity,4,7,536,6,1,2,1,24,0,51255,6
8948,insubstantial,Insxbst@nCL,1,1,0,1,0,insubstantial,4,12,785,13,1,0,18,175,6,123180,11
1412,baby,bebi,5,4,1,3,2,baby,2,4,372,5,55,17,25978,34012,8993,117716269,5
373,afoot,xfUt,1,0,1,1,0,afoot,2,4,448,4,2,1,52,303,46,367802,3
8674,indoor,Indor,3,1,2,1,2,indoor,2,5,389,7,3,1,68,2603,146,13875813,6
11778,oath,oT,12,9,3,3,9,oath,1,2,352,5,43,19,504,1792,640,2684269,3
11974,opt,apt,2,2,0,2,0,opt,1,3,350,4,23,18,20,1906,239,10770523,4
3521,commendation,kamxndeS|n,1,0,1,0,1,commendation,4,10,747,9,0,0,46,152,16,431651,7
6404,filial,fIliL,1,0,1,0,1,filial,3,6,529,5,0,0,15,205,1,218828,5
3253,classical,kl@sIkL,2,1,1,1,1,classical,3,8,516,10,1,0,224,5135,475,33959138,7
9330,jig,JIg,17,15,2,10,7,jig,1,3,375,4,47,24,87,537,19,1393707,4
1942,blood,bl^d,7,6,1,2,5,blood,1,4,369,6,20,8,9492,36787,5666,61356375,5
12360,pap,p@p,28,28,0,19,9,pap,1,3,279,4,73,43,66,646,57,1954530,4
13198,pocket,pak|t,7,7,0,7,0,pocket,2,5,304,7,12,9,1821,10395,1017,38932393,6
2266,bucket,b^k|t,1,1,0,1,0,bucket,2,5,337,7,11,6,511,2429,231,4415452,6
563,alteration,cltXeS|n,2,0,2,0,2,alteration,4,8,673,11,2,3,36,509,22,2847005,9
17378,tincture,tIGkCX,1,0,1,0,1,tincture,2,6,422,9,4,1,4,104,0,318695,7
5406,ear,Ir,31,12,19,22,9,ear,1,2,278,4,113,50,1632,9860,923,14882612,3
12979,pierce,pIrs,4,3,1,2,2,pierce,1,4,479,7,24,12,1313,2196,269,5947276,5
18600,virtue,vRCu,2,1,1,0,2,virtue,2,4,521,7,1,1,263,3635,296,5148061,5
2571,cap,k@p,30,28,2,19,11,cap,1,3,409,4,117,47,956,8620,1254,25442468,4
12382,parade,pXed,2,0,2,1,1,parade,2,4,396,7,11,6,657,4138,884,8630290,5
6999,garble,garbL,4,2,2,2,2,garble,2,6,479,7,9,10,0,23,3,37309,7
14149,rack,r@k,29,26,3,18,11,rack,1,3,374,5,137,33,397,3636,148,14539676,4
3285,clever,klEvX,2,1,1,2,0,clever,2,5,393,7,13,8,1391,3083,402,4865717,6
15830,sloppy,slapi,1,0,1,0,1,sloppy,2,5,521,6,7,2,300,1044,155,1322519,6
13368,postal,postL,5,4,1,3,2,postal,2,6,495,7,13,4,96,1661,460,29860400,7
5161,dollar,dalX,7,6,1,4,3,dollar,2,4,378,7,64,9,1410,11801,3362,35276362,5
18209,urbane,Rben,2,1,1,1,1,urbane,2,4,578,7,7,5,7,157,6,195416,4
2612,capture,k@pCX,2,2,0,1,1,capture,2,5,599,8,14,3,540,6377,914,17823473,6
3499,comedy,kamxdi,1,1,0,0,1,comedy,3,6,501,7,3,1,602,5740,1399,22994845,7
3150,chuckle,C^kL,5,4,1,3,2,chuckle,2,5,379,8,11,4,81,904,47,635926,6
9736,lead,lEd,31,23,8,20,11,lead,1,3,606,5,134,26,4246,38562,7348,68327739,4
9862,liable,lYxbL,3,1,2,3,0,liable,3,6,559,5,7,5,369,1252,239,12126852,5
11764,nutty,n^ti,6,5,1,4,2,nutty,2,4,464,5,17,7,182,582,127,689340,4
6301,feeble,fibL,2,2,0,2,0,feeble,2,5,384,6,28,3,86,667,25,747164,5
10593,meadow,mEdo,4,3,1,0,4,meadow,2,4,401,7,23,3,116,1558,63,3549050,5
10889,minute,mIn|t,4,3,1,3,1,minute,2,5,494,7,4,2,19252,26841,8141,41062743,4
15768,sky,skY,6,5,1,3,3,sky,1,3,492,4,23,8,2285,19650,1325,27296223,4
13044,pirate,pYrxt,2,2,0,2,0,pirate,2,5,375,7,11,3,375,1154,114,4309949,6
13332,portable,portxbL,2,1,1,2,0,portable,3,8,420,9,1,2,204,2791,182,34210546,9
17031,teach,tiC,13,11,2,6,7,teach,1,3,360,6,69,16,3715,14813,2299,19086011,4
1759,berry,bEri,13,10,3,7,6,berry,2,4,374,6,144,23,178,2860,420,7552546,5
11776,oasis,oes|s,1,1,0,1,0,oasis,3,5,494,4,1,4,98,833,69,9273039,4
17484,top,tap,21,17,4,16,5,top,1,3,319,4,75,37,6805,76822,13724,484225102,4
1886,blade,bled,9,8,1,3,6,blade,1,4,527,6,39,14,663,4132,113,11529676,5
616,amen,emEn,1,0,1,1,0,amen,2,4,529,5,8,25,1325,801,250,2402870,4
3973,corona,kXonx,2,2,0,1,1,corona,3,5,499,7,12,4,58,599,33,2807296,6
11212,mouth,mWT,7,6,1,5,2,mouth,1,3,539,6,22,11,5325,22510,2107,22881577,4
4573,defeat,dxfit,1,1,0,1,0,defeat,2,5,438,7,4,3,580,5657,1293,6851628,6
6625,folly,fali,11,10,1,10,1,folly,2,4,459,5,81,17,74,749,52,1367992,5
16731,supposed,sxpozd,1,0,1,0,1,supposed,2,6,677,9,2,2,12865,20498,6273,14497557,6
1172,assure,xSUr,6,4,2,4,2,assure,2,4,524,7,8,3,1021,2898,650,8118473,5
5075,dissolve,dIzalv,2,2,0,2,0,dissolve,2,6,540,9,4,3,95,1424,90,1307386,7
18927,whelp,hwElp,3,2,1,1,2,whelp,1,4,238,6,29,3,24,13,0,71458,5
17807,tuber,tubX,5,4,1,1,4,tuber,2,4,391,6,27,19,3,123,4,249743,5
13628,priest,prist,1,0,1,0,1,priest,1,5,378,7,18,6,1336,5614,923,7402030,6
6905,fuse,fyuz,7,5,2,2,5,fuse,1,4,668,5,59,19,248,705,103,3000882,5
13944,pump,p^mp,14,12,2,11,3,pump,1,4,301,5,20,16,645,4620,730,18645408,5
7477,grunt,gr^nt,4,3,1,4,0,grunt,1,5,413,6,19,9,113,708,18,618246,6
10404,mannequin,m@nIk|n,1,1,0,0,1,mannequin,3,7,482,10,1,1,62,245,39,397146,8
17799,trustee,tr^sti,1,0,1,0,1,trustee,2,6,512,8,9,2,42,920,95,6132688,7
15533,shark,Sark,10,8,2,7,3,shark,1,4,449,6,57,18,764,2173,417,5909700,5
17284,those,Doz,9,8,1,8,1,those,1,3,538,4,71,10,38404,244236,71088,270022703,3
19257,yeast,yist,4,3,1,4,0,yeast,1,4,450,6,21,15,44,1165,101,6083904,5
7228,glory,glori,1,0,1,1,0,glory,2,5,457,5,28,6,1096,3723,365,13160100,6
14623,reproof,rIpruf,1,1,0,0,1,reproof,2,6,703,6,0,0,2,26,0,96285,5
15726,sip,sIp,28,25,3,21,7,sip,1,3,417,4,83,44,260,2026,108,5433773,4
15545,sheath,SiT,11,10,1,4,7,sheath,1,3,449,7,55,6,25,520,18,1252872,4
7184,glacial,gleSL,1,1,0,0,1,glacial,2,6,542,7,0,0,6,518,17,1085890,5
406,aggression,xgrES|n,1,1,0,1,0,aggression,3,7,480,11,3,1,143,3978,782,2543047,8
11194,motive,motIv,1,1,0,1,0,motive,2,5,397,7,4,5,675,2459,974,2136857,6
2532,candor,k@ndX,10,8,2,4,6,candor,2,5,464,5,34,6,51,561,134,371814,5
2396,cabbage,k@bIJ,1,1,0,1,0,cabbage,2,5,499,8,5,3,148,1705,88,2237437,5
19195,wreck,rEk,18,17,1,13,5,wreck,1,3,321,6,121,9,697,1804,332,2448625,4
8953,insulate,Insxlet,1,0,1,0,1,insulate,3,7,728,9,3,2,14,360,33,340181,8
10140,love,l^v,11,10,1,5,6,love,1,3,363,5,40,31,56864,84549,24659,201087618,4
19086,wire,wYr,22,19,3,13,9,wire,2,3,519,5,114,36,1403,7556,882,31120754,4
12997,piling,pYlIG,3,3,0,3,0,piling,2,5,480,7,18,9,72,776,171,690226,6
7866,hew,hyu,9,5,4,7,2,hew,1,3,363,4,61,39,8,193,10,356064,4
4758,design,dIzYn,2,2,0,2,0,design,2,5,512,7,8,5,826,29783,1364,264467230,6
2304,bully,bUli,8,7,1,6,2,bully,2,4,411,6,48,17,368,1363,308,1532418,5
907,applause,xplcz,1,1,0,0,1,applause,2,5,622,7,4,0,576,3031,1544,1705835,5
5113,divide,dxvYd,4,4,0,0,4,divide,2,5,483,7,14,5,298,4726,815,6625935,6
12949,piazza,pi@zx,1,1,0,1,0,piazza,3,5,558,6,3,1,25,596,29,1694892,4
17521,toss,tcs,10,9,1,5,5,toss,1,3,482,5,54,34,632,4350,342,2645572,4
4163,creepy,kripi,1,0,1,0,1,creepy,2,5,365,6,14,4,568,898,194,1697316,6
48,abnormal,@bnormL,1,0,1,0,1,abnormal,3,8,768,9,1,0,148,1330,152,3966114,9
3216,city,sIti,7,6,1,5,2,city,2,4,365,5,42,4,8624,110435,20881,390573240,5
8256,if,If,13,10,3,5,8,if,1,2,375,3,46,26,180610,589059,179701,1134988791,3
5304,drown,drWn,9,8,1,4,5,drown,1,4,406,6,17,7,540,1044,221,1156106,5
1379,aware,xwEr,4,3,1,4,0,aware,2,4,559,6,14,5,1818,16138,3300,25701095,5
18256,uttermost,^tXmost,2,1,1,2,0,uttermost,3,7,571,6,3,0,3,15,0,150056,4
15866,smitten,smItN,1,0,1,1,0,smitten,2,6,502,6,7,1,62,359,56,382659,6
4976,discard,dIskard,1,1,0,0,1,discard,2,7,579,8,5,4,55,1466,36,1974345,8
5795,equestrian,IkwEstrixn,1,1,0,0,1,equestrian,4,10,604,4,0,0,20,411,14,3081766,4
1239,attain,xten,7,5,2,4,3,attain,2,4,440,7,18,1,47,1347,66,2668275,5
2471,callow,k@lo,9,8,1,8,1,callow,2,4,426,7,52,9,13,101,8,186826,5
17786,TRUE,tru,18,11,7,8,10,TRUE,1,3,360,5,61,14,12921,50607,15278,96282261,4
6736,fought,fct,20,17,3,16,4,fought,1,3,428,5,71,8,1362,8271,2018,5535215,4
2491,camber,k@mbX,5,3,2,4,1,camber,2,5,549,6,20,12,0,62,3,368461,6
15988,son,s^n,26,24,2,20,6,son,1,3,392,4,110,62,20949,42385,9688,58098266,4
17331,thy,DY,23,21,2,17,6,thy,1,2,433,4,92,18,1243,899,131,10020384,3
14279,ravel,r@vL,9,7,2,6,3,ravel,2,5,529,6,23,22,21,178,6,515437,6
4182,crew,kru,19,10,9,11,8,crew,1,3,423,5,94,17,2424,11363,2238,22459782,4
16456,stray,stre,10,4,6,4,6,stray,1,4,523,6,20,10,272,1494,138,1807545,5
4176,crest,krEst,9,6,3,6,3,crest,1,5,620,6,27,14,107,1328,152,5477034,6
4937,dip,dIp,25,23,2,16,9,dip,1,3,302,4,75,31,406,2619,328,5850511,4
2998,checker,CEkX,3,1,2,0,3,checker,2,4,377,8,37,3,56,263,31,3577995,5
5930,every,Evri,2,1,1,2,0,every,2,4,321,6,15,9,28007,135518,34789,189332269,5
4750,desecration,dEsIkreS|n,1,0,1,0,1,desecration,4,10,668,12,3,2,23,203,37,321471,11
15793,slay,sle,19,12,7,9,10,slay,1,3,574,5,55,25,109,212,14,702325,4
1970,bluish,bluIS,1,1,0,0,1,bluish,2,5,508,5,6,3,7,388,10,384449,5
607,ambitious,@mbIS|s,1,1,0,0,1,ambitious,3,7,598,10,1,1,243,3879,428,3292680,8
17310,throne,Tron,8,6,2,5,3,throne,1,4,429,7,23,8,441,1680,216,3392820,5
8489,inalienable,InelyxnxbL,1,1,0,1,0,inalienable,5,11,532,4,0,2,20,241,26,316410,4
4453,date,det,24,20,4,16,8,date,1,3,355,5,80,38,7218,19581,3886,488975185,4
19186,wove,wov,12,11,1,8,4,wove,1,3,430,5,24,15,12,341,10,198353,4
13125,play,ple,16,9,7,7,9,play,1,3,333,5,52,22,18081,68601,13591,150763326,4
17319,thud,T^d,7,7,0,5,2,thud,1,3,334,5,29,10,99,629,32,392615,4
14740,reveal,rIvil,2,2,0,1,1,reveal,2,5,563,7,6,7,476,8309,1039,8279126,6
18032,undertake,^ndXtek,1,0,1,0,1,undertake,3,7,609,10,3,3,52,1438,158,5613443,8
9994,list,lIst,19,16,3,10,9,list,1,4,478,5,56,33,4110,31376,5888,472615583,5
5337,dug,d^g,22,21,1,13,9,dug,1,3,469,4,60,31,455,3189,427,1925921,4
17457,tome,tom,22,20,2,14,8,tome,1,3,300,5,65,30,39,343,14,4284389,4
15586,shirt,SRt,15,14,1,13,2,shirt,1,3,395,6,71,12,2365,13813,1409,40510838,4
11726,nude,nud,15,13,2,8,7,nude,1,3,344,5,56,16,301,1643,322,96757551,4
12587,peaked,pikt,5,3,2,2,3,peaked,1,4,374,6,36,8,62,959,97,870787,4
15532,share,SEr,22,20,2,18,4,share,1,3,420,6,124,32,3545,30316,4932,119297860,4
6390,fifteen,fIftin,1,0,1,0,1,fifteen,2,6,540,8,6,2,895,7293,878,6252884,7
13344,portion,porS|n,3,1,2,3,0,portion,2,6,459,8,7,2,221,7351,973,23356888,7
11595,noble,nobL,5,3,2,5,0,noble,2,5,512,6,37,16,744,3221,356,12605251,6
12159,ovation,oveS|n,1,1,0,1,0,ovation,3,6,484,8,1,2,45,446,83,791068,7
8231,idea,Ydix,1,1,0,0,1,idea,3,4,423,5,15,9,18311,56406,15986,65466433,5
4294,culture,k^lCX,2,1,1,1,1,culture,2,5,452,8,12,3,711,35835,3703,68608026,6
3121,chosen,CozN,1,0,1,0,1,chosen,2,5,516,6,8,3,927,9439,1189,21347014,4
17370,timid,tImxd,1,1,0,1,0,timid,2,5,397,6,0,1,77,719,84,663058,5
12549,patrician,pxtrIS|n,2,0,2,2,0,patrician,3,8,588,10,4,2,5,245,7,218456,9
4313,curb,kRb,12,11,1,5,7,curb,1,3,495,5,58,9,209,2718,279,3509520,4
9754,lease,lis,27,24,3,12,15,lease,1,3,392,6,140,24,320,2125,171,17180592,4
13031,pinto,pInto,1,1,0,1,0,pinto,2,5,484,5,13,15,43,466,79,1108872,5
18517,vice,vYs,16,14,2,10,6,vice,1,3,418,5,62,27,950,21532,8967,32223701,4
18529,victimize,vIktxmYz,1,0,1,0,1,victimize,3,8,764,10,3,1,9,61,23,44256,9
11703,novel,navL,3,3,0,1,2,novel,2,5,473,6,17,12,513,13577,1248,21821672,6
19171,worm,wRm,10,10,0,4,6,worm,1,3,490,5,40,13,516,1474,69,5784026,4
17936,umpire,^mpYr,1,1,0,1,0,umpire,3,5,486,7,2,2,54,433,69,795626,6
14712,retake,ritek,1,1,0,0,1,retake,2,5,483,7,5,4,37,245,59,348798,6
2591,capitol,k@pxtL,2,1,1,0,2,capitol,3,7,486,8,8,4,122,6567,3176,7917607,8
12397,parameter,pX@mxtX,1,1,0,1,0,parameter,4,7,672,10,3,2,13,669,12,22301697,8
2985,chattel,C@tL,9,8,1,4,5,chattel,2,5,421,7,17,3,15,80,7,191116,5
7852,hero,hIro,3,2,1,2,1,hero,2,4,379,5,22,34,2542,7912,1942,12346600,5
16957,tamp,t@mp,11,6,5,8,3,tamp,1,4,386,5,35,23,3,111,29,95517,5
2254,brunch,br^nC,4,3,1,3,1,brunch,1,5,441,7,13,4,189,785,45,2123970,6
11632,none,n^n,20,20,0,15,5,none,1,3,335,5,78,31,5641,22082,4214,85532588,4
15216,scarf,skarf,2,0,2,0,2,scarf,1,5,562,6,8,12,239,1691,120,3181107,6
13239,political,pxlItIkL,1,1,0,0,1,political,4,9,547,10,1,1,1115,92025,22593,82022326,7
13969,puppy,p^pi,6,5,1,2,4,puppy,2,4,417,5,15,4,584,1295,268,6662994,5
18418,venue,vEnyu,1,1,0,1,0,venue,2,5,499,6,2,4,73,1636,215,14204074,4
8033,horror,hcrX,2,2,0,0,2,horror,2,4,438,7,44,3,468,4312,721,16404225,5
1706,being,biIG,1,1,0,1,0,being,2,4,436,6,22,10,24781,177650,52565,242793967,5
2321,bunk,b^Gk,14,10,4,9,5,bunk,1,4,509,5,43,26,320,1034,96,1645649,5
16931,tag,t@g,21,20,1,14,7,tag,1,3,370,4,62,40,708,3394,492,32443312,4
16391,stock,stak,12,9,3,2,10,stock,1,4,590,6,47,17,1300,22498,4253,176300524,5
5148,dog,dcg,8,8,0,6,2,dog,1,3,326,4,46,36,9835,22251,4315,77282721,4
18468,vertical,vRtIkL,1,1,0,1,0,vertical,3,7,472,9,0,0,141,3864,87,16230027,6
1913,bleed,blid,9,8,1,3,6,bleed,1,4,370,6,26,7,515,816,151,1989525,5
2709,cask,k@sk,7,5,2,4,3,cask,1,4,455,5,34,17,6,104,7,484364,5
18025,underside,^ndXsYd,1,0,1,0,1,underside,3,7,763,8,2,0,12,670,20,738829,7
19176,worse,wRs,14,12,2,6,8,worse,1,3,454,6,71,9,5002,19564,5186,15677993,4
9186,irk,Rk,16,8,8,12,4,irk,1,2,312,4,86,14,5,28,5,124144,3
9804,leisure,liZX,3,3,0,1,2,leisure,2,4,629,8,29,2,129,2448,183,23133305,4
14570,render,rEndX,4,3,1,3,1,render,2,5,379,7,31,26,103,1511,119,5232001,6
5386,dwarf,dworf,1,0,1,1,0,dwarf,1,5,425,6,7,2,157,1417,61,3072068,6
10175,lumber,l^mbX,6,3,3,5,1,lumber,2,5,425,7,9,12,126,1625,115,3970464,6
15903,snivel,snIvL,3,2,1,2,1,snivel,2,6,484,7,3,2,5,9,1,18854,7
3336,clung,kl^G,8,7,1,3,5,clung,1,4,442,5,23,9,24,1146,37,371586,5
1789,bias,bYxs,1,1,0,1,0,bias,2,4,629,5,24,20,82,4418,640,8808565,5
2213,brittle,brItL,3,3,0,1,2,brittle,2,6,362,8,19,5,71,907,36,880926,6
12212,overturn,ovXtRn,1,1,0,0,1,overturn,3,6,649,9,5,3,19,799,339,618972,7
14172,raffle,r@fL,7,7,0,3,4,raffle,2,5,491,7,25,8,93,169,11,1541879,6
7155,gift,gIft,5,5,0,4,1,gift,1,4,596,5,19,10,3290,12214,1808,131428152,5
5185,donkey,dcGki,1,1,0,1,0,donkey,2,5,479,7,9,6,273,1189,72,2821287,6
15422,sensor,sEnsor,1,1,0,0,1,sensor,2,5,544,7,27,7,115,1595,76,13759804,6
7235,glower,glWX,1,1,0,1,0,glower,2,4,420,7,11,9,0,78,6,35287,5
13055,pitch,pIC,24,21,3,13,11,pitch,1,3,372,6,67,15,792,6672,801,9800806,4
12681,Pentecostal,pEntIkcstL,1,0,1,0,1,pentecostal,4,11,714,10,0,0,10,522,35,534827,10
15627,shrink,SrIGk,6,5,1,6,0,shrink,1,5,467,7,14,5,577,1942,272,3261118,6
14339,receive,rIsiv,4,4,0,2,2,receive,2,5,624,8,7,10,992,14838,1676,88330662,6
16945,tallow,t@lo,10,8,2,8,2,tallow,2,4,402,6,31,11,5,138,0,239819,4
5513,election,xlEkS|n,2,1,1,2,0,election,3,7,738,9,5,5,560,26106,12730,36728229,8
33,abide,xbYd,5,4,1,3,2,abide,2,4,421,6,11,8,138,959,283,3722809,5
9671,lark,lark,11,9,2,7,4,lark,1,4,351,5,46,22,83,423,28,972888,5
2682,carriage,k@rIJ,2,2,0,2,0,carriage,2,5,444,9,20,3,381,1780,110,4664470,6
16075,specific,spxsIfIk,1,0,1,1,0,specific,3,8,629,9,2,1,908,31631,3850,107786068,9
19269,yoga,yogx,2,2,0,1,1,yoga,2,4,435,4,8,8,227,2282,217,14665972,4
15514,shaft,S@ft,5,4,1,5,0,shaft,1,4,446,6,16,7,393,2247,134,6431597,5
13215,pointer,pOntX,1,0,1,0,1,pointer,2,5,501,8,14,11,55,927,56,11476769,6
2206,brisk,brIsk,7,4,3,4,3,brisk,1,5,379,6,23,7,53,1013,56,774000,6
5705,ensign,Ens|n,1,1,0,1,0,ensign,2,5,629,5,25,1,181,298,128,967853,5
3512,command,kxm@nd,4,2,2,1,3,command,2,6,497,8,5,3,2225,9526,1772,59871929,7
12829,pestle,pEstL,7,5,2,5,2,pestle,2,6,529,5,14,4,31,146,12,174357,7
10518,mast,m@st,14,11,3,10,4,mast,1,4,565,5,58,35,83,617,53,2341785,5
16301,station,steS|n,2,0,2,1,1,station,2,6,525,8,11,4,4033,20567,4302,61893414,7
15317,seal,sil,31,28,3,20,11,seal,1,3,519,5,197,34,752,4315,523,16275478,4
2526,candid,k@nd|d,2,2,0,1,1,candid,2,6,529,7,8,5,102,1088,394,3066199,7
15328,seasonable,sizNxbL,1,1,0,1,0,seasonable,4,9,732,8,1,2,2,10,5,51494,7
5919,even,ivxn,2,1,1,2,0,even,2,4,419,5,7,25,44672,279417,57396,245707765,5
16936,take,tek,25,23,2,22,3,take,1,3,298,5,69,36,96443,185863,61593,264366303,4
11998,oratorio,crxtorio,1,0,1,0,1,oratorio,5,8,696,8,0,0,2,79,20,197424,4
10980,mixture,mIksCX,1,1,0,1,0,mixture,2,6,649,8,5,2,126,10337,325,8996041,7
14761,revive,rIvYv,3,2,1,0,3,revive,2,5,559,7,3,7,94,1235,250,1247670,6
1014,argon,argan,1,1,0,1,0,argon,2,5,558,6,2,10,9,141,6,761489,4
16054,sparkle,sparkL,1,0,1,0,1,sparkle,2,7,616,8,4,5,85,649,67,1998800,8
4120,crane,kren,15,12,3,7,8,crane,1,4,403,6,68,21,1714,2054,199,4888961,5
4378,cymbal,sImbL,4,3,1,3,1,cymbal,2,6,505,7,14,1,13,53,6,611557,7
9894,lid,lId,23,21,2,16,7,lid,1,3,489,4,84,39,251,2714,185,5788240,4
11965,opossum,xpasM,2,1,1,1,1,opossum,3,6,635,3,1,1,4,66,5,193299,4
14917,rope,rop,27,23,4,15,12,rope,1,3,395,5,116,35,1158,4159,429,6948203,4
1061,arrest,xrEst,5,3,2,5,0,arrest,2,4,520,7,30,3,3037,7141,2504,7653819,5
2817,celebrity,sxlEbrxti,1,0,1,1,0,celebrity,4,9,558,10,2,1,372,5085,1712,23500942,10
1395,axial,@ksiL,2,1,1,0,2,axial,3,6,519,4,3,0,7,425,2,1685087,7
644,among,xm^G,1,1,0,0,1,among,2,4,452,6,3,6,1729,90909,9247,83432110,5
3269,clear,klIr,9,8,1,5,4,clear,1,4,431,6,38,11,8763,51346,12859,88453565,5
17279,thorn,Torn,9,9,0,8,1,thorn,1,4,376,6,35,14,260,812,59,1422150,5
7915,hint,hInt,10,9,1,7,3,hint,1,4,347,5,35,22,469,3685,464,6007484,5
15757,skin,skIn,13,11,2,4,9,skin,1,4,594,5,42,19,2246,26103,2238,54800399,5
7697,haunt,hcnt,11,11,0,9,2,haunt,1,4,394,6,22,11,182,998,239,985188,5
11656,noon,nun,19,18,1,13,6,noon,1,3,403,5,63,19,924,6211,1344,9918712,4
15685,sill,sIl,35,26,9,24,11,sill,1,3,407,5,128,32,23,453,19,787271,4
17311,throng,TrcG,4,2,2,3,1,throng,1,4,653,7,8,3,16,471,24,330339,5
8399,impersonate,ImpRsNet,1,0,1,0,1,impersonate,4,9,749,12,3,3,33,84,18,255003,10
2645,career,kXIr,2,2,0,2,0,career,2,4,474,7,12,10,2305,30744,4976,71249453,5
7181,given,gIvxn,1,1,0,1,0,given,2,5,345,6,23,16,4851,62622,11220,125544161,6
16478,strife,strYf,5,5,0,0,5,strife,1,5,592,7,13,8,85,849,109,1156084,6
6640,footage,fUtIJ,1,1,0,0,1,footage,2,5,646,5,2,0,422,2594,1043,6907471,5
13664,private,prYvxt,1,1,0,1,0,private,2,6,422,8,3,2,3874,41819,7720,187887808,7
7435,groan,gron,15,13,2,5,10,groan,1,4,406,6,55,11,47,656,29,473578,5
6433,fine,fYn,28,25,3,20,8,fine,1,3,510,5,93,38,30502,32561,6526,71983414,4
2007,boil,bOl,15,12,3,14,1,boil,1,3,390,5,84,20,303,3947,223,2422548,4
11612,noisy,nOzi,3,2,1,2,1,noisy,2,4,463,5,7,3,257,1692,146,3722908,5
19067,window,wIndo,5,1,4,0,5,window,2,5,469,7,19,7,4386,26536,2511,102713291,6
7976,homicidal,hamxsYdL,1,0,1,0,1,homicidal,4,9,664,8,0,0,103,212,41,217742,8
9737,leaden,lEdN,5,4,1,3,2,leaden,2,5,386,6,38,9,5,194,5,116308,5
16444,strap,str@p,6,4,2,3,3,strap,1,5,552,6,21,8,263,1493,117,11414669,6
61,abortion,xborS|n,1,1,0,1,0,abortion,3,7,595,9,2,1,369,10896,4422,9397315,8
11482,neither,niDX,2,1,1,2,0,neither,2,4,441,5,11,5,3451,18480,2095,22640465,3
6272,favor,fevX,4,3,1,4,0,favor,2,4,390,6,34,6,3609,12796,2888,11868066,5
11176,mosey,mozi,6,6,0,5,1,mosey,2,4,374,5,39,19,36,116,16,67050,5
19295,zealot,zEl|t,1,1,0,1,0,zealot,2,5,454,7,3,2,10,140,38,340121,6
2828,cellular,sElyUlX,1,1,0,1,0,cellular,3,7,595,9,2,0,145,2160,221,19906433,8
6839,frown,frWn,3,3,0,3,0,frown,1,4,427,6,20,7,104,915,34,748276,5
16129,spirit,spIr|t,1,1,0,0,1,spirit,2,6,614,7,3,3,2517,16119,1937,36977078,6
5286,driver,drYvX,3,1,2,1,2,driver,2,5,559,7,18,10,2416,13273,2093,48465707,6
11551,nickel,nIkL,10,9,1,5,5,nickel,2,5,349,7,52,15,431,1343,190,6106046,6
19238,yank,y@Gk,12,9,3,10,2,yank,1,4,440,5,36,24,240,578,44,646395,5
14243,rarefy,r@rxfY,1,1,0,1,0,rarefy,3,6,544,6,4,1,0,3,0,5464,7
1659,beck,bEk,19,19,0,14,5,beck,1,3,306,5,135,34,195,2072,344,4291120,4
11167,mortgage,morgIJ,1,0,1,0,1,mortgage,2,6,499,9,5,3,301,6268,1437,74161273,7
14660,residential,rEzxdEnCL,1,0,1,1,0,residential,4,10,608,9,0,2,91,4802,272,31337029,8
8633,independent,IndxpEnd|nt,1,1,0,0,1,independent,4,11,585,12,2,1,477,21396,4328,64171624,12
6505,flap,fl@p,10,9,1,4,6,flap,1,4,395,5,30,17,135,1434,130,2725466,5
17176,testimonial,tEst|moniL,1,0,1,0,1,testimonial,5,11,644,12,1,1,32,146,20,1481582,12
15812,slim,slIm,11,10,1,3,8,slim,1,4,563,5,26,20,605,2868,328,9713890,5
17000,tart,tart,14,8,6,9,5,tart,1,4,322,5,37,30,122,1336,78,1363526,5
11395,nasty,n@sti,3,2,1,3,0,nasty,2,5,629,5,8,7,1151,3307,787,7439073,6
6151,facet,f@s|t,4,3,1,3,1,facet,2,5,504,6,11,11,13,528,46,1223168,6
6264,fatty,f@ti,7,6,1,4,3,fatty,2,4,499,5,33,11,260,1498,97,5363547,5
3332,club,kl^b,4,3,1,1,3,club,1,4,299,5,18,7,5038,22834,2547,132442807,5
11105,monster,manstX,3,3,0,2,1,monster,2,6,549,8,7,6,1982,4224,618,17611893,7
13614,prevail,prxvel,1,1,0,1,0,prevail,2,6,495,8,3,3,107,1541,403,1948134,7
17529,touch,t^C,12,11,1,5,7,touch,1,3,390,6,39,13,7534,19240,3809,36835562,4
4335,curtain,kRtN,5,4,1,3,2,curtain,2,5,359,8,41,4,525,2749,325,4828203,6
17668,treaty,triti,1,0,1,0,1,treaty,2,5,579,7,7,3,239,6035,1072,9086189,6
15449,sequel,sikwL,1,0,1,1,0,sequel,2,6,639,7,4,1,90,957,207,3277297,7
15274,scramble,skr@mbL,1,0,1,0,1,scramble,2,8,490,9,3,3,123,1135,115,1103614,9
519,alley,@li,22,13,9,16,6,alley,2,3,340,6,118,30,831,3316,349,4541475,4
1584,basin,besN,8,7,1,5,3,basin,2,5,371,6,41,20,96,3415,129,10550181,6
15854,smell,smEl,7,4,3,3,4,smell,1,4,457,6,29,14,4240,10062,1097,6642666,5
6718,fort,fort,16,13,3,6,10,fort,1,4,394,5,66,35,787,9036,1109,34362335,5
6559,floor,floX,6,4,2,1,5,floor,1,4,547,6,38,12,5132,34427,3980,53763234,5
13186,plush,pl^S,9,8,1,4,5,plush,1,4,423,5,12,7,28,799,44,4693277,4
11164,mortality,mort@l|ti,1,0,1,1,0,mortality,4,9,594,7,0,1,77,4629,314,8978176,5
15591,shod,Sad,18,15,3,13,5,shod,1,3,542,5,72,11,6,100,8,201094,4
5497,eighth,etT,2,1,1,0,2,eighth,1,3,322,7,11,5,350,5066,498,4949260,4
7539,gyrate,JYret,1,0,1,1,0,gyrate,2,5,564,7,2,3,4,25,1,28824,6
2149,brave,brev,10,8,2,3,7,brave,1,4,361,6,22,12,1617,3574,850,5221356,5
4690,dental,dEntL,5,4,1,4,1,dental,2,6,387,7,13,5,315,1838,317,23240707,7
16115,spill,spIl,13,9,4,5,8,spill,1,4,517,6,32,11,432,3640,1026,3890646,5
14341,recent,risNt,1,1,0,1,0,recent,2,6,569,7,4,7,669,45589,5477,141766999,7
15997,soot,sUt,11,11,0,11,0,soot,1,3,430,5,21,30,55,563,50,573693,4
13286,pond,pand,7,5,2,4,3,pond,1,4,510,5,32,12,323,3477,262,9223378,5
2713,cassette,k|sEt,1,1,0,1,0,cassette,2,5,446,9,8,5,93,856,67,10853321,6
5027,disown,dIson,1,1,0,0,1,disown,2,5,511,7,4,1,21,88,35,86401,6
5862,estate,Istet,2,0,2,2,0,estate,2,5,494,7,7,4,1076,13061,1968,169262575,6
16493,stroke,strok,7,6,1,0,7,stroke,1,5,452,7,26,10,667,5765,699,11440396,6
7417,grill,grIl,15,13,2,7,8,grill,1,4,401,6,41,17,227,4905,475,10254434,5
17018,tavern,t@vXn,1,1,0,1,0,tavern,2,5,479,7,4,5,158,1135,46,2738818,6
13884,psalm,sam,11,11,0,6,5,psalm,1,3,463,6,68,5,26,324,25,2220027,4
5156,doing,duIG,1,0,1,0,1,doing,2,4,539,6,26,15,52492,90142,39588,80825701,5
982,arch,arC,8,3,5,3,5,arch,1,3,429,5,36,13,188,1849,162,10045078,4
10707,mercer,mRsX,6,6,0,2,4,mercer,2,4,495,7,27,8,117,692,30,3545626,5
11108,monstrous,manstrxs,1,0,1,0,1,monstrous,2,8,728,8,0,0,122,907,88,759187,7
7446,grope,grop,12,10,2,2,10,grope,1,4,454,6,37,16,31,159,15,166652,5
19134,womb,wum,9,8,1,8,1,womb,1,3,479,5,29,5,177,945,128,1173579,4
7882,hickory,hIkXi,1,1,0,1,0,hickory,3,5,424,7,9,0,69,564,24,2570254,6
14003,push,pUS,5,5,0,2,3,push,1,3,375,5,19,23,3598,14614,3304,20776546,4
8683,industrial,Ind^striL,1,0,1,0,1,industrial,4,10,669,11,8,4,233,12947,1470,65922996,11
1973,blur,blR,6,3,3,2,4,blur,1,3,399,5,106,11,109,1469,111,1918107,4
11387,narrator,n@retX,1,0,1,0,1,narrator,3,6,552,9,4,1,529,7678,136,1696653,7
10543,maternity,mxtRn|ti,2,2,0,2,0,maternity,4,8,572,7,1,1,125,787,126,7689807,6
2202,brink,brIGk,8,5,3,5,3,brink,1,5,385,6,23,16,127,1557,437,1485388,6
18223,urinal,yUrxnL,1,0,1,0,1,urinal,3,7,407,7,0,0,39,130,5,343628,6
8983,intend,IntEnd,2,2,0,0,2,intend,2,6,531,7,5,2,1183,2965,818,6070612,7
3027,chest,CEst,13,12,1,12,1,chest,1,4,519,6,35,10,2090,13451,980,13517184,5
3110,chops,Caps,5,4,1,3,2,chops,1,4,459,6,37,9,277,1179,88,1318721,5
5201,dose,dos,12,11,1,3,9,dose,1,3,434,5,62,45,270,3858,481,15960555,4
13334,portal,portL,5,4,1,3,2,portal,2,6,435,7,10,4,222,979,53,30179923,7
17543,towel,tWL,9,7,2,5,4,towel,1,3,500,6,53,13,722,3101,213,4901668,4
2027,bomber,bamX,3,2,1,1,2,bomber,2,4,381,7,44,10,214,1570,631,2507571,5
6970,gamble,g@mbL,4,2,2,3,1,gamble,2,6,401,7,15,9,456,1849,397,3294887,7
3350,coast,kost,12,11,1,9,3,coast,1,4,508,6,51,10,1361,17429,4271,47718553,5
7456,ground,grWnd,5,3,2,5,0,ground,1,5,473,7,21,7,3696,45521,8773,60680843,6
5963,except,IksEpt,2,2,0,2,0,except,2,6,548,7,2,2,5696,23264,3664,52184148,7
4254,crumple,kr^mpL,2,1,1,1,1,crumple,2,7,539,8,7,5,8,101,6,77197,8
4894,digest,dYJEst,1,1,0,1,0,digest,2,6,559,7,5,7,168,1266,218,14998647,7
10973,mitigate,mIt|get,1,1,0,1,0,mitigate,3,7,580,9,1,3,21,859,90,1866466,8
9850,levee,lEvi,6,6,0,2,4,levee,2,4,356,6,43,9,26,702,337,766809,5
16937,taken,tek|n,4,4,0,4,0,taken,2,5,452,5,18,10,7071,52018,12498,87021159,5
10330,malicious,mxlIS|s,2,2,0,2,0,malicious,3,7,768,10,4,0,80,646,100,3078278,7
9921,likelihood,lYklihUd,1,1,0,1,0,likelihood,3,8,471,7,1,1,58,4121,515,5493171,6
3323,clothing,kloDIG,1,0,1,1,0,clothing,2,6,559,7,3,1,553,7901,1020,72457184,5
6954,gallery,g@lXi,3,2,1,2,1,gallery,3,5,408,8,18,5,434,7955,344,165682518,6
4227,crotch,kraC,4,4,0,0,4,crotch,1,4,415,7,33,2,140,621,53,1039119,5
16432,straggle,str@gL,3,2,1,0,3,straggle,2,7,601,9,6,5,1,79,0,18088,8
16074,species,spiSiz,1,0,1,0,1,species,2,6,585,8,0,1,696,25982,1297,44161798,5
15800,sleeve,sliv,7,6,1,2,5,sleeve,1,4,657,7,20,2,286,2092,158,11445499,5
3617,conceal,kxnsil,4,4,0,0,4,conceal,2,6,604,8,8,2,129,1199,166,1122483,7
13005,pilot,pYlxt,2,2,0,2,0,pilot,2,5,486,6,16,8,1360,9324,2160,21913365,6
4113,craft,kr@ft,4,2,2,3,1,craft,1,5,436,6,20,8,289,5974,517,16529247,6
3180,circle,sRkL,5,5,0,3,2,circle,2,5,492,7,38,2,1097,11180,894,23969393,6
2379,butterfingers,b^tXfIGgXz,1,1,0,0,1,butterfingers,4,10,688,9,0,0,27,12,2,25024,6
16932,tail,tel,30,26,4,26,4,tail,1,3,394,5,117,29,1219,5452,595,10557843,4
6748,fourteen,fortin,1,0,1,0,1,fourteen,2,6,550,9,15,1,333,2998,417,3077092,7
15036,ruthless,ruTlxs,1,1,0,1,0,ruthless,2,6,560,9,2,0,211,1061,206,1015291,7
4549,decorate,dEkXet,1,0,1,0,1,decorate,3,6,394,9,3,3,118,886,80,2087154,7
17324,thunder,T^ndX,3,2,1,3,0,thunder,2,5,522,8,10,1,679,2162,222,6544981,6
3559,compare,kxmpEr,1,1,0,0,1,compare,2,6,561,8,3,3,426,6539,1203,183204396,7
6503,flannel,fl@nL,1,1,0,0,1,flannel,2,6,384,8,4,1,70,632,39,1322321,7
13339,porter,portX,4,3,1,2,2,porter,2,5,411,7,26,19,795,2886,454,7153875,6
10193,lure,lUr,9,8,1,8,1,lure,1,3,368,5,52,26,217,2556,281,2090646,4
13172,plume,plum,7,5,2,5,2,plume,1,4,418,6,19,11,24,670,64,1269109,5
6600,flux,fl^ks,3,3,0,3,0,flux,1,5,513,5,24,9,53,1010,48,6325320,5
17318,thrust,Tr^st,3,2,1,3,0,thrust,1,5,666,7,8,3,197,3101,274,3500938,6
18855,weak,wik,22,19,3,16,6,weak,1,3,489,5,109,17,1607,9178,1478,13348085,4
18795,ward,word,21,15,6,11,10,ward,1,4,344,5,63,30,727,5753,916,14829346,5
9122,invasion,InveZ|n,2,1,1,2,0,invasion,3,7,639,9,3,1,434,5838,1426,7384121,8
8841,inmate,Inmet,1,0,1,1,0,inmate,2,5,373,7,3,2,137,1399,411,2046395,6
10695,mental,mEntL,7,5,2,6,1,mental,2,6,559,7,15,6,1002,18162,1864,35679901,7
17526,totality,tot@l|ti,1,1,0,1,0,totality,4,8,616,8,1,1,7,746,97,653139,8
16116,spilled,spIld,3,2,1,1,2,spilled,1,5,559,7,10,5,324,1819,187,978351,5
14077,quartz,kworts,3,2,1,0,3,quartz,1,6,484,6,16,3,27,360,9,4954096,6
15769,slab,sl@b,11,10,1,4,7,slab,1,4,489,5,20,18,94,1021,42,2092957,5
7002,gargle,gargL,2,1,1,1,1,gargle,2,6,424,6,6,4,30,61,3,89983,7
2658,carmine,karmxn,2,0,2,1,1,carmine,2,6,486,6,56,6,111,190,14,452762,7
4689,dent,dEnt,19,16,3,12,7,dent,1,4,335,5,55,33,180,1163,151,3053258,5
11063,monetary,man|tEri,2,1,1,1,1,monetary,4,8,705,8,1,0,52,3093,433,8524903,6
11361,naive,naiv,1,1,0,0,1,naive,2,4,530,6,3,4,329,1979,405,1862438,4
17123,tenor,tEnX,9,6,3,1,8,tenor,2,4,315,6,55,6,79,930,128,2361385,5
14126,quorum,kworM,1,1,0,0,1,quorum,2,6,404,7,4,1,27,140,23,1973172,7
3252,classic,kl@sIk,1,0,1,0,1,classic,2,6,496,8,7,1,824,11622,1406,59964382,7
5166,dolphin,dclfxn,1,0,1,1,0,dolphin,2,6,464,8,6,2,141,822,117,4551643,7
11056,monarchy,manXki,1,0,1,0,1,monarchy,3,7,483,8,4,2,34,987,246,1172749,8
2246,brow,brW,7,4,3,1,6,brow,1,3,317,5,44,22,94,1961,68,1376949,4
18424,verbal,vRbL,3,2,1,0,3,verbal,2,5,409,7,9,4,149,4587,342,5259906,6
8803,ingrown,Ingron,2,2,0,0,2,ingrown,2,6,510,5,1,0,17,77,7,228400,6
7607,ham,h@m,26,24,2,14,12,ham,1,3,464,4,105,56,591,2215,283,6719894,4
6601,fly,flY,13,9,4,5,8,fly,1,3,414,4,53,15,4335,13809,2880,28290310,4
14835,rim,rIm,26,22,4,15,11,rim,1,3,418,4,107,37,125,2890,107,7152392,4
10198,lust,l^st,13,11,2,11,2,lust,1,4,497,5,40,26,284,1465,125,3107455,5
11027,mold,mold,18,14,4,12,6,mold,1,4,397,5,49,27,219,2319,364,5937613,5
8702,inert,InRt,4,2,2,0,4,inert,2,4,447,6,10,4,18,453,15,935898,5
13222,polar,polX,12,11,1,7,5,polar,2,4,417,6,73,9,135,2152,187,7716475,5
12574,pawn,pcn,21,15,6,17,4,pawn,1,3,350,5,74,13,221,456,101,1192557,4
1681,beetle,bitL,6,5,1,2,4,beetle,2,5,489,7,26,4,105,1049,90,3207549,6
14432,refer,rIfR,3,2,1,1,2,refer,2,4,452,6,31,17,374,4830,651,27107953,5
1125,asleep,xslip,1,0,1,1,0,asleep,2,5,455,5,1,1,2541,6072,792,3967813,4
15636,shrunk,Sr^Gk,4,4,0,4,0,shrunk,1,5,569,7,15,4,79,663,79,629377,6
9463,kennel,kEnL,4,3,1,2,2,kennel,2,5,345,7,51,8,57,314,58,1954777,6
16787,swam,sw@m,4,4,0,1,3,swam,1,4,604,5,16,26,123,1243,78,590013,4
17037,tease,tiz,16,12,4,7,9,tease,1,3,548,6,162,23,290,1021,214,2019742,4
17002,tartar,tartX,6,5,1,4,2,tartar,2,5,336,7,22,4,76,225,7,337681,6
8149,hussy,h^zi,3,3,0,1,2,hussy,2,4,348,5,35,7,63,47,3,90501,5
11339,mystery,mIstXi,4,2,2,2,2,mystery,3,6,520,7,9,2,1171,7441,1772,19281540,7
248,adjourn,xJRn,1,1,0,0,1,adjourn,2,4,576,8,6,1,66,82,26,957864,5
4330,curse,kRs,16,14,2,9,7,curse,1,3,519,6,88,16,929,2146,237,3982181,4
6387,fiery,fYri,6,3,3,5,1,fiery,3,4,583,5,13,7,103,1432,159,1838655,4
11821,obsession,absES|n,1,1,0,1,0,obsession,3,7,768,10,2,1,289,2173,442,2484420,8
19262,yeoman,yomxn,4,3,1,4,0,yeoman,2,5,329,7,44,4,9,126,15,347689,6
16503,strove,strov,5,4,1,0,5,strove,1,5,572,5,15,10,7,228,2,238819,5
14955,rout,rWt,21,18,3,19,2,rout,1,3,303,5,60,26,18,432,42,526454,4
13416,pottery,patXi,2,1,1,1,1,pottery,3,5,386,7,8,3,94,1786,48,15363954,5
3300,clinical,klInIkL,1,0,1,0,1,clinical,3,8,427,9,1,0,149,10172,709,42952429,5
16951,talon,t@l|n,3,2,1,2,1,talon,2,5,467,6,29,9,56,200,6,858741,6
17716,trig,trIg,9,7,2,4,5,trig,1,4,378,5,28,14,39,91,26,591988,5
16243,stable,stebL,4,2,2,3,1,stable,2,6,505,7,11,10,673,7423,911,18230012,7
15638,shudder,S^dX,2,2,0,1,1,shudder,2,4,402,8,13,2,57,678,50,557246,5
10961,mist,mIst,16,11,5,10,6,mist,1,4,499,5,51,30,181,2155,65,3736454,5
290,adult,xd^lt,1,1,0,1,0,adult,2,5,436,6,6,4,729,14517,1770,97585771,6
12709,perch,pRC,16,15,1,10,6,perch,1,3,397,6,56,14,50,1178,55,1235177,4
15260,scorn,skorn,6,3,3,3,3,scorn,1,5,558,6,16,9,59,563,37,628582,6
4614,delegate,dElxget,2,2,0,2,0,delegate,3,7,392,9,3,4,73,1037,379,3921156,8
118,access,@ksEs,3,3,0,2,1,access,2,5,582,7,5,0,1615,27792,3841,217995377,6
12944,pi,pY,32,21,11,18,14,pi,1,2,410,3,119,53,187,1180,100,12273864,3
1726,belly,bEli,11,10,1,5,6,belly,2,4,315,6,128,18,794,4872,374,7346775,5
6620,folk,fok,16,13,3,10,6,folk,1,3,399,5,70,16,365,4504,508,15400730,4
18220,urge,RJ,11,6,5,7,4,urge,1,2,519,5,46,11,339,3776,630,5195810,3
7134,get,gEt,21,19,2,18,3,get,1,3,430,4,74,29,233772,323633,129301,605996761,4
7837,herein,hIrIn,1,1,0,0,1,herein,2,5,568,5,9,7,21,392,12,12372575,4
10537,material,mxtIriL,1,0,1,1,0,material,4,8,601,9,5,3,1129,21885,2482,98530746,9
7168,ginger,JInJX,1,0,1,1,0,ginger,2,5,507,7,3,22,327,4037,273,4901707,6
9063,intersect,IntXsEkt,2,2,0,0,2,intersect,3,8,727,10,7,7,16,379,29,737947,9
8503,inboard,Inbord,1,1,0,0,1,inboard,2,6,501,5,2,1,10,96,3,299263,6
11118,mooring,mUrIG,1,1,0,1,0,mooring,2,5,688,8,14,5,13,137,7,711200,5
8085,hub,h^b,19,19,0,10,9,hub,1,3,280,4,48,25,156,1869,147,11194938,4
6828,front,fr^nt,5,2,3,4,1,front,1,5,337,6,15,6,9259,60046,10181,100890012,6
10607,measurable,mEZXxbL,2,1,1,2,0,measurable,4,8,728,10,1,1,6,806,60,2202880,7
14832,rigor,rIgX,7,5,2,4,3,rigor,2,4,430,6,41,6,44,682,33,519381,5
17462,tonal,tonL,5,3,2,3,2,tonal,2,5,469,6,9,4,3,431,14,707113,4
6791,freight,fret,17,14,3,9,8,freight,1,4,364,8,45,2,196,1231,154,8453128,5
8065,houseboat,hWsbot,1,1,0,0,1,houseboat,2,6,609,10,3,3,40,216,73,381481,7
7426,grip,grIp,12,11,1,3,9,grip,1,4,363,5,36,13,494,4821,295,8098633,5
10624,mediate,midiet,1,0,1,0,1,mediate,3,6,622,8,1,3,14,742,70,982901,7
17088,temperate,tEmpX|t,1,1,0,0,1,temperate,2,7,469,9,2,0,12,678,23,1183312,7
15444,septic,sEptIk,3,1,2,3,0,septic,2,6,619,6,4,2,72,571,23,2044503,6
2020,bolt,bolt,14,12,2,8,6,bolt,1,4,354,5,57,31,351,2258,169,5203702,5
17095,temporal,tEmpXL,2,0,2,0,2,temporal,3,7,379,9,5,0,69,2368,17,5228038,8
3444,collect,kxlEkt,3,2,1,3,0,collect,2,6,581,8,5,3,1020,5898,878,15943314,7
18356,vast,v@st,13,10,3,10,3,vast,1,4,748,5,32,23,311,11276,1397,11921677,5
207,actor,@ktX,5,2,3,4,1,actor,2,4,416,6,25,9,1343,9611,3815,16283217,5
2778,caudal,kcdL,6,6,0,4,2,caudal,2,5,393,5,38,1,0,24,0,271590,6
9608,laid,led,30,23,7,17,13,laid,1,3,349,5,98,24,1527,10429,1946,13359320,4
6269,fault,fclt,10,6,4,5,5,fault,1,4,380,6,33,13,5310,6839,1729,13112664,5
14792,rhyme,rYm,25,20,5,14,11,rhyme,1,3,385,6,86,7,225,742,101,1530934,4
13458,preach,priC,4,2,2,3,1,preach,1,4,466,7,27,5,122,965,209,1539268,5
17885,twenty,twEnti,1,1,0,1,0,twenty,2,6,354,7,4,0,1378,25037,3434,21104413,7
1640,bearing,b@rIG,4,3,1,4,0,bearing,2,5,346,8,61,17,486,4611,397,10602853,6
17519,torture,torCX,2,1,1,0,2,torture,2,5,530,8,7,3,812,3900,1154,12209454,6
18875,weave,wiv,16,13,3,9,7,weave,1,3,419,6,59,12,105,1245,73,1965230,4
15319,seam,sim,22,18,4,10,12,seam,1,3,454,5,115,32,33,703,17,1640179,4
1654,beauty,byuti,3,0,3,2,1,beauty,2,5,409,6,17,3,2460,12883,1477,87579908,6
8990,intention,IntEnC|n,4,2,2,3,1,intention,3,8,818,10,3,2,559,4627,841,8018304,9
6595,flush,fl^S,9,8,1,4,5,flush,1,4,436,6,21,8,478,1863,134,5625616,5
14909,roof,ruf,13,11,2,5,8,roof,1,3,389,5,80,14,1818,8727,1142,14811067,4
3743,connect,kxnEkt,1,1,0,1,0,connect,2,6,375,8,5,3,492,4960,799,45140204,7
15072,sage,seJ,19,15,4,11,8,sage,1,3,541,5,50,32,89,2593,113,7742604,4
18234,use,yuz,13,9,4,9,4,use,1,3,580,4,73,30,17536,149661,20659,719989010,4
14612,repossess,ripxzEs,1,0,1,1,0,repossess,3,7,661,10,2,1,20,33,6,77949,8
15332,secede,sIsid,1,1,0,1,0,secede,2,5,539,7,6,2,4,237,60,130758,6
16001,sop,sap,23,20,3,18,5,sop,1,3,423,4,84,45,14,206,13,1045740,4
12429,pariah,pxrYx,1,1,0,1,0,pariah,3,4,531,7,12,5,20,267,48,395153,5
14993,rummage,r^mIJ,1,1,0,1,0,rummage,2,5,520,8,3,3,40,204,12,200967,6
2158,breach,briC,10,8,2,4,6,breach,1,4,413,7,37,10,317,1427,337,5928795,5
11066,monger,m^GgX,1,1,0,1,0,monger,2,5,629,7,10,15,4,57,19,177097,6
7556,habituate,hxbICuet,1,0,1,0,1,habituate,4,9,600,8,0,0,3,26,4,20633,5
17293,three,Tri,9,8,1,7,2,three,1,3,454,6,47,7,27654,189312,36451,223420478,4
18153,untold,^ntold,1,1,0,0,1,untold,2,6,550,5,2,2,62,567,123,1151452,4
6507,flash,fl@S,10,9,1,4,6,flash,1,4,608,6,30,10,783,5606,592,68397676,5
17033,teal,til,30,27,3,23,7,teal,1,3,352,5,150,32,26,511,23,1803669,4
3340,coach,koC,14,14,0,5,9,coach,1,3,421,6,71,5,2429,23042,1857,24517183,4
15473,servant,sRvxnt,1,1,0,1,0,servant,2,6,688,8,6,2,619,2057,185,4457769,7
2605,captious,k@pS|s,1,1,0,0,1,captious,2,6,652,7,2,2,0,7,1,13677,6
7327,grab,gr@b,8,7,1,3,5,grab,1,4,318,5,41,23,3614,5666,1021,7611410,5
5315,dry,drY,12,8,4,6,6,dry,1,3,360,4,32,22,2184,18236,1426,31746729,4
11163,mortal,mortL,7,4,3,4,3,mortal,2,6,411,7,19,5,488,1323,123,2888221,7
13113,plateau,pl@to,4,3,1,1,3,plateau,2,5,499,8,10,0,29,1192,59,2451741,6
1,a,x,7,4,3,6,1,a,1,1,359,2,79,72,1041179,5822980,1259642,9081174698,2
18400,venerate,vEnXet,1,1,0,1,0,venerate,3,6,474,9,2,3,1,46,4,55151,7
2138,bramble,br@mbL,1,0,1,1,0,bramble,2,7,456,8,6,3,0,85,3,258488,8
9769,leery,lIri,10,7,3,7,3,leery,2,4,439,5,86,9,162,311,50,169484,5
3096,chock,Cak,20,20,0,17,3,chock,1,3,394,6,80,13,9,258,24,508651,4
17823,tulip,tulxp,1,1,0,1,0,tulip,2,5,406,6,7,1,40,412,13,2406691,6
7555,habitual,hxbICuL,1,1,0,0,1,habitual,4,8,560,9,1,0,26,553,36,764616,9
13096,plan,pl@n,8,6,2,2,6,plan,1,4,458,5,39,24,7432,52927,15142,160755405,5
15313,scurvy,skRvi,1,0,1,0,1,scurvy,2,5,642,5,2,2,55,109,3,192339,5
1502,banish,b@nIS,3,3,0,3,0,banish,2,5,463,7,19,12,69,948,18,332389,6
14270,rattle,r@tL,9,7,2,5,4,rattle,2,5,459,7,26,13,172,1085,95,1162261,6
13778,propel,prxpEl,1,0,1,0,1,propel,2,6,619,7,3,3,11,645,65,646694,7
5711,enter,EntX,2,1,1,2,0,enter,2,4,431,6,31,22,1516,11972,1441,119398654,5
1831,billow,bIlo,11,9,2,5,6,billow,2,4,363,7,54,9,5,96,11,53209,5
17363,timber,tImbX,2,2,0,2,0,timber,2,5,369,7,7,8,127,2778,237,8206346,6
3114,chore,Cor,21,20,1,19,2,chore,1,3,469,6,90,9,51,685,47,565733,4
11953,operable,apXxbL,1,1,0,1,0,operable,4,7,603,6,1,0,12,75,14,529630,5
19267,yield,yild,4,4,0,4,0,yield,1,4,448,6,20,4,206,5639,427,15022494,5
780,ant,@nt,12,4,8,8,4,ant,1,3,357,4,61,47,273,1116,55,6191588,4
15725,sinus,sYn|s,2,2,0,2,0,sinus,2,5,549,6,11,7,89,941,42,1738565,6
19253,year,yIr,18,17,1,18,0,year,1,3,339,5,66,28,14174,262528,58412,451113403,4
2752,catechism,k@t|kIzM,1,0,1,0,1,catechism,4,9,680,5,0,0,15,338,14,536172,6
13798,proprietor,prxprYxtX,1,1,0,0,1,proprietor,4,9,652,11,3,1,60,543,32,1222912,10
13110,plastic,pl@stIk,1,1,0,1,0,plastic,2,7,501,8,2,2,957,14562,1271,35423760,8
5461,edge,EJ,15,10,5,7,8,edge,1,2,341,5,64,17,1199,20699,1865,41874916,3
9502,kink,kIGk,15,11,4,12,3,kink,1,4,363,5,55,25,34,98,9,566327,5
3133,chrome,krom,11,7,4,3,8,chrome,1,4,481,6,51,0,65,883,31,9330251,5
13809,prosecutor,prasIkyutX,1,0,1,0,1,prosecutor,4,10,621,11,3,1,366,5390,3180,3316544,11
9300,jaw,Jc,15,14,1,11,4,jaw,1,2,399,4,59,28,364,3227,239,2798439,3
10713,mere,mIr,31,27,4,23,8,mere,1,3,405,5,111,38,401,6561,335,7312247,4
3404,coffin,kcfxn,3,2,1,3,0,coffin,2,5,491,7,8,4,461,1946,241,1662468,6
16138,spite,spYt,15,12,3,3,12,spite,1,4,559,6,26,12,388,4079,518,4495204,5
4441,dark,dark,10,8,2,7,3,dark,1,4,382,5,38,23,4519,37730,2636,50687578,5
4888,difference,dIfXxns,1,1,0,1,0,difference,2,7,503,11,5,2,4066,30395,7828,44548015,8
4075,courtesy,kRt|si,1,0,1,0,1,courtesy,3,6,488,8,4,0,414,4995,413,10945291,7
9512,kiss,kIs,13,13,0,5,8,kiss,1,3,378,5,94,24,6179,6550,1038,14799208,4
9356,joggle,JagL,5,4,1,3,2,joggle,2,5,462,5,11,7,1,2,0,19415,4
6741,found,fWnd,14,13,1,12,2,found,1,4,489,6,24,11,20196,119500,19980,232008727,5
18764,waive,wev,21,18,3,11,10,waive,1,3,436,6,60,7,88,338,88,1789027,4
6462,fist,fIst,11,9,2,9,2,fist,1,4,599,5,54,29,375,3144,256,7324058,5
954,aquarium,xkw@rixm,1,1,0,0,1,aquarium,4,8,723,9,2,2,141,1157,149,5327865,9
2454,calibrate,k@l|bret,1,0,1,0,1,calibrate,3,8,536,10,0,1,12,167,18,633205,9
279,adopt,xdapt,2,2,0,2,0,adopt,2,5,544,6,5,3,238,4518,761,11272756,6
14084,queer,kwIr,10,9,1,2,8,queer,1,4,418,6,29,2,296,928,43,2717979,5
15913,snuffle,sn^fL,5,4,1,3,2,snuffle,2,6,560,6,3,4,0,14,0,19185,5
12752,perjure,pRJX,5,3,2,2,3,perjure,2,4,374,8,10,4,8,13,5,13874,5
17287,thought,Tct,11,9,2,9,2,thought,1,3,445,8,34,2,41232,110168,26766,81567901,4
7727,hear,hIr,30,28,2,20,10,hear,1,3,402,5,59,38,28323,51092,19209,47430050,4
2124,bracket,br@k|t,2,0,2,1,1,bracket,2,6,459,8,9,6,32,1154,150,5321561,7
16112,spider,spYdX,1,0,1,1,0,spider,2,5,552,7,19,11,515,2115,304,9442640,6
19192,wrath,r@T,17,17,0,7,10,wrath,1,3,472,6,54,3,199,923,123,2486921,4
6871,function,f^GkS|n,2,1,1,2,0,function,2,7,569,9,4,3,565,14884,1064,93882580,8
7445,groove,gruv,8,7,1,1,7,groove,1,4,458,7,25,5,212,883,88,5407849,5
17722,trim,trIm,9,8,1,4,5,trim,1,4,391,5,36,17,218,3321,160,10397657,5
17854,turkey,tRki,3,1,2,1,2,turkey,2,4,389,7,39,9,1153,11581,1467,28115923,5
9253,Italian,|t@lyxn,1,1,0,1,0,italian,3,7,529,8,3,5,194,9766,1171,39018431,8
14296,read,rid,28,25,3,18,10,read,1,3,375,5,150,31,12302,52516,12160,322346193,4
6461,fissure,fISX,3,2,1,0,3,fissure,2,4,432,8,28,2,22,195,4,427405,5
909,appliance,xplY|ns,1,0,1,1,0,appliance,3,7,688,10,1,2,41,674,80,9005645,8
14837,rind,rYnd,10,8,2,9,1,rind,1,4,318,5,46,25,14,535,29,420816,5
15231,scheme,skim,6,3,3,2,4,scheme,1,4,614,7,25,8,370,4746,608,28310172,5
15870,smooth,smuD,1,0,1,1,0,smooth,1,4,622,7,6,3,932,9574,525,18635288,5
14428,reel,ril,34,28,6,20,14,reel,1,3,341,5,192,35,166,1468,106,6688022,4
5633,empower,ImpWX,1,1,0,1,0,empower,3,5,473,8,2,1,16,939,198,1969852,6
17767,trot,trat,8,6,2,3,5,trot,1,4,479,5,26,15,92,545,37,723756,5
14438,refine,rIfYn,3,3,0,3,0,refine,2,5,583,7,5,9,22,818,54,12027198,6
17789,trump,tr^mp,2,1,1,2,0,trump,1,5,273,6,12,9,115,2798,1412,2879836,6
157,ace,es,22,12,10,14,8,ace,1,2,406,4,86,42,751,2970,120,11140861,3
1980,board,bord,16,12,4,11,5,board,1,4,342,6,82,18,3272,35565,5745,212367487,5
13677,probe,prob,5,3,2,2,3,probe,1,4,423,6,17,11,225,3100,360,9646581,5
7255,goad,god,22,18,4,15,7,goad,1,3,398,5,73,22,7,148,13,217883,4
15855,smelled,smEld,3,1,2,1,2,smelled,1,5,593,7,10,4,404,2973,150,670183,5
9355,jog,Jag,11,10,1,5,6,jog,1,3,400,4,39,25,123,655,79,1002505,4
8298,imagine,Im@J|n,1,0,1,0,1,imagine,3,6,718,8,2,3,4133,19285,5530,17370170,7
16475,stride,strYd,7,5,2,2,5,stride,1,5,517,7,20,10,107,1629,122,1546387,6
13650,print,prInt,2,1,1,1,1,print,1,5,342,6,15,12,1018,9561,1025,178257086,6
6628,fond,fand,12,9,3,9,3,fond,1,4,441,5,34,18,629,1832,233,3332153,5
101,abyss,xbIs,2,2,0,1,1,abyss,2,4,502,6,6,0,90,712,88,1152924,4
7167,gin,JIn,20,19,1,15,5,gin,1,3,418,4,111,39,575,1293,79,1962221,4
8330,imminent,Imxn|nt,1,1,0,0,1,imminent,3,7,474,9,3,1,123,1863,404,2023614,8
11165,mortally,mortLi,1,0,1,0,1,mortally,3,7,536,7,3,1,14,183,19,236264,7
7282,gone,gcn,17,14,3,9,8,gone,1,3,370,5,73,29,15135,45028,11761,34516203,4
8081,howl,hWl,15,13,2,13,2,howl,1,3,376,5,82,13,105,794,60,835214,4
17355,tights,tYts,4,3,1,1,3,tights,1,4,513,6,56,7,135,582,81,2023147,4
15383,selfish,sElfIS,1,1,0,1,0,selfish,2,6,619,8,3,1,811,1542,274,1868650,7
3160,chute,Sut,17,16,1,16,1,chute,1,3,422,6,75,7,184,757,50,834005,4
5097,ditch,dIC,16,15,1,8,8,ditch,1,3,401,6,68,13,401,1792,237,2374035,4
17765,tropic,trapIk,1,0,1,1,0,tropic,2,6,464,7,4,3,36,185,29,624139,7
8314,imitation,ImxteS|n,2,2,0,2,0,imitation,4,8,848,10,1,2,139,1302,89,1978811,6
4723,depth,dEpT,1,0,1,0,1,depth,1,4,393,6,7,2,421,7550,626,31879926,5
11504,nervous,nRvxs,3,3,0,3,0,nervous,2,5,510,8,5,0,3425,8520,2226,7908827,6
14970,ruby,rubi,3,3,0,1,2,ruby,2,4,509,5,41,15,607,2421,216,10832739,5
4148,creator,krietX,2,0,2,1,1,creator,3,6,477,8,4,1,142,2453,457,11071241,7
6546,flip,flIp,11,9,2,3,8,flip,1,4,341,5,28,11,728,3788,965,7931190,5
16293,startle,startL,1,0,1,0,1,startle,2,7,484,8,6,2,60,225,13,194954,8
9451,kayak,kY@k,3,3,0,3,0,kayak,2,4,540,6,12,3,26,667,21,2629920,5
1756,berg,bRg,13,11,2,5,8,berg,1,3,353,5,84,18,79,718,94,3115609,4
7371,grate,gret,21,18,3,9,12,grate,1,4,326,6,45,26,52,718,29,672155,5
17280,thorough,TRo,4,4,0,3,1,thorough,2,3,419,9,24,1,240,2473,397,5191306,4
3977,coroner,kcrxnX,3,3,0,0,3,coroner,3,6,396,8,15,8,458,803,319,861881,7
3298,cling,klIG,14,8,6,7,7,cling,1,4,342,6,57,13,128,878,132,946281,5
1487,bandage,b@ndIJ,1,1,0,1,0,bandage,2,6,462,8,5,6,146,500,27,605193,7
676,anal,enL,2,1,1,1,1,anal,2,4,370,5,11,14,138,676,38,59778384,4
5943,evolve,Ivalv,3,0,3,3,0,evolve,2,5,545,7,5,6,83,1837,192,2982447,6
16271,stamp,st@mp,4,3,1,3,1,stamp,1,5,488,6,13,12,302,2260,448,9760676,6
846,apart,xpart,3,1,2,3,0,apart,2,5,519,6,3,2,2398,14469,2695,16512388,6
16457,streak,strik,6,6,0,0,6,streak,1,5,548,7,24,4,295,2910,219,3268695,6
1916,blend,blEnd,7,4,3,5,2,blend,1,5,321,6,11,9,218,4052,234,9685398,6
7853,heroic,hIroIk,1,0,1,0,1,heroic,3,6,631,7,1,2,234,2008,295,1876003,7
14962,royal,rOL,3,3,0,3,0,royal,2,4,358,6,15,9,1185,8996,1709,45412059,5
15649,sick,sIk,29,23,6,18,11,sick,1,3,559,5,109,35,8437,12970,3564,15974902,4
2386,buzz,b^z,15,15,0,5,10,buzz,1,3,409,5,91,8,814,3013,728,7891304,4
1251,attest,xtEst,2,1,1,2,0,attest,2,5,605,7,4,3,22,649,53,997406,6
2550,canoe,kxnu,2,1,1,1,1,canoe,2,4,369,6,16,8,182,1416,52,3796147,5
4578,deference,dEfXxns,1,1,0,1,0,deference,2,7,540,8,4,2,19,788,91,593894,6
14463,refute,rIfyut,3,2,1,1,2,refute,2,6,418,7,2,7,34,370,74,556518,7
371,afloat,xflot,1,0,1,1,0,afloat,2,5,444,4,1,1,85,772,129,652557,4
10000,literal,lItXL,4,2,2,2,2,literal,3,6,539,8,8,4,69,1428,119,3747449,7
17787,truffle,tr^fL,4,3,1,2,2,truffle,2,6,382,8,7,2,23,280,14,537610,7
12590,pearl,pRl,21,19,2,15,6,pearl,1,3,314,6,93,12,799,3997,741,18709335,4
9843,lettuce,lEt|s,2,2,0,2,0,lettuce,2,5,501,5,12,1,173,1953,143,1772273,5
6247,fasten,f@sN,4,3,1,0,4,fasten,2,5,619,7,32,8,190,423,32,577740,6
6690,forge,forJ,9,8,1,1,8,forge,1,4,494,6,44,26,166,1340,133,5226805,5
16386,stipulation,stIpyUleS|n,1,1,0,1,0,stipulation,4,11,762,12,2,2,9,202,37,781273,12
2295,bulge,b^lJ,4,3,1,1,3,bulge,1,4,382,6,10,12,48,720,59,881613,5
12487,party,parti,5,2,3,2,3,party,2,5,472,6,38,21,11890,59449,19532,144723933,6
9836,let,lEt,30,25,5,19,11,let,1,3,446,4,105,48,123381,141994,68454,143074429,4
10482,marrow,m@ro,9,8,1,7,2,marrow,2,4,382,6,62,23,151,1021,273,2739298,5
5318,dual,duL,14,11,3,3,11,dual,1,3,319,5,109,16,57,3456,212,29539115,4
18313,van,v@n,12,11,1,11,1,van,1,3,543,4,90,41,2641,16149,3909,55156256,4
10604,meantime,mintYm,1,1,0,1,0,meantime,2,6,605,6,1,1,769,3725,1401,3570145,5
2084,both,boT,13,11,2,5,8,both,1,3,471,5,64,29,15062,161751,29164,228653057,3
2781,causal,kczL,4,2,2,0,4,causal,2,5,461,7,15,5,10,1411,30,2015266,5
16152,split,splIt,3,0,3,1,2,split,1,5,470,6,7,7,1954,9397,1725,20007659,6
19044,will,wIl,34,28,6,24,10,will,1,3,308,5,134,33,108306,501986,140565,1356315700,4
18768,walk,wck,15,14,1,12,3,walk,1,3,377,5,113,29,11009,30064,6234,39132769,4
12694,peppery,pEpXi,2,1,1,1,1,peppery,3,6,413,7,0,2,1,169,5,109013,5
14707,resume,rIzum,1,0,1,1,0,resume,2,5,528,7,3,7,290,2728,715,21107737,6
14881,robe,rob,18,15,3,6,12,robe,1,3,402,5,102,38,433,1833,125,2345968,4
15880,snack,sn@k,10,8,2,5,5,snack,1,4,534,6,29,12,466,2130,163,3847152,5
3964,corner,kornX,2,1,1,0,2,corner,2,5,509,7,46,31,2679,16905,2017,36421177,6
2917,champagne,S@mpen,1,1,0,1,0,champagne,2,6,561,10,5,1,1596,2640,334,5842565,7
7045,gazelle,gxzEl,1,1,0,0,1,gazelle,2,5,539,8,11,2,62,142,17,432190,6
15872,smote,smot,6,5,1,3,3,smote,1,4,503,5,12,3,13,41,1,279526,4
7050,geisha,geSx,1,1,0,0,1,geisha,2,4,474,5,7,0,146,239,59,1720491,4
15625,shrimp,SrImp,2,2,0,2,0,shrimp,1,5,418,7,8,2,444,4459,308,4365187,6
16930,taffy,t@fi,5,5,0,1,4,taffy,2,4,454,6,33,3,122,134,13,411033,5
10884,minstrel,mInstrL,1,0,1,1,0,minstrel,2,8,512,9,4,1,28,105,14,451279,9
6861,fully,fUli,9,7,2,8,1,fully,2,4,433,5,26,10,880,16324,2383,48617064,4
15910,snout,snWt,3,3,0,3,0,snout,1,4,528,6,7,7,43,414,10,264180,5
6467,fix,fIks,10,8,2,6,4,fix,1,4,415,4,75,23,4426,8710,2451,32352416,5
14473,regent,riJ|nt,2,0,2,1,1,regent,2,6,477,7,7,12,85,395,19,2468483,7
561,also,clso,1,1,0,0,1,also,2,4,360,5,2,11,10528,305492,61845,616838308,4
13356,positive,paz|tIv,1,0,1,1,0,positive,3,7,500,9,2,1,1613,29054,4433,56132744,8
15057,sad,s@d,25,21,4,15,10,sad,1,3,460,4,82,45,3232,9390,2701,13017058,4
2349,burn,bRn,22,18,4,13,9,burn,1,3,394,5,155,28,2816,6706,1206,13609561,4
13296,pony,poni,6,5,1,3,3,pony,2,4,330,5,42,16,413,1126,107,4769443,5
13651,prior,prYX,9,8,1,4,5,prior,2,4,431,6,45,7,422,12718,1638,62949059,5
8013,hop,hap,20,19,1,15,5,hop,1,3,327,4,105,44,977,3542,582,22935809,4
16290,stark,stark,7,5,2,2,5,stark,1,5,587,6,32,18,331,2970,443,3479265,6
8237,ideally,Ydili,3,0,3,2,1,ideally,3,5,543,6,9,0,22,1552,136,4048227,5
14382,recount,rIkWnt,2,2,0,1,1,recount,2,6,625,8,2,3,37,1626,1082,842672,7
2437,calamine,k@lxmYn,1,0,1,1,0,calamine,3,7,558,9,1,0,10,45,4,42374,8
12806,pertain,pXten,1,0,1,1,0,pertain,2,5,546,8,3,5,14,268,30,963600,6
17712,tried,trYd,16,11,5,5,11,tried,1,4,413,5,30,13,9529,42151,10198,34201786,5
11290,musician,myUzIS|n,1,1,0,1,0,musician,3,8,585,9,4,1,308,2356,648,6011315,9
10500,mascara,m@sk@rx,1,1,0,1,0,mascara,3,7,559,7,0,2,64,657,64,842185,5
11875,off,cf,12,7,5,4,8,off,1,2,374,4,56,14,60155,190390,39513,284052274,3
5221,dower,dWX,12,11,1,6,6,dower,1,3,329,6,47,23,1,38,4,187508,4
7441,groin,grOn,4,4,0,0,4,groin,1,4,365,6,21,11,92,721,59,784476,5
4389,dabble,d@bL,8,7,1,5,3,dabble,2,5,389,7,24,6,29,92,3,147951,6
2354,burp,bRp,8,7,1,1,7,burp,1,3,249,5,70,13,66,159,20,456508,4
16171,spoon,spun,11,10,1,2,9,spoon,1,4,655,6,21,10,388,3990,198,4000675,5
6163,factual,f@kCuL,1,0,1,1,0,factual,3,7,474,8,1,2,27,1214,196,3008091,8
4653,demise,dxmYz,1,1,0,1,0,demise,2,5,560,6,6,6,87,1707,187,1580466,5
10050,loath,loT,13,11,2,3,10,loath,1,3,479,6,48,7,5,316,25,158004,4
7702,having,h@vIG,2,2,0,2,0,having,2,5,402,7,12,17,14752,73176,21593,109363088,6
4042,count,kWnt,7,4,3,5,2,count,1,4,404,6,22,7,4588,13641,3448,40348176,5
1607,batman,b@tmxn,2,1,1,1,1,batman,2,6,649,4,0,16,239,1693,240,6354546,4
14094,quick,kwIk,14,11,3,4,10,quick,1,4,295,6,30,5,5542,20412,5253,85588228,5
14219,rang,r@G,21,20,1,10,11,rang,1,3,407,5,74,38,277,3106,253,1766026,4
14331,recall,rIkcl,1,1,0,0,1,recall,2,5,460,7,6,3,1003,8524,1811,12127299,6
18189,uproar,^pror,1,1,0,0,1,uproar,2,5,529,7,0,0,53,594,170,481195,4
5807,equity,Ekwxti,1,1,0,0,1,equity,3,6,459,7,3,0,67,4707,667,31158626,7
1168,assuage,xsweJ,1,0,1,1,0,assuage,2,5,511,8,1,1,6,240,29,123696,6
5342,dull,d^l,23,22,1,13,10,dull,1,3,322,5,109,26,616,3007,225,3211758,4
14927,rosy,rozi,7,4,3,5,2,rosy,2,4,497,4,55,19,169,912,128,836269,5
7248,gnash,n@S,15,14,1,10,5,gnash,1,3,487,6,53,2,5,18,5,66277,4
7288,good,gUd,12,10,2,10,2,good,1,3,284,5,28,23,133117,236132,85425,365822878,4
16839,swung,sw^G,5,4,1,3,2,swung,1,4,499,4,5,4,117,2912,115,870107,4
5885,etiquette,EtIk|t,1,0,1,1,0,etiquette,3,6,549,4,1,1,96,751,74,3872794,4
960,Arab,@rxb,3,2,1,0,3,arab,2,4,499,5,22,17,174,15774,4274,21022995,5
15125,sang,s@G,19,17,2,11,8,sang,1,3,509,5,61,44,419,3658,644,3669497,4
18710,vow,vW,14,11,3,10,4,vow,1,2,348,4,75,26,276,886,172,1127734,3
9167,inwards,InwXdz,2,0,2,1,1,inwards,2,6,523,7,4,3,6,59,4,234751,6
18191,uproot,^prut,1,1,0,0,1,uproot,2,5,457,7,4,0,18,136,15,116513,6
9726,layer,leX,16,14,2,5,11,layer,2,3,505,6,96,29,189,6661,398,26912653,4
2072,boron,boran,2,1,1,1,1,boron,2,5,728,5,15,19,8,122,3,865654,4
18737,wade,wed,24,21,3,16,8,wade,1,3,489,5,91,32,840,3968,886,4793167,4
12782,Persian,pRZ|n,1,1,0,1,0,persian,2,5,478,8,9,4,109,4568,1530,5280749,6
2756,cater,ketX,6,5,1,5,1,cater,2,4,389,6,61,29,64,578,79,2092828,5
13203,podium,podixm,2,2,0,2,0,podium,3,6,497,7,4,2,65,1355,313,1230847,7
6529,flesh,flES,7,7,0,1,6,flesh,1,4,451,6,21,6,1125,6008,335,6768724,5
7993,honor,anX,2,2,0,2,0,honor,2,3,357,6,47,6,4912,12107,2791,16788215,4
18636,vitalize,vYtxlYz,1,0,1,0,1,vitalize,3,7,645,7,1,0,0,8,0,31523,6
2060,booth,buT,12,11,1,6,6,booth,1,3,369,6,49,11,1039,3503,417,7723310,4
14677,resound,rIzWnd,2,2,0,1,1,resound,2,6,624,8,4,2,9,66,9,121342,4
15076,sail,sel,34,27,7,25,9,sail,1,3,447,5,140,38,701,2050,182,5228207,4
3837,continent,kantN|nt,1,1,0,0,1,continent,3,9,550,10,4,2,187,3467,364,5095575,10
19244,yarn,yarn,5,4,1,3,2,yarn,1,4,451,5,21,18,81,640,28,5113505,5
2513,canal,kxn@l,2,2,0,1,1,canal,2,5,560,6,4,12,326,3554,378,8279384,6
9716,lavish,l@vIS,1,1,0,1,0,lavish,2,5,518,7,3,4,39,1146,143,885755,6
11444,nebula,nEbyUlx,1,0,1,0,1,nebula,3,7,639,7,2,3,75,1339,13,1294884,8
17566,tractor,tr@ktX,1,0,1,0,1,tractor,2,6,416,8,7,6,190,1400,152,5098075,7
13108,plasma,pl@zmx,1,0,1,0,1,plasma,2,6,522,6,1,0,254,1564,76,19335038,6
15775,slalom,slalxm,1,0,1,1,0,slalom,2,6,530,4,1,1,3,405,19,766679,4
5966,excess,EksEs,1,1,0,1,0,excess,2,5,608,7,3,1,156,4579,493,17152900,6
3377,cocky,kaki,11,9,2,5,6,cocky,2,4,391,5,62,6,210,472,63,364425,5
2087,bottom,batM,2,1,1,0,2,bottom,2,5,307,7,12,2,2546,23684,4381,45599059,6
11839,occasion,xkeZ|n,1,0,1,0,1,occasion,3,6,542,9,2,1,844,5242,771,11854911,7
16607,subtly,s^tli,1,0,1,1,0,subtly,3,6,552,6,6,1,22,1006,45,634021,6
18910,whack,hw@k,3,2,1,3,0,whack,1,3,370,6,99,8,455,654,146,725891,4
10078,lodge,laJ,10,8,2,3,7,lodge,1,3,472,6,46,12,341,2939,206,21541414,4
6394,fight,fYt,24,21,3,18,6,fight,1,3,381,6,83,15,10255,27491,9379,30788957,4
18884,weeny,wini,5,4,1,3,2,weeny,2,4,398,4,53,6,8,21,6,58568,4
14259,ratio,reSo,1,1,0,0,1,ratio,3,5,536,6,2,7,164,5065,213,26458226,6
10658,mellow,mElo,10,10,0,6,4,mellow,2,4,430,7,53,9,153,667,77,1239234,5
10212,lyric,lIrxk,1,0,1,0,1,lyric,2,5,423,6,23,3,56,849,116,6970569,6
3283,clerical,klErIkL,1,0,1,0,1,clerical,3,8,598,7,1,0,50,825,67,3586609,6
19051,wilt,wIlt,14,10,4,10,4,wilt,1,4,306,5,54,25,93,517,60,1267600,5
17306,throat,Trot,6,4,2,2,4,throat,1,4,403,7,18,4,1837,8165,841,14353822,5
10147,loyal,lOL,3,3,0,1,2,loyal,2,4,341,6,12,7,612,3117,657,4499155,5
14577,renovate,rEnxvet,1,0,1,0,1,renovate,3,7,538,9,1,1,13,340,42,585494,8
12754,perk,pRk,22,20,2,16,6,perk,1,3,326,5,97,27,72,402,39,393721,4
17385,tinkle,tIGkL,7,5,2,3,4,tinkle,2,6,391,7,21,12,47,109,10,104907,7
307,adverse,@dvRs,2,2,0,0,2,adverse,2,5,542,8,5,1,36,2279,210,11157534,6
9359,joint,JOnt,5,4,1,3,2,joint,1,4,427,6,16,6,1405,10852,1933,38828945,5
11601,nod,nad,20,15,5,12,8,nod,1,3,459,4,68,27,203,2867,181,2193669,4
7789,helm,hElm,10,6,4,3,7,helm,1,4,360,5,31,17,273,1236,107,1960083,5
3384,code,kod,28,23,5,16,12,code,1,3,374,5,105,33,2709,12359,2018,250250908,4
17568,trader,tredX,2,1,1,0,2,trader,2,5,396,7,27,17,80,1098,223,6166980,6
15890,sneak,snik,7,5,2,3,4,sneak,1,4,475,6,23,5,861,1882,424,2281170,5
5353,dump,d^mp,13,10,3,9,4,dump,1,4,278,5,25,16,1470,2668,600,6945921,5
15386,selves,sElvz,2,1,1,2,0,selves,1,5,628,6,19,9,62,895,52,1023898,5
11301,muss,m^s,25,21,4,13,12,muss,1,3,486,5,83,31,31,53,11,416545,4
1598,bat,b@t,40,33,7,25,15,bat,1,3,384,4,101,54,1052,4169,567,7734454,4
13443,prairie,prEri,1,0,1,0,1,prairie,2,5,470,8,12,1,143,2809,190,8844038,6
12167,overawe,ovXc,3,1,2,0,3,overawe,3,4,579,6,9,1,1,12,0,10252,5
10114,loosen,lusN,4,2,2,2,2,loosen,2,5,417,7,40,7,282,1099,123,819463,6
3225,clad,kl@d,13,11,2,4,9,clad,1,4,382,5,40,15,10,1638,65,2247938,5
6747,fountain,fWntN,2,1,1,1,1,fountain,2,6,597,9,5,3,352,2122,162,6932499,7
918,appoint,xpOnt,3,1,2,2,1,appoint,2,5,573,8,8,1,104,1052,416,3696615,6
2906,chalk,Cck,13,12,1,13,0,chalk,1,3,409,6,80,3,183,1145,75,2498717,4
17259,thigh,TY,19,18,1,17,2,thigh,1,2,472,6,89,2,191,2155,118,2171743,3
6775,fraud,frcd,4,4,0,1,3,fraud,1,4,517,6,23,6,512,5377,1743,15378751,5
11994,orate,oret,9,7,2,8,1,orate,2,4,440,5,16,8,2,12,1,31700,4
9725,lay,le,35,20,15,20,15,lay,1,2,412,4,165,58,2970,17528,2145,16125669,3
2534,cane,ken,33,30,3,24,9,cane,1,3,383,5,192,47,425,2584,181,3494916,4
18167,upend,^pEnd,2,2,0,2,0,upend,2,5,440,3,7,1,1,71,6,36879,6
15259,score,skor,14,10,4,7,7,score,1,4,489,6,34,16,1552,13504,983,69317191,5
15124,sane,sen,33,27,6,24,9,sane,1,3,435,5,140,44,281,916,145,1939156,4
8526,incessant,InsEsNt,1,0,1,0,1,incessant,3,8,619,10,0,0,23,386,19,391925,9
16096,spell,spEl,9,8,1,3,6,spell,1,4,468,6,31,12,1869,3139,476,8508070,5
15618,shrew,Sru,9,6,3,7,2,shrew,1,3,416,6,46,6,42,130,5,382770,4
8328,immigrate,Imxgret,1,1,0,1,0,immigrate,3,7,568,10,2,1,5,112,14,152356,8
13779,propeller,prxpElX,1,0,1,0,1,propeller,3,7,678,10,4,2,78,405,32,1075824,8
4273,cubic,kyubIk,1,0,1,0,1,cubic,2,6,478,6,11,5,44,1708,40,5775965,7
1281,audition,cdIS|n,2,2,0,2,0,audition,3,6,575,9,3,2,705,945,307,2134610,7
1514,bantam,b@ntxm,1,1,0,1,0,bantam,2,6,469,7,7,3,4,251,19,1276580,7
9853,lever,lEvX,13,11,2,6,7,lever,2,4,471,6,52,29,163,1241,92,3566558,5
19142,wood,wUd,15,13,2,11,4,wood,1,3,289,5,30,17,1377,17037,1029,51133768,4
4583,defile,dIfYl,2,1,1,0,2,defile,2,5,527,6,5,2,17,70,5,154945,5
17410,titillate,tItxlet,1,1,0,0,1,titillate,3,7,446,10,0,1,8,27,5,33077,8
18978,whisker,hwIskX,4,2,2,0,4,whisker,2,5,376,8,23,14,13,99,4,247102,6
1118,aside,xsYd,5,4,1,3,2,aside,2,4,579,6,12,4,1212,14221,2205,11769721,5
17217,theology,TialxJi,1,1,0,1,0,theology,4,7,599,8,1,1,36,5643,170,6464165,4
6362,fever,fivX,4,4,0,2,2,fever,2,4,458,6,37,18,1017,3416,439,8583242,5
4439,dare,dEr,26,24,2,17,9,dare,1,3,419,5,131,41,2826,3393,579,6534911,4
15598,shore,Sor,28,23,5,21,7,shore,1,3,483,6,124,26,1013,6645,841,12569355,4
14611,repository,rIpaz|tori,1,1,0,1,0,repository,5,10,839,10,1,1,13,670,75,8893330,11
124,accidental,@ksxdEntL,1,1,0,1,0,accidental,4,10,770,11,3,2,153,1552,293,3914534,11
15663,sigh,sY,35,24,11,17,18,sigh,1,2,549,5,145,12,173,2674,154,3177268,3
11881,offering,cfXIG,1,0,1,1,0,offering,2,5,533,9,4,2,777,11017,1456,34799901,6
11904,old,old,11,1,10,10,1,old,1,3,393,4,53,25,31056,158200,32125,199709349,4
18888,weird,wIrd,5,5,0,2,3,weird,1,4,479,6,31,4,5156,5260,1520,11561592,5
9644,language,l@GgwIJ,1,1,0,0,1,language,2,7,495,9,2,2,1790,37870,4639,138523112,8
15692,similar,sImLX,2,1,1,0,2,similar,3,6,470,8,8,1,695,35679,3641,119151349,7
3210,cite,sYt,28,24,4,22,6,cite,1,3,468,5,91,19,48,1742,255,7047997,4
11762,nuts,n^ts,2,1,1,0,2,nuts,1,4,432,5,57,20,2729,4744,734,9057533,5
12192,overly,ovXli,3,1,2,0,3,overly,3,5,514,7,12,8,113,2278,306,2372522,5
15623,shrill,SrIl,8,5,3,7,1,shrill,1,4,559,7,19,2,24,632,50,374686,5
6961,gallop,g@lxp,2,2,0,2,0,gallop,2,5,409,7,9,6,48,362,34,451480,6
3446,collective,kxlEktIv,1,0,1,1,0,collective,3,8,738,11,4,1,122,7178,630,12279562,9
15415,sense,sEns,13,11,2,7,6,sense,1,4,480,6,39,13,6722,61151,15737,52634107,5
14190,rainy,reni,6,5,1,3,3,rainy,2,4,366,5,84,7,194,1432,203,2469088,5
9376,journey,JRni,4,4,0,2,2,journey,2,4,438,8,54,3,1017,8587,1422,19236654,5
2001,body,badi,11,11,0,7,4,body,2,4,332,5,50,21,9972,67552,9218,136568103,5
2614,car,kar,24,18,6,12,12,car,1,3,339,4,162,60,24636,60316,12604,264728586,4
6581,fluff,fl^f,5,4,1,2,3,fluff,1,4,429,6,16,6,72,449,34,814535,5
3731,conic,kanIk,6,5,1,6,0,conic,2,5,420,6,22,12,3,37,1,224114,6
16480,string,strIG,7,4,3,1,6,string,1,5,718,7,23,13,646,5584,650,52684205,6
1976,blush,bl^S,7,6,1,5,2,blush,1,4,409,6,14,10,136,1104,103,1722003,5
1011,arena,xrinx,1,0,1,1,0,arena,3,4,421,6,47,20,185,5102,662,13966787,5
3006,cheeky,Ciki,1,0,1,0,1,cheeky,2,4,400,6,17,5,64,173,25,895925,4
11530,never,nEvX,4,3,1,3,1,never,2,4,393,6,17,23,69490,160644,39746,149574220,5
16631,sudden,s^dN,3,3,0,2,1,sudden,2,5,371,7,22,7,1707,10030,2581,6982656,6
9115,inure,InyUr,2,2,0,2,0,inure,2,5,330,6,5,3,1,10,4,123230,6
16827,swish,swIS,9,8,1,2,7,swish,1,4,516,6,15,3,82,269,12,949706,5
17982,unction,^GkS|n,2,0,2,2,0,unction,2,6,577,5,2,2,8,15,0,93850,4
16261,stale,stel,17,14,3,4,13,stale,1,4,388,6,50,21,149,949,44,1065657,5
3238,clank,kl@Gk,9,6,3,6,3,clank,1,5,446,6,21,12,16,133,2,272419,6
11438,nearby,nIrbY,1,1,0,1,0,nearby,2,5,523,5,1,4,425,13040,1291,27263100,4
6997,garb,garb,4,2,2,1,3,garb,1,4,394,5,28,26,16,469,37,614648,5
12582,peace,pis,19,17,2,10,9,peace,1,3,366,6,118,12,3550,27233,8620,47876863,4
16317,stead,stEd,11,9,2,3,8,stead,1,4,559,6,41,9,54,302,27,724786,5
5783,equal,ikwL,2,0,2,1,1,equal,2,5,579,6,6,2,682,12810,1887,34834012,6
4738,derogate,dErxget,1,1,0,1,0,derogate,3,7,452,8,1,0,0,8,0,53267,5
15686,silly,sIli,12,11,1,7,5,silly,2,4,455,5,117,16,2912,3990,900,6837784,5
10862,miner,mYnX,9,8,1,4,5,miner,2,4,448,6,74,46,74,867,223,2265353,5
3493,combo,kambo,1,1,0,1,0,combo,2,5,500,5,7,10,125,728,47,10594360,5
16492,strode,strod,4,4,0,0,4,strode,1,5,460,7,18,9,34,1093,10,324522,6
8477,impunity,Impyun|ti,1,0,1,1,0,impunity,4,9,646,5,1,3,18,508,90,666112,8
14902,roman,romxn,4,3,1,4,0,roman,2,5,388,6,87,41,534,6643,545,17434592,6
11267,mummy,m^mi,8,7,1,4,4,mummy,2,4,539,6,43,12,500,684,26,1878933,5
11503,nerve,nRv,6,5,1,5,1,nerve,1,3,419,6,27,8,1171,4198,612,6567853,4
14071,quart,kwort,9,3,6,4,5,quart,1,5,539,6,16,7,106,1328,23,2002490,6
2845,cent,sEnt,22,16,6,13,9,cent,1,4,503,5,68,22,483,3031,250,30837557,5
14308,really,rili,4,3,1,2,2,really,2,4,349,6,110,6,76508,175972,98022,162055598,5
8353,immutability,ImyutxbIl|ti,1,0,1,1,0,immutability,6,12,775,8,0,0,1,21,1,50218,8
16137,spit,spIt,16,11,5,4,12,spit,1,4,489,5,27,17,987,2006,230,2072889,5
6576,flower,flWX,5,5,0,1,4,flower,2,4,529,7,24,10,1161,5237,345,33373457,5
6476,fizzle,fIzL,6,4,2,3,3,fizzle,2,5,559,7,26,3,10,124,17,177487,6
11792,object,abJEkt,1,1,0,1,0,object,2,6,541,7,3,3,1314,11486,978,69823836,7
15612,shower,SWX,6,6,0,5,1,shower,2,3,423,7,55,9,2097,5249,692,20639456,4
8642,indication,IndxkeS|n,2,0,2,2,0,indication,4,9,690,11,4,2,181,3996,1307,6667902,10
1766,besiege,bIsiJ,1,1,0,0,1,besiege,2,5,534,8,3,1,14,35,1,57717,6
2238,brook,brUk,6,4,2,3,3,brook,1,4,259,6,30,10,104,1464,121,6044943,5
13663,privacy,prYvxsi,1,1,0,1,0,privacy,3,7,603,7,2,1,774,6188,1401,333277179,8
13232,police,pxlis,1,1,0,1,0,police,2,5,514,7,7,7,12044,56379,24327,64199830,6
16523,study,st^di,6,4,2,2,4,study,2,5,549,6,18,5,2501,90030,5262,152983170,6
2276,budge,b^J,15,14,1,4,11,budge,1,3,348,6,43,16,104,583,86,418361,4
5258,drawl,drcl,9,8,1,4,5,drawl,1,4,422,6,29,7,4,343,10,113170,5
4955,dirt,dRt,15,15,0,12,3,dirt,1,3,297,5,56,14,1310,7616,668,8196433,4
15075,said,sEd,21,17,4,16,5,said,1,3,519,5,84,31,56531,567945,105049,315601361,4
19277,young,y^G,7,7,0,7,0,young,1,3,373,6,35,8,12402,88434,17701,136350267,4
10124,lose,luz,17,14,3,9,8,lose,1,3,499,5,145,47,8382,21791,6458,24140555,4
13643,primp,prImp,5,3,2,3,2,primp,1,5,379,5,9,7,6,29,1,60629,5
8890,inseparable,InsEpXxbL,1,1,0,1,0,inseparable,5,10,642,11,0,1,51,624,51,473993,9
14801,rice,rYs,23,18,5,13,10,rice,1,3,589,5,114,32,769,13060,1917,21189704,4
16143,splay,sple,4,1,3,2,2,splay,1,4,447,5,8,5,4,65,3,130292,5
12575,pay,pe,33,20,13,17,16,pay,1,2,292,4,147,47,12985,51421,14803,129203391,3
16719,supper,s^pX,7,4,3,2,5,supper,2,4,497,7,24,8,988,2325,104,2709558,5
9169,iodide,Y|dYd,1,1,0,0,1,iodide,3,5,534,7,4,4,9,79,20,446635,6
5507,elastic,xl@stIk,1,1,0,1,0,elastic,3,7,542,8,1,1,53,976,34,4267174,6
14813,ridge,rIJ,14,13,1,3,11,ridge,1,3,449,6,47,11,361,5596,506,15996151,4
5131,dock,dak,22,21,1,16,6,dock,1,3,354,5,126,20,497,2769,241,6018421,4
2300,bulletin,bUl|tN,1,0,1,0,1,bulletin,3,7,657,9,2,1,183,2136,239,21744475,5
1138,aspire,xspYr,1,0,1,1,0,aspire,2,5,623,7,2,3,55,668,69,2640620,6
18568,vindication,vIndxkeS|n,2,1,1,2,0,vindication,4,10,968,9,1,1,22,348,100,273973,8
3294,climatic,klYm@tIk,1,0,1,0,1,climatic,3,8,633,7,1,1,7,573,20,1559502,6
4065,couple,k^pL,4,3,1,1,3,couple,2,5,371,7,27,6,11394,41876,15374,43578666,6
8732,inferior,InfIriX,1,1,0,1,0,inferior,4,7,655,9,1,1,156,1610,109,2546617,7
18502,viable,vYxbL,2,1,1,2,0,viable,3,6,421,5,1,1,121,3249,525,4802961,5
4272,cube,kyub,2,1,1,0,2,cube,1,4,379,5,30,20,152,1245,95,7203665,5
13431,pox,paks,7,5,2,5,2,pox,1,4,549,3,66,27,75,249,46,614286,4
16987,taps,t@ps,7,4,3,5,2,taps,1,4,446,5,42,29,130,994,111,2690265,5
17345,tide,tYd,22,17,5,10,12,tide,1,3,429,5,79,24,375,3350,450,6706726,4
13298,pool,pul,18,16,2,17,1,pool,1,3,409,5,94,20,2396,12198,1548,53058254,4
11508,net,nEt,26,23,3,20,6,net,1,3,473,4,91,50,793,10909,1287,116889743,4
15569,shift,SIft,6,5,1,6,0,shift,1,4,513,6,23,10,1164,12842,1531,19814829,5
15819,slippery,slIpXi,1,0,1,0,1,slippery,3,6,498,8,3,2,225,1494,177,1775430,6
8894,inset,InsEt,6,4,2,1,5,inset,2,5,472,6,13,10,1,606,26,1164467,6
10335,mall,mcl,24,20,4,20,4,mall,1,3,374,5,114,39,964,4610,786,15177039,4
13805,proscribe,proskrYb,1,1,0,1,0,proscribe,2,8,649,10,4,4,2,31,0,58912,9
15836,slug,sl^g,10,9,1,4,6,slug,1,4,518,5,19,13,253,711,55,1663224,5
9378,jovial,JoviL,1,0,1,0,1,jovial,3,6,529,6,1,1,11,220,29,189613,6
2503,campaign,k@mpen,1,1,0,1,0,campaign,2,6,612,9,8,2,856,39605,18551,37151240,7
6755,fragile,fr@JL,1,1,0,0,1,fragile,2,6,498,7,2,1,262,3269,440,2852127,4
14262,rational,r@SNL,1,0,1,1,0,rational,3,7,489,9,6,3,256,3604,462,6946351,8
1203,at,@t,31,12,19,23,8,at,1,2,320,3,85,73,164072,1238967,247370,2272272772,3
15530,shape,Sep,16,15,1,10,6,shape,1,3,382,6,60,19,1542,17600,2304,25676543,4
17560,track,tr@k,10,7,3,3,7,track,1,4,356,6,41,18,2843,19368,3641,112389630,5
1111,ash,@S,17,6,11,10,7,ash,1,2,439,4,59,33,469,3155,250,8948202,3
2140,branch,br@nC,5,3,2,3,2,branch,1,5,529,7,18,9,514,7650,982,36712567,6
6586,flung,fl^G,8,6,2,3,5,flung,1,4,460,5,14,6,44,1740,69,841446,5
1792,bible,bYbL,6,6,0,6,0,bible,2,5,497,6,34,10,935,7146,1207,45083951,6
2056,boon,bun,22,21,1,16,6,boon,1,3,559,5,112,37,108,716,78,1193882,4
10047,loaf,lof,16,14,2,6,10,loaf,1,3,425,5,51,7,228,1330,112,1599779,4
6431,find,fYnd,12,11,1,10,2,find,1,4,581,5,39,24,42379,107011,27292,502051487,5
13522,prefer,prIfR,1,0,1,1,0,prefer,2,5,483,7,9,6,1679,7128,993,16005656,6
14890,rodeo,rodio,1,1,0,1,0,rodeo,3,5,389,6,15,6,283,1012,97,3587192,6
1259,attraction,xtr@kS|n,1,0,1,1,0,attraction,3,8,551,11,2,1,348,2927,401,11998068,9
1755,beret,bXe,2,1,1,1,1,beret,2,5,428,6,41,21,48,363,58,330199,6
4821,devise,dxvYz,5,4,1,1,4,devise,2,5,708,7,6,11,32,896,60,1333890,6
3305,clique,klik,13,12,1,4,9,clique,1,4,351,7,40,1,39,240,32,836149,4
14321,rebel,rEbL,7,6,1,5,2,rebel,2,5,370,6,44,21,273,2753,701,6534099,6
2122,brace,bres,13,10,3,5,8,brace,1,4,489,6,47,25,319,1218,185,2182960,5
3928,cop,kap,30,24,6,18,12,cop,1,3,312,4,129,50,4393,5614,1152,5586148,4
16025,sour,sWr,10,7,3,7,3,sour,2,3,589,5,57,32,297,3302,309,3759025,4
2406,cache,k@S,25,19,6,12,13,cache,2,4,467,6,14,10,31,2053,59,17258521,5
16357,stew,stu,13,5,8,5,8,stew,1,3,428,5,41,17,328,1471,95,1716385,4
16552,sub,s^b,17,15,2,11,6,sub,1,3,398,4,44,31,390,3923,333,47600191,4
6043,expedition,EkspxdIS|n,1,1,0,0,1,expedition,4,10,637,11,3,1,289,2565,191,4830835,11
15770,slack,sl@k,19,17,2,9,10,slack,1,4,505,6,37,15,302,1465,197,1954286,5
1407,babble,b@bL,12,12,0,8,4,babble,2,5,390,7,22,7,44,290,21,705693,6
1547,barker,barkX,3,2,1,0,3,barker,2,5,375,7,27,19,149,897,110,3096553,6
3215,citrus,sItr|s,1,0,1,1,0,citrus,2,6,519,7,4,1,26,1319,116,3955640,7
11856,octave,aktIv,1,1,0,1,0,octave,2,5,482,7,2,2,14,283,9,2180280,6
15950,solace,salxs,1,1,0,0,1,solace,2,5,621,7,9,1,78,741,94,620953,5
14466,regal,rigL,6,4,2,4,2,regal,2,5,379,6,50,9,58,747,62,2236787,6
541,alms,amz,2,2,0,1,1,alms,1,4,494,4,17,25,25,188,3,407901,4
13331,port,port,18,13,5,9,9,port,1,4,324,5,53,32,741,8260,1363,78056223,5
16219,square,skwEr,3,1,2,1,2,square,1,5,529,7,6,3,1620,20747,2352,44788646,6
2580,caper,kepX,9,8,1,6,3,caper,2,4,333,6,48,19,90,213,17,485193,5
6491,flair,flEr,10,8,2,4,6,flair,1,4,541,5,40,9,116,709,47,1925510,5
9982,lipstick,lIpstIk,1,1,0,1,0,lipstick,2,7,539,9,2,2,449,1643,161,2166486,8
12435,park,park,18,12,6,9,9,park,1,4,369,5,52,29,3678,42050,3560,141555213,5
17731,tripe,trYp,15,11,4,4,11,tripe,1,4,230,5,29,17,41,73,4,220021,5
15151,sat,s@t,32,28,4,24,8,sat,1,3,461,4,82,57,1459,29649,2703,70649302,4
6826,from,fr^m,5,4,1,4,1,from,1,4,486,5,32,15,103992,1043919,200634,2275621616,5
2643,care,kEr,23,19,4,18,5,care,1,3,347,5,143,62,24748,91854,24156,225351564,4
16310,stature,st@CX,3,3,0,0,3,stature,2,5,698,6,9,2,85,1391,253,995928,5
12418,pardon,pardN,3,2,1,1,2,pardon,2,6,466,7,18,14,3297,1841,721,1963040,7
4140,craze,krez,11,9,2,5,6,craze,1,4,539,6,81,11,52,590,85,967820,5
10032,lively,lYvli,1,1,0,1,0,lively,2,5,474,6,9,7,207,2116,162,3635880,6
6509,flat,fl@t,15,13,2,3,12,flat,1,4,450,5,42,23,1337,13571,1332,46695552,5
6780,freak,frik,7,5,2,4,3,freak,1,4,526,6,51,10,1874,1579,277,3921675,5
7942,hoax,hoks,4,4,0,2,2,hoax,1,4,497,5,50,5,123,596,218,1309028,5
7819,her,hR,22,14,8,7,15,her,1,2,389,4,150,49,144627,835418,117168,391980169,3
15132,sanity,s@n|ti,1,1,0,1,0,sanity,3,6,563,6,4,3,139,800,116,1879220,6
14704,restrict,rIstrIkt,1,1,0,1,0,restrict,2,8,471,9,1,1,28,1765,260,5544351,9
533,allure,xlUr,4,3,1,4,0,allure,2,4,539,7,10,2,30,698,57,1292131,5
16013,sorrow,saro,3,3,0,2,1,sorrow,2,4,524,7,51,7,350,1636,221,2723156,5
115,accept,@ksEpt,2,2,0,1,1,accept,2,6,684,7,3,3,2692,15060,3744,43171429,7
1098,as,@z,13,9,4,7,6,as,1,2,407,3,85,77,113068,1515436,251899,2247431740,3
11752,nurse,nRs,10,10,0,9,1,nurse,1,3,434,6,55,10,2294,8146,1138,16773004,4
16221,squat,skwat,6,4,2,1,5,squat,1,5,484,6,10,2,160,1151,43,925062,6
13204,poem,poxm,1,1,0,0,1,poem,2,4,499,5,6,7,696,4733,603,8910539,5
4987,discomfort,dIsk^mfXt,1,1,0,0,1,discomfort,3,9,682,8,0,0,81,2030,167,2041894,8
3947,coral,kcrL,9,7,2,7,2,coral,2,5,318,6,80,17,121,2371,168,8819801,6
7132,gesture,JEsCX,1,1,0,1,0,gesture,2,5,548,8,6,3,379,3926,384,2211952,6
16231,squid,skwId,4,2,2,1,3,squid,1,5,449,5,4,2,141,835,76,3831988,5
5784,equality,ikwal|ti,1,0,1,1,0,equality,4,8,529,7,1,1,97,3590,370,8778339,4
12938,physics,fIzIks,2,1,1,0,2,physics,2,6,668,8,1,1,482,6003,360,29726685,6
19313,zip,zIp,14,13,1,12,2,zip,1,3,446,4,52,23,389,1981,232,70559906,4
5788,equally,ikwLi,1,0,1,0,1,equally,3,6,517,6,3,0,274,8824,845,10603542,6
13100,plank,pl@Gk,7,5,2,6,1,plank,1,5,430,6,14,15,104,947,115,1265284,6
2476,calorie,k@lXi,3,3,0,3,0,calorie,3,5,589,8,22,2,12,1494,182,2667892,6
11878,offense,xfEns,3,1,2,2,1,offense,2,5,513,8,2,1,840,6029,687,8249726,6
6260,father,faDX,6,5,1,5,1,father,2,4,418,7,15,14,28279,80659,15116,48581480,5
9417,junk,J^Gk,9,8,1,8,1,junk,1,4,411,5,33,17,784,3075,613,6476245,5
18293,valid,v@lxd,5,5,0,4,1,valid,2,5,399,6,7,7,164,3736,547,57099840,6
15156,sate,set,36,26,10,25,11,sate,1,3,504,5,92,38,4,94,15,241366,4
16779,swab,swab,10,8,2,3,7,swab,1,4,581,5,21,13,121,315,54,420847,5
17894,twinkle,twIGkL,2,0,2,2,0,twinkle,2,7,390,8,6,6,157,487,52,815215,8
9012,interior,IntIriX,2,2,0,2,0,interior,4,7,549,9,3,3,267,8758,756,26708813,8
17755,trod,trad,7,5,2,2,5,trod,1,4,449,5,19,8,23,196,7,182743,5
5856,espy,IspY,1,0,1,1,0,espy,2,4,562,5,20,4,2,165,29,144113,5
8985,intense,IntEns,3,3,0,1,2,intense,2,6,543,8,6,2,520,9021,1448,8204888,7
15390,semen,simxn,4,4,0,4,0,semen,2,5,424,6,72,10,201,377,100,1553516,6
13783,property,prapXti,1,0,1,0,1,property,3,7,498,9,3,1,1698,19770,2394,191785541,8
16192,sprint,sprInt,2,1,1,2,0,sprint,1,6,487,7,5,5,36,1547,101,7782311,7
16110,spice,spYs,9,6,3,2,7,spice,1,4,538,6,24,16,270,1765,188,7127714,5
18345,variety,vXYxti,1,1,0,0,1,variety,4,6,589,7,1,1,294,18339,1426,49844591,7
15650,sicken,sIk|n,1,1,0,1,0,sicken,2,5,444,7,28,8,19,56,2,54917,6
2079,boss,bcs,11,11,0,7,4,boss,1,3,395,5,88,47,6339,8232,1624,14442463,4
15204,scandal,sk@ndL,2,0,2,2,0,scandal,2,7,544,8,6,2,414,5146,2310,4315093,8
12607,pedal,pEdL,8,8,0,5,3,pedal,2,5,449,6,37,5,104,1413,96,3763705,6
18481,vessel,vEsL,6,5,1,4,2,vessel,2,5,502,7,24,15,477,3493,310,8794883,6
17661,treadle,trEdL,3,2,1,0,3,treadle,2,6,356,6,16,0,0,35,4,81512,6
13847,proud,prWd,7,6,1,2,5,proud,1,4,377,6,21,2,4265,10752,3382,17169250,5
2844,census,sEns|s,1,1,0,1,0,census,2,6,629,7,1,0,70,4379,574,25385152,7
17556,toy,tO,12,10,2,4,8,toy,1,2,326,4,73,44,859,4278,590,26931464,3
12414,parcel,parsL,3,2,1,0,3,parcel,2,6,414,7,12,3,71,1023,120,6257270,7
446,akin,xkIn,2,1,1,2,0,akin,2,4,395,5,20,20,14,1480,154,1714256,5
7968,holy,holi,8,6,2,4,4,holy,2,4,558,5,95,16,3475,8768,1118,23693122,5
7646,happy,h@pi,3,2,1,1,2,happy,2,4,407,5,31,6,16993,31050,10550,63507173,5
3266,clean,klin,11,8,3,6,5,clean,1,4,374,6,67,11,6183,21825,3760,45385208,5
18912,whaler,hwelX,1,0,1,0,1,whaler,2,4,375,7,75,13,20,106,1,305342,5
7647,harangue,hX@G,2,1,1,1,1,harangue,2,4,463,9,11,2,4,107,16,62839,5
13760,promoter,prxmotX,1,0,1,0,1,promoter,3,7,589,9,3,5,51,656,94,3416706,8
8318,immaterial,ImxtIriL,1,0,1,1,0,immaterial,5,9,630,6,1,0,45,214,22,459140,5
18950,whiff,hwIf,7,7,0,0,7,whiff,1,3,338,6,67,2,127,665,42,249083,4
7990,honey,h^ni,9,8,1,5,4,honey,2,4,305,6,57,29,15325,7288,1030,9983411,5
10764,meter,mitX,11,8,3,8,3,meter,2,4,599,6,68,26,317,4244,389,22874915,5
5378,dusk,d^sk,9,8,1,6,3,dusk,1,4,378,5,29,17,61,1927,84,1902302,5
15327,season,sizN,3,2,1,1,2,season,2,5,474,7,24,11,1605,48653,4726,76447399,6
18664,vocation,vokeS|n,3,2,1,3,0,vocation,3,7,604,9,4,5,42,838,31,935670,8
5644,enamel,In@mL,1,1,0,0,1,enamel,3,6,451,7,3,1,29,631,19,2510773,7
1869,bitten,bItN,10,8,2,7,3,bitten,2,5,539,7,58,11,188,846,134,821475,5
10219,macaw,mxkc,1,1,0,0,1,macaw,2,4,520,6,25,5,12,99,4,262324,5
18298,valley,v@li,11,10,1,9,2,valley,2,4,382,7,63,22,1275,16110,1367,61698110,5
186,acre,ekX,3,1,2,2,1,acre,2,3,558,5,55,17,93,4231,260,6661571,4
5498,eighty,eti,4,1,3,1,3,eighty,2,3,389,7,66,11,129,3390,783,2385976,4
12898,phoneme,fonim,1,0,1,0,1,phoneme,2,5,485,8,5,2,0,270,4,236822,6
15022,rusk,r^sk,8,7,1,6,2,rusk,1,4,379,5,35,16,24,194,47,489388,5
11890,offing,cfIG,3,2,1,2,1,offing,2,4,497,5,7,2,16,208,30,154728,4
5917,evasion,IveZ|n,1,0,1,1,0,evasion,3,6,538,8,2,2,59,528,115,932025,7
17706,trickle,trIkL,7,5,2,5,2,trickle,2,6,449,8,15,6,16,1185,244,716225,7
1284,auditory,cd|tori,1,0,1,1,0,auditory,4,7,540,8,2,2,27,1447,40,1706299,8
18894,well,wEl,31,22,9,20,11,well,1,3,391,5,131,36,152523,350260,173958,362103243,4
16989,tar,tar,20,16,4,15,5,tar,1,3,398,4,101,53,160,1560,139,6820909,4
10554,matrimonial,m@trxmoniL,2,1,1,1,1,matrimonial,5,11,772,9,1,2,15,131,20,977357,10
16433,straight,stret,8,4,4,1,7,straight,1,5,467,9,22,2,6244,22886,4628,32554215,6
7525,gut,g^t,24,20,4,17,7,gut,1,3,384,4,66,28,497,2991,585,2982775,4
12088,ounce,Wns,3,0,3,3,0,ounce,1,3,449,6,10,12,206,3693,215,3268355,4
1121,ask,@sk,8,3,5,5,3,ask,1,3,409,4,34,20,24640,57880,23076,106411449,4
12557,patron,petrxn,1,1,0,1,0,patron,2,6,499,7,5,10,158,1531,141,2892996,7
1268,auction,ckS|n,2,2,0,2,0,auction,2,5,439,8,7,4,454,2976,461,44619724,6
19273,yokel,yokL,4,3,1,2,2,yokel,2,5,459,6,0,6,16,25,2,58740,6
15580,ship,SIp,19,19,0,15,4,ship,1,3,397,5,84,24,5043,15354,2201,60651686,4
14594,repent,rIpEnt,2,2,0,2,0,repent,2,6,477,7,3,8,123,225,37,824802,7
6172,fail,fel,37,33,4,28,9,fail,1,3,440,5,135,33,1254,7954,1458,30146568,4
2252,bruise,bruz,10,8,2,3,7,bruise,1,4,447,7,68,6,165,531,74,388443,5
2826,cello,CElo,5,5,0,5,0,cello,2,4,416,6,23,19,95,589,68,2358848,5
7668,harp,harp,10,8,2,2,8,harp,1,4,301,5,44,30,134,615,83,2550236,5
428,aground,xgrWnd,2,0,2,2,0,aground,2,6,517,5,1,3,25,229,30,166844,4
14604,replete,rIplit,2,1,1,1,1,replete,2,6,475,6,1,1,8,525,26,405157,5
1056,arrange,xrenJ,3,1,2,2,1,arrange,2,4,646,8,11,3,791,3162,243,7727860,5
11013,modulate,maJxlet,1,0,1,0,1,modulate,3,7,559,9,1,2,5,130,2,452499,8
9630,lancer,l@nsX,3,1,2,2,1,lancer,2,5,668,7,19,14,22,89,14,1096622,6
2660,carnal,karnL,5,3,2,2,3,carnal,2,6,347,6,25,6,61,203,7,550376,6
9967,link,lIGk,17,10,7,14,3,link,1,4,330,5,58,41,609,9673,1333,240412757,5
10995,model,madL,9,9,0,8,1,model,2,5,307,6,28,19,1635,42175,2736,161212032,6
4632,delta,dEltx,1,0,1,0,1,delta,2,5,328,6,7,7,425,4225,494,28053919,6
12648,penchant,pEnC|nt,3,1,2,2,1,penchant,2,7,476,5,2,1,27,695,40,431194,4
14411,reddish,rEdIS,2,2,0,2,0,reddish,2,5,397,6,12,2,10,807,21,850815,5
6422,final,fYnL,6,4,2,3,3,final,2,5,450,6,19,5,2533,31644,6006,97654851,6
12275,pal,p@l,20,19,1,10,10,pal,1,3,469,4,82,47,2937,1803,312,9995683,4
7890,hiding,hYdIG,3,3,0,3,0,hiding,2,5,488,4,16,9,2207,4950,1223,4565153,6
11064,money,m^ni,10,10,0,6,4,money,2,4,340,6,80,22,32679,104788,36865,190213104,5
808,antic,@ntIk,2,1,1,1,1,antic,2,5,453,6,8,8,4,77,5,148766,6
15404,senate,sEn|t,5,3,2,3,2,senate,2,5,417,7,24,2,331,25661,13336,34303220,6
14446,reform,rIform,2,1,1,1,1,reform,2,6,557,7,2,4,184,21029,6775,22752959,7
18845,watery,wctXi,1,0,1,0,1,watery,3,5,470,6,6,4,36,835,24,630703,5
16834,sword,sord,13,11,2,9,4,sword,1,4,559,6,49,7,1335,3323,259,8845283,5
16177,spot,spat,13,10,3,5,8,spot,1,4,542,5,33,14,3140,17227,2137,26758818,5
8481,in,In,26,12,14,17,9,in,1,2,292,3,119,58,498444,4677345,956546,8469414438,3
14987,rum,r^m,29,23,6,20,9,rum,1,3,295,4,115,41,382,1229,149,2255735,4
4169,creole,kriol,3,2,1,2,1,creole,2,5,491,7,6,2,55,681,56,2277595,6
17340,ticket,tIk|t,4,3,1,4,0,ticket,2,5,444,7,8,8,2324,8125,2215,28768655,6
3895,converse,kxnvRs,2,2,0,0,2,converse,2,6,570,9,5,4,66,618,39,2554939,7
17714,trifle,trYfL,4,2,2,2,2,trifle,2,6,475,7,6,4,107,299,12,354770,7
11868,ode,od,24,12,12,13,11,ode,1,2,334,4,100,34,41,355,33,1648112,3
13994,purse,pRs,19,16,3,11,8,purse,1,3,400,6,59,15,1008,3692,422,5489934,4
13366,post,post,15,13,2,10,5,post,1,4,490,5,33,35,1654,32375,6271,392967450,5
13658,prison,prIzN,3,1,2,1,2,prison,2,6,444,7,9,6,3368,17698,6084,15837188,7
15991,song,scG,11,10,1,8,3,song,1,3,507,5,59,35,4778,17778,5535,65843143,4
5103,diva,divx,1,1,0,1,0,diva,2,4,457,5,21,15,78,662,106,2719065,5
16292,start,start,7,4,3,2,5,start,1,5,474,6,32,18,17345,62495,18955,161934195,6
668,amuse,xmyuz,3,2,1,3,0,amuse,2,5,668,6,6,5,133,340,23,556542,6
3802,construct,kxnstr^kt,1,1,0,0,1,construct,2,9,583,10,4,3,74,4592,156,8472340,10
13948,punch,p^nC,8,7,1,6,2,punch,1,4,370,6,14,8,1514,3872,631,6873557,5
13699,prod,prad,9,7,2,4,5,prod,1,4,443,5,27,17,35,318,47,3500701,5
13812,prospect,praspEkt,1,0,1,0,1,prospect,2,8,678,9,2,3,178,5197,810,7106121,9
11574,ninety,nYnti,1,0,1,0,1,ninety,2,5,500,7,5,2,142,3069,720,2587226,6
9835,lest,lEst,23,20,3,17,6,lest,1,4,444,5,59,37,100,1157,74,1921747,5
14592,repeat,rIpit,3,2,1,1,2,repeat,2,5,413,7,9,5,1684,7027,1122,14026113,6
10640,medley,mEdli,2,2,0,0,2,medley,2,5,432,6,20,9,32,536,44,1717954,5
16198,spry,sprY,5,2,3,1,4,spry,1,4,566,4,8,5,32,141,9,217147,5
3903,conviction,kxnvIkS|n,1,1,0,1,0,conviction,3,9,613,11,2,2,303,4315,1094,5818769,10
7195,glance,gl@ns,3,1,2,1,2,glance,1,5,569,7,10,5,175,4932,165,15569875,6
2494,came,kem,24,21,3,15,9,came,1,3,282,5,97,33,23650,106661,28026,73291509,4
2882,certain,sRtN,4,4,0,3,1,certain,2,5,537,8,29,2,4354,42058,9555,73108213,6
11409,native,netIv,1,1,0,1,0,native,2,5,442,7,2,2,421,20238,1038,35161852,6
16970,tank,t@Gk,16,11,5,11,5,tank,1,4,327,5,48,29,1306,7358,1306,22073920,5
6161,factor,f@ktX,2,0,2,1,1,factor,2,5,512,7,19,4,370,18689,2870,38741396,6
7661,harm,harm,9,8,1,3,6,harm,1,4,440,5,40,30,1621,7124,1524,10026586,5
11278,murmur,mRmX,4,4,0,1,3,murmur,2,4,609,7,19,1,48,706,19,472146,5
10412,mansion,m@nC|n,1,1,0,1,0,mansion,2,6,537,8,8,5,329,2842,464,4019687,5
5327,duck,d^k,25,22,3,13,12,duck,1,3,445,5,98,29,1263,3639,615,8287612,4
5609,emigrate,Emxgret,2,1,1,1,1,emigrate,3,7,652,9,4,5,14,205,26,213644,8
849,apathetic,@pxTEtIk,1,0,1,1,0,apathetic,4,8,530,6,1,1,18,212,38,302358,5
15306,sculptor,sk^lptX,1,1,0,0,1,sculptor,2,7,544,9,4,1,46,850,65,963733,8
11452,neck,nEk,13,13,0,10,3,neck,1,3,432,5,86,23,3035,15430,1361,17356090,4
10155,lucent,lusNt,1,0,1,0,1,lucent,2,6,534,7,0,1,5,187,45,1766342,6
10670,memo,mEmo,2,2,0,0,2,memo,2,4,449,5,18,13,337,2328,867,6710945,5
17509,torque,tork,11,8,3,4,7,torque,1,4,357,4,52,0,37,1024,18,4264924,5
6474,fixture,fIksCX,1,1,0,1,0,fixture,2,6,668,8,5,2,32,876,97,2633227,7
19326,zoo,zu,20,19,1,18,2,zoo,1,2,534,4,129,21,696,2842,528,11593039,3
11346,myth,mIT,15,14,1,8,7,myth,1,3,361,5,53,7,352,4390,471,6054397,4
16183,sprawl,sprcl,1,1,0,1,0,sprawl,1,5,579,7,14,3,7,638,57,985396,6
14846,ripe,rYp,20,17,3,10,10,ripe,1,3,328,5,69,27,213,2311,162,9136382,4
6159,faction,f@kS|n,4,1,3,4,0,faction,2,6,538,8,6,4,58,977,157,1631371,7
7154,giddy,gIdi,3,3,0,2,1,giddy,2,4,469,5,31,5,91,706,70,483433,5
1394,axe,@ks,9,4,5,6,3,axe,1,3,403,4,93,28,249,714,77,2777022,4
7512,gun,g^n,20,18,2,14,6,gun,1,3,278,4,112,34,10873,20046,5799,22838661,4
5496,eighteen,etin,1,0,1,0,1,eighteen,2,4,599,9,12,1,310,3222,394,3094087,5
17144,term,tRm,13,13,0,9,4,term,1,3,489,5,39,10,890,42461,8580,116284146,4
12256,paddy,p@di,7,6,1,3,4,paddy,2,4,438,6,31,11,134,503,78,1668962,5
8057,hotel,hotEl,1,1,0,1,0,hotel,2,5,491,6,5,9,5264,20040,3269,297980524,6
6703,formality,form@l|ti,1,1,0,1,0,formality,4,9,537,9,2,1,110,491,42,414604,10
3037,chic,Sik,24,21,3,17,7,chic,1,3,385,5,110,8,119,1681,142,3735613,4
3039,chick,CIk,23,22,1,16,7,chick,1,3,358,6,66,15,1334,1506,193,7776742,4
19202,wrinkle,rIGkL,5,3,2,4,1,wrinkle,2,6,517,8,25,4,96,675,86,1551149,7
16382,stint,stInt,3,2,1,2,1,stint,1,5,526,6,14,12,38,1080,69,856043,6
4137,crawl,krcl,9,7,2,6,3,crawl,1,4,417,6,48,10,614,1865,217,2859784,5
7092,gent,JEnt,17,14,3,12,5,gent,1,4,391,5,57,32,82,175,31,1074241,5
8849,innings,InIGz,2,1,1,1,1,innings,2,5,395,7,7,2,49,1966,57,2204569,5
12448,parody,p@rxdi,1,1,0,0,1,parody,3,6,525,6,3,4,36,742,105,1829413,7
7632,hangar,h@GX,6,4,2,0,6,hangar,2,4,418,7,27,5,173,442,59,795985,5
7501,guitar,g|tar,1,1,0,1,0,guitar,2,5,521,7,4,2,795,4245,795,37108254,6
17235,thermal,TRmL,1,1,0,1,0,thermal,2,5,411,7,7,1,112,1878,123,14187566,5
3173,cinema,sInxmx,1,0,1,0,1,cinema,3,6,489,7,3,3,198,1965,130,18180242,7
5570,emanation,EmxneS|n,1,0,1,1,0,emanation,4,8,590,10,1,1,5,40,6,94942,9
7283,goner,gcnX,2,1,1,0,2,goner,2,4,464,5,38,18,78,80,21,82437,5
14070,quarry,kwcri,2,2,0,1,1,quarry,2,5,453,7,15,2,78,767,32,1960848,6
18576,vinyl,vYnL,7,5,2,3,4,vinyl,2,5,423,5,12,1,63,1072,65,17011205,5
4368,cyclic,sYklIk,1,0,1,0,1,cyclic,2,6,522,7,3,0,9,198,3,2199045,7
4346,custom,k^stxm,2,0,2,1,1,custom,2,6,502,7,3,1,316,4614,230,66595625,7
16174,spore,spor,13,10,3,6,7,spore,1,4,555,6,40,14,7,172,12,589962,5
3755,conscience,kanC|ns,1,0,1,0,1,conscience,2,7,659,11,1,1,709,3023,617,3577738,6
17801,truth,truT,5,3,2,1,4,truth,1,4,400,6,22,6,9801,26432,7161,35350927,5
12971,picture,pIkCX,2,1,1,2,0,picture,2,5,494,8,12,2,7061,28392,7439,124127951,6
10432,map,m@p,20,20,0,13,7,map,1,3,395,4,73,44,1623,11585,1608,309679646,4
11926,one,w^n,18,17,1,17,1,one,1,3,339,4,90,40,156684,742881,177330,993546809,4
17320,thug,T^g,12,12,0,10,2,thug,1,3,378,5,27,11,178,459,102,1607469,4
18605,virus,vYr|s,2,1,1,2,0,virus,2,5,457,6,5,3,964,6519,1719,36295812,6
7049,geese,gis,8,7,1,8,0,geese,1,3,413,6,73,18,81,1006,94,1299115,4
15285,scribe,skrYb,2,1,1,1,1,scribe,1,5,650,7,5,4,13,282,12,1030833,6
10898,mirth,mRT,13,11,2,10,3,mirth,1,3,484,5,55,10,11,211,12,387672,4
11948,opener,opxnX,1,0,1,0,1,opener,3,5,487,7,4,2,173,1568,113,3239644,6
11303,must,m^st,16,12,4,10,6,must,1,4,427,5,40,27,35661,103754,12983,292787867,5
15230,schematic,skIm@tIk,1,0,1,1,0,schematic,3,8,738,8,0,0,58,426,5,2085298,7
12253,padding,p@dIG,4,4,0,4,0,padding,2,5,385,8,11,6,49,561,30,2890936,6
10075,locus,lok|s,3,2,1,2,1,locus,2,5,516,6,14,8,17,1240,4,3009222,6
16458,stream,strim,6,5,1,1,5,stream,1,5,624,7,22,5,410,7055,462,38598566,6
6275,faze,fez,23,21,2,14,9,faze,1,3,549,5,133,20,22,123,12,138560,4
12126,outlay,Wtle,2,1,1,0,2,outlay,2,4,415,7,5,3,6,181,10,926485,5
6635,fool,ful,18,17,1,17,1,fool,1,3,462,5,88,16,4556,4403,584,7569582,4
8329,immigration,ImxgreS|n,1,1,0,1,0,immigration,4,9,569,9,2,0,128,10643,3396,15879176,7
5555,ellipse,xlIps,1,1,0,1,0,ellipse,2,5,427,7,19,3,0,128,18,866759,6
15969,solidly,salxdli,2,1,1,1,1,solidly,3,7,651,6,0,1,13,683,99,536571,6
10357,manage,m@nIJ,3,2,1,1,2,manage,2,5,447,7,8,6,1095,8449,1087,36439435,6
7998,hood,hUd,13,13,0,11,2,hood,1,3,479,5,35,20,785,4172,603,11000354,4
2860,centralize,sEntrxlYz,1,0,1,0,1,centralize,3,9,872,11,2,1,1,88,10,214248,10
16688,sung,s^G,20,16,4,13,7,sung,1,3,619,5,48,30,178,1566,297,3242040,4
5822,erratic,Ir@tIk,1,1,0,1,0,erratic,3,6,531,8,1,0,85,896,120,716141,4
7724,heal,hil,29,26,3,23,6,heal,1,3,370,5,154,28,578,2422,556,3771118,4
16388,stirrup,stRxp,1,0,1,1,0,stirrup,2,5,507,8,5,1,12,122,7,225827,6
17021,tawny,tcni,5,5,0,4,1,tawny,2,4,359,5,61,1,33,237,4,602308,5
16748,surgery,sRJXi,1,1,0,1,0,surgery,3,5,534,7,2,0,1651,11501,2675,40026384,6
14088,query,kwIri,5,3,2,3,2,query,2,5,519,5,6,2,29,722,32,31285263,5
15004,runaway,r^nxwe,1,0,1,0,1,runaway,3,6,426,8,4,3,207,1265,243,1809362,7
16322,steed,stid,10,9,1,3,7,steed,1,4,490,6,49,17,130,254,16,701658,5
4480,deal,dil,29,24,5,22,7,deal,1,3,439,5,159,37,13330,49762,18165,63831872,4
15778,slang,sl@G,11,10,1,2,9,slang,1,4,534,5,20,13,71,572,85,1819478,5
15615,shrank,Sr@Gk,8,6,2,8,0,shrank,1,5,547,5,19,4,19,616,33,227485,4
5631,employment,ImplOmxnt,1,1,0,1,0,employment,3,9,548,11,3,2,272,9244,940,79105509,10
10976,mitre,mYtX,11,10,1,7,4,mitre,2,5,401,5,7,9,2,52,4,714477,5
7604,halve,h@v,17,16,1,5,12,halve,1,3,448,6,45,10,7,222,4,242617,4
16460,street,strit,6,5,1,1,5,street,1,5,412,7,23,6,7557,56313,12122,149137640,6
5719,entity,En|ti,1,0,1,1,0,entity,3,6,659,7,3,2,86,2485,287,17518443,7
4408,daisy,dezi,6,5,1,4,2,daisy,2,4,466,6,32,6,689,1463,144,5125361,5
7693,hatter,h@tX,11,9,2,8,3,hatter,2,4,505,7,47,24,23,97,18,294189,5
16401,stoic,stoIk,4,1,3,0,4,stoic,2,5,519,6,5,2,21,453,49,275967,6
8142,hurt,hRt,23,21,2,15,8,hurt,1,3,443,5,101,23,12564,18791,5882,12940340,4
13684,proceed,prosid,2,1,1,1,1,proceed,2,6,748,8,4,3,1066,3376,737,11314884,7
10852,mimetic,mxmEtIk,1,1,0,1,0,mimetic,3,7,469,5,0,0,2,285,0,145902,5
3677,cone,kon,35,30,5,24,11,cone,1,3,509,5,165,47,149,1561,125,4434449,4
2373,but,b^t,35,30,5,21,14,but,1,3,289,4,101,40,225291,1149758,330971,999908295,4
15917,soap,sop,21,17,4,16,5,soap,1,3,400,5,63,12,775,3324,513,12486613,4
18624,visitor,vIz|tX,1,0,1,0,1,visitor,3,6,498,8,5,2,446,3619,277,20159943,7
15016,rupee,rupi,2,1,1,0,2,rupee,2,4,499,6,40,6,2,90,6,2831536,5
7463,grove,grov,13,11,2,4,9,grove,1,4,431,6,40,21,197,3287,209,15189493,5
4699,deny,dInY,6,3,3,0,6,deny,2,4,714,5,13,19,1091,5105,1289,7211538,5
5516,elector,xlEktX,1,0,1,0,1,elector,3,6,456,8,10,5,0,93,47,473844,7
11831,obtain,xbten,2,0,2,2,0,obtain,2,5,496,7,5,1,190,5657,330,30672052,6
14696,restitution,rEst|tuS|n,1,1,0,1,0,restitution,4,10,736,9,0,1,28,431,65,1282669,8
18045,undo,^ndu,2,2,0,0,2,undo,2,4,405,5,10,13,223,866,172,6202977,5
10811,mighty,mYti,2,1,1,0,2,mighty,2,4,649,6,28,4,1355,2408,261,7270974,5
13373,poster,postX,7,4,3,4,3,poster,2,5,456,7,17,24,305,2564,402,41897879,6
16663,sulk,s^lk,7,5,2,4,3,sulk,1,4,575,5,18,17,38,81,4,95404,5
16361,sticky,stIki,2,1,1,1,1,sticky,2,5,579,6,20,6,292,2056,159,5700342,6
10977,mitt,mIt,33,27,6,23,10,mitt,1,3,321,5,99,23,70,3567,2815,693498,4
10536,mate,met,28,26,2,19,9,mate,1,3,394,5,110,52,1491,3766,815,9736872,4
17468,tonic,tanIk,5,5,0,5,0,tonic,2,5,366,6,14,12,195,633,35,1393402,6
16520,studied,st^did,1,0,1,0,1,studied,2,6,549,7,6,2,577,11061,958,12881982,6
2229,broker,brokX,1,0,1,0,1,broker,2,5,544,7,29,15,185,2189,365,13865583,6
1381,awe,c,20,4,16,15,5,awe,1,1,366,4,99,32,134,1850,183,2250899,2
16633,sue,su,34,26,8,20,14,sue,1,2,449,4,169,50,1498,4685,1247,11090997,3
9833,lessen,lEsN,6,5,1,2,4,lessen,2,5,580,7,44,11,30,839,86,1087324,6
7467,growth,groT,6,5,1,0,6,growth,1,4,426,7,33,2,329,32886,4033,79998686,5
17665,treasury,trEZXi,1,0,1,0,1,treasury,3,6,469,9,8,2,194,4800,1555,9167640,7
17348,tier,tIr,29,27,2,23,6,tier,1,3,401,5,66,30,54,1627,194,7089892,4
5018,dislike,dIslYk,1,1,0,1,0,dislike,2,6,748,8,2,2,200,1247,242,2025443,7
2843,censure,sEnCX,5,4,1,2,3,censure,2,5,553,8,13,3,8,328,55,452851,6
10677,memory,mEmXi,2,1,1,2,0,memory,3,5,487,6,12,2,2477,19130,2062,140484503,6
19210,written,rItN,8,6,2,5,3,written,2,5,479,5,59,4,2247,26388,5182,98056850,6
11573,nineteen,nYntin,1,0,1,0,1,nineteen,2,6,575,9,5,0,169,1770,316,1454202,7
11972,oppression,xprES|n,1,1,0,1,0,oppression,3,7,572,11,3,1,76,1931,205,1770635,8
12935,physical,fIzIkL,2,1,1,0,2,physical,3,7,541,9,2,1,1386,36212,2863,64091252,8
4859,diarrhoea,dYXix,1,1,0,1,0,diarrhoea,4,5,559,7,3,1,19,60,1,598810,6
18050,unduly,^nduli,1,1,0,1,0,unduly,3,6,578,6,1,1,24,413,39,683166,5
19106,within,wItIn,1,1,0,0,1,within,2,5,417,7,4,1,3017,77592,9829,261396179,5
2092,boulder,boldX,5,3,2,3,2,boulder,2,5,495,8,32,8,106,3563,397,6562262,6
9683,last,l@st,14,12,2,12,2,last,1,4,502,5,51,33,36878,193855,52414,417620476,5
1858,biscuit,bIsk|t,2,1,1,2,0,biscuit,2,6,421,8,4,1,191,458,33,1724569,7
9750,leapt,lipt,4,2,2,1,3,leapt,1,4,509,5,23,4,45,949,39,415235,5
309,advert,@dvRt,2,2,0,0,2,advert,2,5,477,7,3,4,13,34,3,5431594,6
2920,chancel,C@nsL,6,3,3,2,4,chancel,2,6,550,8,11,8,0,37,0,197855,7
19261,yen,yEn,20,19,1,17,3,yen,1,3,609,4,87,38,312,1013,171,5796042,4
16808,sweep,swip,9,7,2,4,5,sweep,1,4,455,6,25,8,485,2772,402,3624118,5
2250,browse,brWz,8,6,2,3,5,browse,1,4,443,7,38,11,30,634,32,128742720,5
7037,gave,gev,18,16,2,10,8,gave,1,3,471,5,48,31,12428,47687,9825,36576902,4
7489,guess,gEs,11,9,2,9,2,guess,1,3,378,6,59,10,23153,27152,14120,28747353,4
14184,railing,relIG,4,3,1,4,0,railing,2,5,619,8,42,18,75,1199,70,837646,6
6527,fleet,flit,16,13,3,7,9,fleet,1,4,503,6,36,11,540,3583,395,10364760,5
8337,immodest,Imad|st,1,0,1,1,0,immodest,3,7,828,9,2,1,18,79,14,60945,8
10665,melon,mEl|n,1,1,0,1,0,melon,2,5,456,6,65,18,218,695,27,1356060,6
7714,hazel,hezL,3,2,1,1,2,hazel,2,5,477,6,12,12,55,1067,99,2843086,6
19197,wrench,rEnC,10,5,5,6,4,wrench,1,4,400,7,32,5,202,678,54,2044734,5
10555,matrimony,m@trxmoni,2,1,1,1,1,matrimony,4,9,660,9,1,1,136,149,12,331010,10
4303,cup,k^p,18,15,3,10,8,cup,1,3,186,4,76,22,2634,33206,1183,45039410,4
5377,during,dUrIG,2,2,0,2,0,during,2,5,411,5,15,13,3872,121775,15459,206364907,4
10783,mice,mYs,22,20,2,15,7,mice,1,3,462,5,84,27,335,2197,180,11969407,4
9007,interest,Intrxst,1,1,0,0,1,interest,2,7,471,9,5,4,2598,45894,8308,120273375,8
7635,hanging,h@GIG,2,2,0,2,0,hanging,2,5,433,8,12,9,2735,9443,1544,10190519,4
16744,surface,sRfxs,2,2,0,1,1,surface,2,5,532,8,7,4,930,21818,1603,50028031,6
3829,contention,kxntEnC|n,1,1,0,1,0,contention,3,9,627,11,4,2,41,1743,255,2101748,10
7688,hatch,h@C,19,19,0,8,11,hatch,1,3,443,6,63,15,654,2978,638,3897926,4
17252,thicken,TIk|n,2,2,0,1,1,thicken,2,5,455,8,15,5,5,290,24,228030,6
16346,sterile,stErL,1,0,1,0,1,sterile,2,6,577,7,12,1,111,1028,101,2004265,7
1005,arctic,arktIk,1,1,0,0,1,arctic,2,5,448,5,3,0,100,2439,231,7367739,6
12281,palate,p@l|t,7,7,0,6,1,palate,2,5,431,7,19,3,50,673,55,1435844,6
3424,coin,kOn,14,13,1,11,3,coin,1,3,339,5,87,20,497,2093,305,10097574,4
1770,best,bEst,23,20,3,20,3,best,1,4,490,5,64,37,20623,111604,22450,371877082,5
10563,maturation,m@CXeS|n,1,1,0,1,0,maturation,4,8,747,11,1,1,3,436,9,906863,5
4237,crown,krWn,10,10,0,4,6,crown,1,4,559,6,43,15,698,4648,617,16651038,5
1888,blame,blem,7,6,1,3,4,blame,1,4,539,6,37,14,2998,9891,3386,8171067,5
2359,bus,b^s,20,17,3,8,12,bus,1,3,329,4,110,51,3783,12981,2510,41049366,4
17116,tendon,tEnd|n,2,1,1,0,2,tendon,2,6,589,7,6,4,29,522,20,789636,7
18362,vault,vclt,6,6,0,5,1,vault,1,4,458,6,20,8,614,1069,115,5408483,5
17053,teens,tinz,3,2,1,1,2,teens,1,4,469,6,70,11,99,4647,840,70871043,4
3751,conquer,kaGkX,3,2,1,1,2,conquer,2,5,527,8,13,1,254,970,120,2280435,6
9979,lip,lIp,29,23,6,19,10,lip,1,3,329,4,93,40,548,4814,386,7699845,4
7690,hatching,h@CIG,2,2,0,2,0,hatching,2,5,455,6,16,6,25,275,16,558388,5
9252,it,It,27,13,14,19,8,it,1,2,310,3,74,48,963712,2453309,843024,2813166778,3
6558,flood,fl^d,5,5,0,1,4,flood,1,4,419,6,15,6,291,5344,1251,13981585,5
14716,retention,rItEnC|n,2,1,1,2,0,retention,3,8,629,8,1,1,14,2678,53,9226062,5
9303,jealous,JElxs,2,2,0,1,1,jealous,2,5,465,8,9,2,1952,1883,422,2229501,6
13888,Psyche,sYki,3,2,1,2,1,psyche,2,4,426,7,21,4,140,1346,153,1166306,5
14757,revise,rIvYz,2,2,0,0,2,revise,2,5,680,7,7,11,44,788,83,3475221,6
5618,emote,Imot,4,2,2,3,1,emote,2,4,463,5,6,5,3,31,6,169439,5
16821,swim,swIm,11,11,0,3,8,swim,1,4,456,5,22,11,1622,4008,467,8741139,5
17494,tops,taps,5,4,1,3,2,tops,1,4,452,5,38,30,375,3305,257,11774961,5
18946,which,hwIC,11,9,2,4,7,which,1,4,429,6,18,2,24339,433589,78406,810525668,5
4036,couch,kWC,9,7,2,6,3,couch,1,3,416,6,48,14,1197,5195,561,4581367,4
2858,central,sEntrL,3,3,0,1,2,central,2,7,447,8,8,3,1262,34258,4614,113843808,8
4977,discern,dIsRn,1,1,0,0,1,discern,2,5,570,8,9,1,17,1093,68,964331,6
16119,spin,spIn,12,10,2,3,9,spin,1,4,469,5,28,19,746,5175,1159,12675536,5
17585,tramp,tr@mp,8,3,5,4,4,tramp,1,5,348,6,15,12,423,341,35,1087707,6
3517,commando,kxm@ndo,2,1,1,0,2,commando,3,7,678,9,5,3,54,330,59,1354026,8
13795,proposition,prapxzIS|n,1,1,0,1,0,proposition,4,10,659,12,2,1,402,3185,486,6182044,11
6414,film,fIlm,7,6,1,0,7,film,1,4,375,5,24,9,3328,31285,6975,116102433,5
15603,shorten,SortN,1,0,1,0,1,shorten,2,6,506,8,22,4,52,533,63,1012067,7
16319,steal,stil,11,9,2,2,9,steal,1,4,470,6,59,13,2720,3593,835,6258499,5
3949,cordial,korJL,3,1,2,0,3,cordial,2,6,489,8,16,2,62,439,87,585191,7
14396,rectifier,rEkt|fYX,1,0,1,0,1,rectifier,4,8,661,10,4,3,0,17,1,617118,9
15190,say,se,37,23,14,17,20,say,1,2,405,4,156,55,83629,236505,112145,156858126,3
13564,prepossess,pripxzEs,1,0,1,1,0,prepossess,3,8,755,7,1,1,0,0,0,2368,5
15816,slip,slIp,17,14,3,6,11,slip,1,4,409,5,30,17,1320,5286,615,12888349,5
2059,boot,but,32,26,6,23,9,boot,1,3,354,5,97,32,568,3964,404,20827089,4
729,anguish,@GgwIS,1,0,1,1,0,anguish,2,6,495,8,2,1,110,1104,206,903376,7
17009,tatter,t@tX,15,13,2,11,4,tatter,2,4,409,7,35,16,0,13,2,20702,5
15133,sank,s@Gk,17,11,6,15,2,sank,1,4,499,5,52,38,110,2161,172,1027160,5
12581,payment,pemxnt,1,1,0,1,0,payment,2,6,454,8,5,2,538,5052,787,144647216,7
2038,bone,bon,31,26,5,21,10,bone,1,3,385,5,150,53,1329,9669,1059,17586015,4
11185,moth,mcT,8,7,1,5,3,moth,1,3,450,5,46,31,116,797,37,1579676,4
704,and,@nd,12,2,10,8,4,and,1,3,519,4,50,30,682780,6911968,1512019,12997637966,4
17850,turf,tRf,7,7,0,3,4,turf,1,3,333,4,20,8,218,1855,240,3121984,3
14888,rod,rad,21,18,3,18,3,rod,1,3,394,4,106,44,547,4384,538,13126911,4
13164,ploy,plO,6,6,0,2,4,ploy,1,3,413,5,18,13,78,611,167,529976,4
4155,credit,krEd|t,2,0,2,1,1,credit,2,6,345,7,4,3,2337,22884,5800,175917693,7
15025,rust,r^st,19,14,5,13,6,rust,1,4,365,5,57,33,127,1464,94,3630194,5
11902,okay,oke,6,3,3,3,3,okay,2,3,405,5,41,10,102320,24970,10346,15370861,4
10803,midget,mIJ|t,4,4,0,4,0,midget,2,5,323,7,16,8,235,222,18,1865696,6
7151,gibe,JYb,4,4,0,3,1,gibe,1,3,414,5,21,10,2,19,0,28766,4
16815,swept,swEpt,3,1,2,2,1,swept,1,5,471,4,11,7,243,4663,597,2612332,4
7654,hardly,hardli,1,0,1,0,1,hardly,2,6,532,6,11,3,2613,12014,1288,8845763,6
3337,cluster,kl^stX,5,3,2,4,1,cluster,2,6,453,8,13,6,67,4106,178,14678600,7
15462,serf,sRf,8,6,2,3,5,serf,1,3,528,5,34,12,9,118,0,154018,4
2033,bondage,bandIJ,1,1,0,1,0,bondage,2,6,493,6,3,1,87,455,78,38237863,6
14227,rap,r@p,31,26,5,18,13,rap,1,3,326,4,104,52,665,3338,843,10739454,4
15745,skein,sken,10,8,2,5,5,skein,1,4,516,6,35,6,5,102,0,208604,5
11142,morgue,morg,2,1,1,0,2,morgue,1,4,371,7,48,3,440,539,163,379053,5
16424,storm,storm,4,3,1,1,3,storm,1,5,505,6,28,10,1574,13015,4403,22249642,6
12858,phantom,f@ntxm,1,1,0,1,0,phantom,2,6,635,8,6,2,208,1170,135,5306656,7
6584,fluke,fluk,8,7,1,0,8,fluke,1,4,410,6,31,8,89,397,76,1170271,5
6630,fondle,fandL,2,1,1,0,2,fondle,2,6,629,7,3,4,25,72,17,112002,7
19314,zipper,zIpX,6,5,1,4,2,zipper,2,4,431,7,29,10,144,805,43,2450000,5
17332,thyme,tYm,21,19,2,11,10,thyme,1,3,348,5,32,3,10,1733,55,1007823,3
981,arcane,arken,2,2,0,0,2,arcane,2,5,487,6,2,4,21,524,53,809848,6
16235,squirrel,skwRL,2,2,0,0,2,squirrel,2,6,459,9,2,1,279,978,128,2231658,7
8363,impart,Impart,1,1,0,0,1,impart,2,6,463,7,3,5,27,461,28,694505,7
18851,way,we,30,20,10,17,13,way,1,2,399,4,145,51,72661,265399,76376,305528152,3
5857,esquire,EskwYr,1,0,1,1,0,esquire,2,6,537,8,2,2,50,773,61,795793,7
1617,battle,b@tL,14,13,1,6,8,battle,2,5,423,7,35,12,2155,18348,5046,31345568,6
8831,injury,InJXi,1,0,1,0,1,injury,3,5,552,6,5,1,520,9438,959,30291773,6
6062,explode,Iksplod,1,1,0,0,1,explode,2,7,609,8,1,4,499,1542,337,1880693,8
1534,barber,barbX,6,4,2,2,4,barber,2,5,469,7,36,22,279,1653,337,4241984,6
2194,bright,brYt,14,11,3,6,8,bright,1,4,444,7,41,6,2265,16050,1306,19447263,5
8102,humane,hyumen,1,1,0,0,1,humane,2,6,659,7,4,6,93,1273,256,2337182,7
7490,guest,gEst,15,13,2,13,2,guest,1,4,449,6,47,8,2037,9460,3967,55295435,5
18618,visible,vIzxbL,1,1,0,1,0,visible,3,7,466,7,0,1,253,9231,651,15742054,6
17347,tidy,tYdi,6,5,1,3,3,tidy,2,4,445,4,16,4,189,1116,81,1772031,4
1312,author,cTX,3,3,0,3,0,author,2,3,387,7,14,2,405,30832,4919,179813762,4
8962,insure,InSUr,2,2,0,1,1,insure,2,5,537,7,10,8,54,1066,203,5020560,6
12869,pharynx,f@rIGks,1,1,0,1,0,pharynx,2,7,513,7,1,0,0,70,2,184068,6
1578,bash,b@S,24,21,3,14,10,bash,1,3,439,5,76,37,167,916,357,4726953,4
15382,self,sElf,7,5,2,4,3,self,1,4,496,5,40,14,722,64678,4827,112907357,5
15468,serpent,sRpxnt,1,1,0,1,0,serpent,2,6,545,8,4,2,99,535,14,1648778,7
11183,motel,motEl,2,2,0,1,1,motel,2,5,477,6,9,16,927,2125,371,9170238,6
10986,mobile,mobL,5,4,1,2,3,mobile,2,5,448,7,44,6,381,5945,765,145498868,6
15869,smoke,smok,7,6,1,3,4,smoke,1,4,622,6,19,11,3337,12251,2198,16571457,5
1238,attack,xt@k,4,3,1,3,1,attack,2,4,464,7,15,2,3853,24857,8734,35602466,5
15609,shout,SWt,15,14,1,14,1,shout,1,3,369,6,46,14,839,2210,318,3972506,4
6335,fern,fRn,21,19,2,14,7,fern,1,3,393,5,88,22,163,714,115,1871772,4
14379,record,rIkord,2,1,1,1,1,record,2,6,525,7,6,7,4365,36369,9383,102244532,7
7858,herring,hErIG,1,1,0,1,0,herring,2,5,498,8,50,14,152,928,85,1862420,6
6209,fan,f@n,21,20,1,17,4,fan,1,3,423,4,106,48,1792,9085,1944,47059257,4
7221,globe,glob,8,5,3,1,7,globe,1,4,439,6,19,10,266,4955,1075,14557011,5
19055,win,wIn,31,25,6,19,12,win,1,3,410,4,144,49,6867,32455,9608,65271643,4
8127,hunch,h^nC,9,7,2,5,4,hunch,1,4,454,6,20,9,383,631,128,330785,5
14676,resort,rIzort,2,2,0,2,0,resort,2,6,469,7,5,6,352,6817,780,44120131,7
2483,calve,k@v,17,15,2,5,12,calve,1,3,307,6,46,12,0,33,2,62571,4
16413,stood,stUd,4,4,0,0,4,stood,1,4,569,5,13,3,1315,27174,2276,11116938,4
7660,harlot,harlxt,1,1,0,1,0,harlot,2,6,526,6,5,2,40,90,4,256839,6
14085,quell,kwEl,5,4,1,3,2,quell,1,4,316,6,20,7,17,436,70,295959,5
78,absentee,@bs|nti,1,0,1,0,1,absentee,3,7,753,9,3,2,18,683,353,1238718,8
13849,prove,pruv,5,4,1,2,3,prove,1,4,466,6,16,12,3590,12104,3069,16047152,5
11222,muck,m^k,25,22,3,14,11,muck,1,3,460,5,106,25,97,591,52,1305552,4
4589,deform,dIform,1,1,0,1,0,deform,2,6,527,7,1,4,6,81,8,160604,7
8808,inhale,Inhel,2,1,1,1,1,inhale,2,5,605,7,2,2,120,634,72,452592,6
432,aid,ed,20,12,8,12,8,aid,1,2,342,4,101,49,709,17622,4037,50038814,3
2808,cease,sis,18,16,2,6,12,cease,1,3,509,6,126,18,445,3232,1223,4082891,4
5005,dish,dIS,12,12,0,4,8,dish,1,3,369,5,62,25,584,6889,487,21757873,4
545,alone,xlon,7,5,2,5,2,alone,2,4,488,5,30,18,15735,37065,5859,39331197,5
6555,flock,flak,12,10,2,4,8,flock,1,4,356,6,40,16,237,1895,336,2587038,5
2867,century,sEnCXi,2,1,1,0,2,century,3,6,578,8,3,1,1063,44644,3861,54929645,7
3450,collegiate,kxliJ|t,1,1,0,0,1,collegiate,3,7,545,9,0,0,25,1217,86,3416336,6
9395,jug,J^g,16,15,1,13,3,jug,1,3,338,4,31,22,134,698,49,1597717,4
11900,oil,Ol,14,8,6,14,0,oil,1,2,393,4,61,26,2095,54654,10853,82182382,3
4162,creep,krip,11,8,3,2,9,creep,1,4,366,6,40,11,573,1014,122,1812193,5
3495,come,k^m,22,20,2,16,6,come,1,3,376,5,101,32,160190,168892,61354,154346337,4
15868,smog,smcg,2,2,0,0,2,smog,1,4,527,5,6,3,55,667,46,1024854,5
7340,grain,gren,20,16,4,7,13,grain,1,4,459,6,69,18,243,5014,520,10244623,5
15085,salary,s@lXi,4,3,1,3,1,salary,3,5,568,7,17,3,548,5762,824,21156261,6
18805,warm,worm,11,8,3,4,7,warm,1,4,458,5,31,18,2659,19131,1698,22647084,5
1148,assert,xsRt,3,3,0,2,1,assert,2,4,475,7,7,5,43,1782,165,3288118,5
13622,price,prYs,10,7,3,4,6,price,1,4,431,6,39,17,2722,35420,6551,501653687,5
15499,sewn,son,27,23,4,22,5,sewn,1,3,445,4,110,9,66,644,38,1121181,4
6037,expect,IkspEkt,1,1,0,1,0,expect,2,7,538,7,3,3,5299,23781,6886,34675982,8
2871,cereal,sIriL,1,1,0,0,1,cereal,3,6,645,7,8,2,324,1811,187,2871293,7
9696,latitude,l@t|tud,2,0,2,2,0,latitude,3,7,650,9,3,3,81,1045,88,7434370,8
14161,radio,redio,2,2,0,1,1,radio,3,5,509,6,8,7,3936,25052,7032,113302360,6
8098,hull,h^l,24,23,1,14,10,hull,1,3,349,5,104,25,215,2858,114,6744259,4
5281,drink,drIGk,6,5,1,6,0,drink,1,5,441,6,13,9,12617,15356,2200,29256735,6
7526,gutter,g^tX,11,8,3,8,3,gutter,2,4,365,7,35,19,267,490,90,1322843,5
2968,chart,Cart,12,9,3,7,5,chart,1,4,379,6,32,13,483,5701,424,35031298,5
3326,clout,klWt,7,6,1,3,4,clout,1,4,609,6,25,6,48,1266,275,639706,5
4323,curl,kRl,23,20,3,15,8,curl,1,3,334,5,127,15,120,1319,80,3659627,4
8190,hyphen,hYfxn,1,1,0,1,0,hyphen,2,5,569,7,17,0,11,68,11,486821,6
5385,duty,duti,6,6,0,5,1,duty,2,4,332,4,35,10,2599,10076,1720,32011339,5
492,aline,xlYn,8,6,2,3,5,aline,2,4,576,6,39,26,24,202,45,276627,5
9759,leaven,lEvxn,7,5,2,6,1,leaven,2,5,393,7,39,10,0,34,2,139841,6
1549,barn,barn,11,10,1,5,6,barn,1,4,361,5,66,41,693,3601,200,5955376,5
746,ankle,@GkL,4,2,2,1,3,ankle,2,5,392,6,7,5,409,3203,197,4147085,6
15543,shear,SIr,26,24,2,21,5,shear,1,3,419,6,88,18,21,656,57,2887491,4
9717,law,lc,24,15,9,14,10,law,1,2,317,4,110,40,5932,74779,19612,216130164,3
4233,crow,kro,14,10,4,9,5,crow,1,3,338,5,95,24,227,1979,191,4603692,4
14963,rub,r^b,23,18,5,14,9,rub,1,3,294,4,64,32,788,2697,348,3437527,4
18552,vile,vYl,22,19,3,15,7,vile,1,3,499,5,79,30,226,496,100,930954,4
15511,shade,Sed,18,17,1,12,6,shade,1,3,605,6,80,20,304,4732,173,6999879,4
949,aptitude,@pt|tud,2,1,1,2,0,aptitude,3,7,614,9,3,3,55,538,32,1014706,8
7408,grew,gru,15,9,6,8,7,grew,1,3,469,5,59,15,1493,18989,3199,10698645,4
2779,caught,kct,23,20,3,17,6,caught,1,3,477,6,134,6,4791,23155,4521,17750070,4
4904,dilate,dYlet,1,1,0,0,1,dilate,2,5,472,7,2,4,12,96,8,134827,6
6632,font,fant,3,3,0,2,1,font,1,4,502,5,23,18,48,523,14,30329400,5
15885,snap,sn@p,9,7,2,3,6,snap,1,4,375,5,20,12,887,3412,266,7982587,5
16318,steady,stEdi,3,2,1,2,1,steady,2,5,438,6,15,2,1158,7655,741,8194341,6
16803,swear,swEr,11,9,2,8,3,swear,1,4,510,6,30,9,4496,2486,485,3082820,5
18221,urgent,RJ|nt,1,1,0,1,0,urgent,2,5,569,7,3,2,758,2866,473,6676181,6
17204,their,DEr,17,15,2,14,3,their,1,3,316,6,82,6,33413,686111,118894,782857871,4
18821,was,wxz,1,1,0,1,0,was,1,3,429,4,47,45,288391,1832180,447654,1483436342,4
17461,ton,t^n,28,25,3,20,8,ton,1,3,328,4,102,61,382,2803,473,8413255,4
19090,wise,wYz,15,13,2,5,10,wise,1,3,565,5,130,31,1452,6481,1208,13316928,4
1439,baggy,b@gi,3,2,1,2,1,baggy,2,4,384,5,34,9,48,743,51,419677,5
15207,scant,sk@nt,3,1,2,2,1,scant,1,5,477,6,14,10,12,1108,47,546008,6
18094,unit,yun|t,1,0,1,0,1,unit,2,5,388,5,8,12,1845,15992,1888,93722423,6
5673,enemy,Enxmi,1,1,0,0,1,enemy,3,5,374,6,6,1,2474,9394,2225,14085419,6
9613,lake,lek,32,28,4,22,10,lake,1,3,376,5,105,43,1836,21049,1883,85246323,4
6731,forty,forti,4,2,2,1,3,forty,2,5,446,6,38,11,539,10012,1624,7415064,6
18633,vital,vYtL,6,4,2,2,4,vital,2,5,388,6,20,13,396,7006,903,14168370,6
1376,awake,xwek,4,2,2,2,2,awake,2,4,499,6,6,4,1362,3759,384,3233171,5
12368,papery,pepXi,2,1,1,1,1,papery,3,5,425,6,5,2,4,113,0,50159,5
15992,sonic,sanIk,5,5,0,5,0,sonic,2,5,498,6,11,7,99,677,68,7309714,6
10440,march,marC,11,9,2,3,8,march,1,4,559,6,42,20,1225,26604,3544,158286161,5
15783,slate,slet,18,15,3,8,10,slate,1,4,480,6,35,19,165,1827,399,3815353,5
2068,border,bordX,4,2,2,3,1,border,2,5,317,7,27,16,876,16213,5031,23235033,6
17172,tester,tEstX,5,3,2,3,2,tester,2,5,492,7,38,31,17,1175,30,3366908,6
16797,swash,swaS,10,9,1,2,8,swash,1,4,596,6,17,9,5,37,1,272310,5
13243,politics,pal|tIks,1,0,1,0,1,politics,3,8,587,9,1,5,845,27147,8979,53008272,8
2414,caddy,k@di,12,9,3,3,9,caddy,2,4,505,6,59,13,145,260,21,1095654,5
16093,speed,spid,8,7,1,3,5,speed,1,4,565,6,35,14,2104,21292,2015,83140238,5
8217,ice,Ys,16,7,9,11,5,ice,1,2,439,4,99,26,4057,21972,2530,41717036,3
1009,are,ar,19,6,13,14,5,are,1,2,363,4,120,70,265672,1179225,335425,2393621713,3
13396,pot,pat,34,29,5,25,9,pot,1,3,324,4,108,47,1149,8122,836,12930337,4
18438,verify,vErxfY,1,1,0,1,0,verify,3,6,768,7,4,3,248,1552,327,14563766,7
13998,pursuit,pXsut,1,0,1,0,1,pursuit,2,5,457,8,8,1,359,4195,444,5404544,6
7292,goody,gUdi,3,1,2,1,2,goody,2,4,399,6,20,20,181,281,57,733518,5
13106,plaque,pl@k,12,9,3,6,6,plaque,1,4,375,7,35,3,106,1211,82,3850588,5
198,across,xkrcs,2,0,2,2,0,across,2,5,606,5,8,2,4801,74527,11899,76600131,4
11687,noted,not|d,1,1,0,0,1,noted,2,5,441,5,5,7,245,17629,742,29755324,5
17413,titled,tYtLd,1,0,1,0,1,titled,2,6,419,6,7,5,35,2730,361,5523946,6
13515,preen,prin,6,5,1,2,4,preen,1,4,579,6,41,11,3,59,4,77273,5
17761,troop,trup,10,9,1,3,7,troop,1,4,373,6,44,9,296,2428,651,2613768,5
4585,definite,dEfxn|t,1,1,0,0,1,definite,3,7,469,9,1,0,314,1664,290,3651600,8
18959,whimsical,hwImzIkL,1,0,1,0,1,whimsical,3,8,576,10,1,0,40,563,40,915719,7
15599,shorn,Sorn,11,9,2,8,3,shorn,1,4,569,5,44,17,13,298,4,144151,4
11885,officer,cfxsX,1,0,1,0,1,officer,3,5,539,8,4,5,5265,19414,4893,48484127,6
7387,gravy,grevi,1,0,1,0,1,gravy,2,5,354,5,13,4,269,1095,163,1441871,6
5302,drove,drov,11,8,3,5,6,drove,1,4,382,6,17,13,1472,10358,1540,5545848,5
5746,envy,Envi,2,1,1,0,2,envy,2,4,399,4,10,4,487,1754,219,2466070,5
14072,quarter,kwortX,3,2,1,0,3,quarter,2,5,463,8,44,2,1327,15838,2647,36134893,6
2002,bog,bcg,13,13,0,9,4,bog,1,3,533,4,85,38,49,500,25,1227297,4
15946,soil,sOl,13,10,3,12,1,soil,1,3,487,5,59,21,397,12714,772,23955630,4
9457,keep,kip,21,19,2,18,3,keep,1,3,335,5,109,19,35846,85894,21749,119614141,4
11690,notice,not|s,2,2,0,1,1,notice,2,5,514,7,9,4,3022,12783,2361,113693089,6
16236,squirt,skwRt,5,3,2,1,4,squirt,1,5,475,7,6,4,140,341,24,6127116,6
9264,ivory,Yvri,3,1,2,2,1,ivory,3,4,395,6,12,2,71,2138,215,7146890,5
180,acquaint,xkwent,1,0,1,1,0,acquaint,2,6,520,9,1,0,20,114,6,368772,7
5670,endorse,Indors,2,1,1,0,2,endorse,2,6,788,8,3,3,88,1524,532,3732894,7
7527,guttural,g^tXL,1,0,1,0,1,guttural,3,6,450,5,0,0,8,193,4,104317,5
6054,expire,IkspYr,1,1,0,1,0,expire,2,6,569,7,2,4,46,677,203,3381897,7
4115,crafty,kr@fti,2,1,1,1,1,crafty,2,6,446,6,11,5,53,285,35,1034420,6
17512,torrid,tcr|d,1,1,0,0,1,torrid,2,5,405,6,15,3,28,140,18,244508,5
15842,slung,sl^G,14,11,3,6,8,slung,1,4,454,4,15,9,16,862,17,255720,4
2569,canyon,k@nyxn,1,1,0,1,0,canyon,2,6,505,7,19,9,418,4996,279,11515733,7
13316,population,papyUleS|n,1,1,0,1,0,population,4,10,601,11,1,1,464,36011,3738,62452790,11
15937,soda,sodx,2,2,0,1,1,soda,2,4,459,5,37,24,1012,2907,249,3957574,5
1816,bike,bYk,19,18,1,14,5,bike,1,3,316,5,101,25,1320,8894,700,24289265,4
19263,yes,yEs,9,8,1,6,3,yes,1,3,442,4,49,31,101835,106971,69475,159601314,4
530,alloy,@lO,7,7,0,2,5,alloy,2,3,431,6,20,10,52,566,7,5468839,4
4157,credo,krido,1,0,1,0,1,credo,2,5,377,5,5,4,34,275,21,447449,5
7357,granite,gr@n|t,2,0,2,1,1,granite,2,6,417,7,10,1,81,1815,105,4921138,6
984,archaic,arkeIk,1,1,0,0,1,archaic,3,6,599,7,1,0,35,567,36,802317,6
3398,coerce,koRs,3,2,1,1,2,coerce,2,4,622,7,14,1,21,239,41,350982,5
15489,seven,sEvxn,2,2,0,2,0,seven,2,5,417,6,26,16,5327,38656,8497,44237697,6
14665,resign,rIzYn,5,4,1,3,2,resign,2,5,599,7,7,7,257,1862,906,1651986,6
16180,sprain,spren,2,1,1,1,1,sprain,1,5,542,7,12,4,43,116,10,241707,6
15912,snuff,sn^f,6,5,1,2,4,snuff,1,4,525,6,14,5,102,343,49,861230,5
16667,sulphur,s^lfX,2,1,1,0,2,sulphur,2,5,504,6,5,0,43,245,10,1852248,6
13089,plain,plen,10,6,4,4,6,plain,1,4,377,6,56,15,1113,7909,866,23749009,5
14425,reef,rif,22,19,3,11,11,reef,1,3,393,5,104,20,204,1612,132,6627391,4
11684,notation,noteS|n,2,2,0,2,0,notation,3,7,565,9,2,2,12,887,33,4594568,8
3182,circuit,sRk|t,3,2,1,1,2,circuit,2,5,550,8,11,1,340,5681,849,26918881,6
2812,ceiling,silIG,2,1,1,2,0,ceiling,2,5,552,8,35,4,426,7021,855,10391461,6
2540,cannery,k@nXi,4,2,2,1,3,cannery,3,5,545,7,17,4,13,130,2,245544,6
13579,present,prEzNt,3,2,1,2,1,present,2,7,434,8,5,7,4562,38673,3757,99421445,8
17780,truce,trus,9,6,3,1,8,truce,1,4,357,5,35,8,220,764,233,897431,5
3122,chow,CW,10,10,0,9,1,chow,1,2,421,5,76,19,350,639,45,2054998,3
9522,knack,n@k,20,19,1,15,5,knack,1,3,449,6,100,8,127,698,50,616898,4
14499,rehearsal,rIhRsL,2,1,1,1,1,rehearsal,3,7,554,10,3,1,635,2022,274,2092470,8
9065,interstate,IntXstet,1,1,0,1,0,interstate,3,8,613,11,3,2,110,2823,408,6534686,9
303,adverb,@dvRb,2,2,0,0,2,adverb,2,5,532,7,4,2,10,59,9,278164,6
7663,harmonious,harmonixs,1,1,0,0,1,harmonious,4,9,808,11,2,0,20,559,25,850280,10
17607,transform,tr@nsform,1,0,1,0,1,transform,2,9,723,10,3,1,112,3420,300,7497039,10
18879,wedding,wEdIG,1,1,0,1,0,wedding,2,5,345,8,26,7,5173,9741,2349,60761089,6
14670,resist,rIzIst,1,0,1,0,1,resist,2,6,575,7,4,7,657,4529,534,5090837,7
6386,fierce,fIrs,6,5,1,3,3,fierce,1,4,611,7,25,4,244,3239,436,2562384,5
3598,compost,kampost,1,0,1,0,1,compost,2,7,614,8,1,2,28,2378,21,1772210,8
13685,proceeds,prosidz,1,0,1,0,1,proceeds,2,7,631,8,4,4,86,2238,268,7662697,7
9634,landed,l@nd|d,1,1,0,1,0,landed,2,6,460,6,7,10,653,5458,892,3730816,6
1911,bleat,blit,14,12,2,7,7,bleat,1,4,418,6,30,9,6,64,2,152069,5
2618,carafe,kX@f,4,3,1,2,2,carafe,2,5,559,6,0,0,5,103,1,309735,4
7930,history,hIstXi,1,1,0,1,0,history,3,6,601,8,5,0,4280,71960,11973,215004685,7
10120,lore,lor,33,29,4,21,12,lore,1,3,408,5,142,45,34,808,63,1877718,4
14625,reptile,rEptL,2,2,0,2,0,reptile,2,6,649,8,1,1,72,309,33,1464532,7
2878,ceremonial,sErxmoniL,1,0,1,0,1,ceremonial,5,10,812,11,1,0,70,1252,84,1082003,11
14583,renunciation,rIn^nsieS|n,1,1,0,1,0,renunciation,5,11,708,13,2,2,11,201,13,264809,12
6294,fed,fEd,20,18,2,14,6,fed,1,3,429,4,71,33,810,9254,2064,12010245,4
9744,leakage,likIJ,1,1,0,1,0,leakage,2,5,519,5,2,0,28,425,38,2060270,5
5239,drag,dr@g,7,6,1,3,4,drag,1,4,417,5,21,14,1349,4424,579,9151134,5
16159,spoke,spok,9,7,2,4,5,spoke,1,4,559,6,20,10,1970,19237,5232,11577917,5
16837,sworn,sworn,6,4,2,2,4,sworn,1,5,617,5,11,8,494,1697,557,2332355,6
5624,emphatic,Imf@tIk,1,0,1,1,0,emphatic,3,7,758,9,0,0,15,460,57,328145,8
18885,weep,wip,18,16,2,12,6,weep,1,3,309,5,70,17,280,776,83,1039530,4
4218,crop,krap,9,8,1,4,5,crop,1,4,415,5,47,20,248,4829,463,11245815,5
1824,bill,bIl,35,28,7,22,13,bill,1,3,274,5,136,33,6041,60645,28600,98504498,4
1173,assured,xSUrd,1,0,1,0,1,assured,2,5,628,8,3,3,316,4132,460,6038675,5
15162,satire,s@tYr,1,1,0,1,0,satire,3,5,652,7,8,4,33,783,181,2338817,6
17190,Thai,tY,34,22,12,18,16,thai,1,2,355,5,126,19,167,2063,175,13729139,3
3958,core,kor,36,26,10,20,16,core,1,3,409,5,166,53,501,13514,1639,51254699,4
3464,colonel,kRnL,5,5,0,3,2,colonel,2,5,375,8,32,1,4909,4579,1493,4118477,6
793,anterior,@ntIriX,1,1,0,1,0,anterior,4,7,637,9,2,2,48,900,7,2316239,8
18865,weary,wIri,11,8,3,8,3,weary,2,4,599,6,54,15,212,1959,167,1632945,5
10517,massive,m@sIv,2,2,0,2,0,massive,2,5,547,8,7,3,508,11847,2654,19461181,6
12384,paradise,p@rxdYs,1,1,0,0,1,paradise,3,7,758,8,3,2,676,2981,380,13190672,7
3539,common,kamxn,3,1,2,1,2,common,2,5,367,7,61,2,2275,39834,4956,107843433,6
14139,rabble,r@bL,11,10,1,6,5,rabble,2,5,312,5,49,7,54,212,25,565518,6
14851,rise,rYz,21,17,4,10,11,rise,1,3,485,5,140,43,1399,19257,2506,29537255,4
12691,people,pipL,5,4,1,3,2,people,2,5,391,7,15,3,56252,446988,194403,480323270,6
18649,vivid,vIv|d,2,2,0,2,0,vivid,2,5,499,6,1,2,104,2475,247,4485682,6
1052,around,xrWnd,4,2,2,4,0,around,2,3,670,5,16,4,37573,164556,35709,178814813,4
13447,prance,pr@ns,3,2,1,3,0,prance,1,5,539,7,12,9,39,84,7,84700,6
15611,shovel,S^vL,4,3,1,1,3,shovel,2,5,536,7,6,8,349,1272,184,1031406,6
10361,manager,m@nIJX,1,0,1,0,1,manager,3,6,479,8,5,8,2038,18549,1986,87447209,7
11667,north,norT,4,3,1,1,3,north,1,4,373,6,25,11,3258,55704,10461,217815348,5
13436,practically,pr@ktIkLi,1,0,1,0,1,practically,3,9,581,10,1,0,1165,4375,643,4363252,8
13448,prank,pr@Gk,7,6,1,7,0,prank,1,5,340,6,16,9,204,321,60,826645,6
14582,rental,rEntL,7,6,1,6,1,rental,2,6,427,7,14,8,246,2582,244,71014742,7
17686,tress,trEs,11,9,2,4,7,tress,1,4,411,6,26,13,6,38,3,170140,5
16512,stub,st^b,11,7,4,3,8,stub,1,4,475,5,30,11,49,324,13,2185336,5
17803,tryst,trIst,4,3,1,4,0,tryst,1,5,403,4,24,3,20,118,16,209168,6
2171,breath,brET,3,2,1,0,3,breath,1,4,349,7,20,8,2291,14551,1028,10210684,5
4766,despair,dIspEr,1,1,0,0,1,despair,2,6,602,8,4,3,299,2862,389,2380036,7
13557,preparation,prEpXeS|n,1,0,1,1,0,preparation,4,9,818,12,2,2,206,7349,479,25268975,10
7811,hence,hEns,10,8,2,7,3,hence,1,4,384,6,38,15,247,5439,166,14995785,5
15240,school,skul,8,7,1,3,5,school,1,4,576,7,26,6,16989,167495,21082,343078373,5
10859,mind,mYnd,12,11,1,8,4,mind,1,4,488,5,39,29,24715,54610,11786,75405356,5
9407,jumble,J^mbL,7,6,1,6,1,jumble,2,6,422,7,12,9,16,496,20,715330,7
4782,destroy,dIstrO,1,1,0,0,1,destroy,2,6,582,8,3,1,2406,5920,1587,9813684,7
6246,fast,f@st,15,13,2,10,5,fast,1,4,556,5,43,30,7010,27159,4587,93956028,5
12195,overplay,ovXple,1,0,1,0,1,overplay,3,6,619,9,4,3,7,48,16,211081,7
5183,donation,doneS|n,1,1,0,1,0,donation,3,7,548,9,1,1,179,1559,208,11247520,8
6880,fungicide,f^nJ|sYd,1,0,1,0,1,fungicide,3,8,707,10,1,1,3,79,4,439063,9
14103,quilt,kwIlt,4,0,4,2,2,quilt,1,5,341,6,12,9,39,1474,39,5187688,6
17806,tube,tub,12,8,4,2,10,tube,1,4,340,5,6,20,838,6131,584,17269087,4
13253,polo,polo,7,5,2,3,4,polo,2,4,396,5,36,21,178,1316,118,8045348,5
15283,screw,skru,4,3,1,3,1,screw,1,4,520,6,14,5,1912,2370,290,8178278,5
12237,pace,pes,30,22,8,18,12,pace,1,3,467,5,74,36,488,8256,889,12251129,4
7438,grocery,grosXi,1,0,1,0,1,grocery,3,6,469,7,8,2,280,4496,647,9699375,7
12933,phylum,fYlxm,1,1,0,1,0,phylum,2,5,698,5,6,0,7,41,2,510826,5
18916,what,hwat,7,5,2,3,4,what,1,3,321,5,61,19,501965,755309,320102,812428199,4
1472,balloon,bxlun,2,2,0,1,1,balloon,2,5,560,8,11,4,442,2521,492,6720528,6
6978,gamut,g@mxt,3,2,1,1,2,gamut,2,5,559,5,11,3,13,458,64,559805,6
718,anger,@GgX,3,2,1,1,2,anger,2,4,320,6,12,29,991,10499,2478,7991258,5
15202,scamper,sk@mpX,1,0,1,0,1,scamper,2,6,688,8,8,6,13,122,5,90165,7
2946,chaps,C@ps,7,5,2,4,3,chaps,1,4,456,5,37,14,131,201,14,791470,4
15935,socket,sak|t,6,6,0,6,0,socket,2,5,592,7,12,7,82,694,30,12770920,6
12181,overhaul,ovXhcl,1,0,1,0,1,overhaul,3,6,504,9,3,1,24,1337,254,1684772,7
12594,peat,pit,31,26,5,20,11,peat,1,3,341,5,97,26,13,606,19,1223084,4
16922,tacky,t@ki,13,11,2,4,9,tacky,2,4,442,5,46,8,134,455,77,519106,5
11557,nifty,nIfti,1,1,0,1,0,nifty,2,5,488,4,4,2,71,405,32,1981740,4
9537,knit,nIt,28,27,1,22,6,knit,1,3,325,5,85,11,97,1527,177,5113070,4
13645,prince,prIns,3,2,1,2,1,prince,1,5,411,7,14,5,2299,9494,2606,23979830,6
5733,entry,Entri,2,0,2,2,0,entry,2,5,389,6,4,4,620,7513,567,80720070,6
5028,disparate,dIsp@rxt,1,0,1,0,1,disparate,3,7,599,8,2,1,7,1190,96,1280509,6
2189,brief,brif,8,6,2,3,5,brief,1,4,295,6,37,7,732,10926,1391,32599674,5
437,aim,em,21,11,10,13,8,aim,1,2,397,4,88,35,758,6116,618,28955618,3
10028,live,lIv,15,13,2,7,8,live,1,3,499,5,50,33,17574,65328,22022,166016512,4
1717,bell,bEl,27,22,5,18,9,bell,1,3,395,5,148,44,2006,10969,1404,25286532,4
13022,pink,pIGk,16,10,6,12,4,pink,1,4,429,5,49,31,1452,9799,640,41726352,5
483,alien,elixn,2,2,0,1,1,alien,3,5,460,6,10,9,889,4657,454,10502558,6
11843,occult,xk^lt,2,1,1,2,0,occult,2,5,589,5,2,0,80,347,17,1769403,5
5168,domain,domen,2,2,0,2,0,domain,2,5,557,7,10,6,132,4259,241,88102462,6
15676,silent,sYlxnt,1,1,0,0,1,silent,2,6,513,7,5,0,1173,9685,905,12774071,7
3153,chum,C^m,16,14,2,11,5,chum,1,3,478,5,48,18,156,264,24,579859,4
11712,now,nW,16,15,1,9,7,now,1,2,413,4,92,35,163333,399097,174178,611394332,3
5160,doll,dal,16,14,2,9,7,doll,1,3,316,5,121,30,1263,2943,405,12051620,4
15978,solve,sclv,1,1,0,0,1,solve,1,4,429,6,21,7,994,7752,2430,13452605,5
19115,witty,wIti,7,6,1,4,3,witty,2,4,449,5,54,13,163,862,106,1753886,5
13875,prude,prud,10,9,1,4,6,prude,1,4,342,6,33,9,70,51,5,96547,5
12529,patent,p@tNt,3,1,2,1,2,patent,2,6,562,7,10,5,126,2950,286,21613489,7
6165,fad,f@d,19,18,1,15,4,fad,1,3,486,4,56,33,39,497,73,1105997,4
14175,rag,r@g,28,24,4,17,11,rag,1,3,381,4,78,47,244,1217,107,2387246,4
10189,lung,l^G,18,15,3,12,6,lung,1,3,379,5,49,33,420,3034,628,10318853,4
6885,funny,f^ni,11,10,1,8,3,funny,2,4,415,5,36,8,11127,12458,4466,34294708,5
13807,prosecute,prasIkyut,1,0,1,0,1,prosecute,3,9,644,10,0,2,144,1241,581,1104300,10
12048,ornate,ornet,1,0,1,0,1,ornate,2,5,472,7,2,2,10,810,28,844908,6
15540,shawl,Scl,16,15,1,16,0,shawl,1,3,539,6,92,5,70,516,20,1011728,4
9795,legion,liJ|n,2,2,0,2,0,legion,2,5,596,7,15,3,126,1119,106,2923526,6
3074,chip,CIp,24,22,2,16,8,chip,1,3,343,5,57,17,1051,5457,926,19822862,4
3852,contraction,kxntr@kS|n,1,1,0,0,1,contraction,3,10,659,12,2,2,55,697,54,1688692,11
12415,parch,parC,10,8,2,4,6,parch,1,4,364,6,24,12,2,32,23,30234,5
8258,igloo,Iglu,1,0,1,1,0,igloo,2,4,493,4,4,0,15,108,16,397625,4
16684,sunder,s^ndX,6,4,2,5,1,sunder,2,5,473,7,24,15,2,18,1,125141,6
12503,passive,p@sIv,3,3,0,1,2,passive,2,5,511,8,5,1,111,2804,288,6357851,6
7959,hole,hol,31,28,3,22,9,hole,1,3,519,5,142,50,2969,13106,1570,26202887,4
19006,whomever,humEvX,1,0,1,1,0,whomever,3,6,509,5,1,1,62,424,136,741766,4
5419,earthy,RTi,2,1,1,1,1,earthy,2,3,469,6,21,4,21,647,35,533770,3
9152,invite,InvYt,4,4,0,3,1,invite,2,5,517,7,8,6,1509,3423,674,11996795,6
1228,atone,xton,5,4,1,3,2,atone,2,4,492,6,9,7,43,148,12,154979,5
542,aloe,@lo,20,11,9,14,6,aloe,2,3,519,4,64,12,15,158,10,1897405,4
4171,crept,krEpt,3,2,1,2,1,crept,1,5,345,5,11,4,58,1268,62,590578,5
8056,hot,hat,28,26,2,23,5,hot,1,3,394,4,131,48,9682,33900,4806,159296822,4
17663,treason,trizN,1,0,1,1,0,treason,2,6,501,8,4,4,259,556,100,1155400,7
10451,marina,mXinx,1,0,1,0,1,marina,3,5,595,7,21,16,240,1662,138,7636265,6
17353,tight,tYt,30,25,5,18,12,tight,1,3,267,6,91,13,2597,11930,1415,17983507,4
4670,demonstrate,dEmxnstret,1,0,1,0,1,demonstrate,3,10,721,12,2,3,238,6888,696,14807121,11
6816,fritter,frItX,1,1,0,1,0,fritter,2,5,450,8,16,6,15,67,7,62574,6
208,actual,@kCuL,2,0,2,1,1,actual,2,5,592,7,5,1,884,13849,2378,42552937,6
4747,descend,dIsEnd,2,2,0,1,1,descend,2,6,518,8,11,2,98,1172,102,1079518,7
6842,frozen,frozN,1,0,1,0,1,frozen,2,6,482,6,6,2,782,7718,719,9167199,5
9542,knock,nak,19,19,0,15,4,knock,1,3,372,6,102,8,3299,4486,902,5196936,4
5356,dunce,d^ns,4,3,1,3,1,dunce,1,4,469,5,26,10,25,55,8,117172,5
4466,day,de,27,20,7,15,12,day,1,2,245,4,163,54,40893,204040,52473,446243266,3
3375,cockle,kakL,6,5,1,1,5,cockle,2,5,374,7,34,4,4,19,0,129341,6
7374,gratify,gr@t|fY,1,0,1,1,0,gratify,3,7,595,8,3,1,8,63,3,129689,8
4290,cult,k^lt,7,4,3,4,3,cult,1,4,599,5,38,14,227,2689,628,6369223,5
11969,opposite,apxz|t,1,1,0,1,0,opposite,3,6,572,9,2,1,775,12369,1646,11965615,7
4768,desperate,dEspXxt,1,0,1,0,1,desperate,2,7,649,10,1,0,1310,6312,1811,9350873,6
2822,cell,sEl,26,19,7,19,7,cell,1,3,359,5,133,35,2772,17288,3641,113072063,4
16681,summons,s^mxnz,1,0,1,0,1,summons,2,6,492,8,26,3,81,477,25,1353994,7
3634,conch,kaGk,4,1,3,1,3,conch,1,4,428,6,29,6,20,315,22,379190,5
9682,lasso,l@so,3,2,1,1,2,lasso,2,4,398,5,27,13,45,131,7,573529,4
17111,tender,tEndX,7,5,2,4,3,tender,2,5,467,7,27,22,453,5358,268,8921535,6
5192,door,doX,13,10,3,2,11,door,1,3,338,5,138,21,14895,61644,6657,56642825,4
2982,chat,C@t,22,17,5,16,6,chat,1,3,346,5,60,32,830,2994,745,83643143,4
6807,friend,frEnd,5,3,2,4,1,friend,1,5,472,7,22,6,21384,39344,9083,154539828,6
11186,mother,m^DX,4,2,2,2,2,mother,2,4,569,7,21,12,24476,90785,16011,57436148,5
1593,bast,b@st,18,15,3,14,4,bast,1,4,491,5,58,40,13,43,4,286873,5
9480,kill,kIl,36,31,5,26,10,kill,1,3,424,5,145,32,23081,20637,6580,24861591,4
15845,slush,sl^S,10,9,1,4,6,slush,1,4,569,6,16,8,28,319,39,389608,5
7725,health,hElT,7,6,1,1,6,health,1,4,372,7,20,4,2054,104031,20117,440421164,5
4530,declamation,dEklxmeS|n,1,1,0,1,0,declamation,4,10,810,6,2,2,0,19,0,44168,6
10576,maxim,m@ksxm,1,0,1,0,1,maxim,2,6,649,6,11,9,65,470,37,3826819,7
13724,profound,prxfWnd,1,1,0,1,0,profound,2,7,718,9,0,1,213,4698,673,4168371,8
4031,cottage,katIJ,3,2,1,3,0,cottage,2,5,413,8,8,2,270,2607,157,10524011,5
10242,made,med,24,21,3,14,10,made,1,3,516,5,110,43,28626,188424,40007,287363423,4
7369,grasp,gr@sp,3,0,3,2,1,grasp,1,5,489,6,12,6,233,3666,269,3271967,6
9760,leaves,livz,8,5,3,6,2,leaves,1,4,432,6,61,14,2316,19817,1859,22612896,4
10805,midst,mIdst,1,0,1,1,0,midst,1,5,500,6,9,3,175,3539,598,3381410,6
16819,swig,swIg,10,9,1,3,7,swig,1,4,449,5,23,9,48,313,9,377915,5
1355,averse,xvRs,4,2,2,2,2,averse,2,4,530,6,6,6,15,372,31,426255,5
19304,zephyr,zEfX,1,1,0,1,0,zephyr,2,4,520,7,18,1,50,127,7,1334891,5
1485,banana,b|n@nx,1,0,1,0,1,banana,3,6,380,7,2,2,547,2273,221,5572067,7
13973,pure,pyUr,2,1,1,1,1,pure,1,4,307,5,8,28,1271,8072,962,22842684,5
9304,jeans,Jinz,4,3,1,2,2,jeans,1,4,482,6,77,11,337,5598,514,11899652,4
18351,vary,vEri,10,7,3,8,2,vary,2,4,426,5,100,20,47,5102,194,21033431,5
9519,kitten,kItN,7,6,1,5,2,kitten,2,5,359,7,52,6,241,574,60,3052310,6
6572,flounder,flWndX,1,0,1,1,0,flounder,2,6,592,9,3,2,43,323,12,588770,7
17290,thrash,Tr@S,5,4,1,4,1,thrash,1,4,556,7,13,4,27,238,25,901098,5
5236,draft,dr@ft,7,3,4,5,2,draft,1,5,498,6,15,8,371,8710,1119,35035340,6
9660,lapse,l@ps,8,4,4,4,4,lapse,1,4,499,6,47,8,70,680,99,1459542,5
5858,essay,Ese,4,2,2,3,1,essay,2,3,368,6,25,5,313,5864,594,11750312,4
15507,shabby,S@bi,7,5,2,4,3,shabby,2,4,539,5,21,0,87,775,44,1081095,4
345,affair,xfEr,4,3,1,2,2,affair,2,4,413,7,18,1,1502,5712,1745,5545856,5
4887,differ,dIfX,7,7,0,1,6,differ,2,4,395,7,33,3,124,4299,327,10224024,5
2556,cantaloupe,k@ntxlop,1,0,1,1,0,cantaloupe,3,8,561,11,2,1,38,322,17,214978,9
15199,scalp,sk@lp,2,1,1,0,2,scalp,1,5,507,6,8,9,188,1216,110,1356840,6
5604,emerge,ImRJ,3,2,1,1,2,emerge,2,4,593,7,8,6,88,5197,578,4250813,5
13287,ponder,pandX,5,4,1,4,1,ponder,2,5,431,7,21,15,56,854,62,1290410,6
3432,cold,kold,15,11,4,10,5,cold,1,4,408,5,76,29,6638,33636,4763,40844411,5
18349,varnish,varnIS,2,2,0,2,0,varnish,2,6,566,8,6,5,21,417,9,752945,7
14743,revelation,rEvxleS|n,2,2,0,1,1,revelation,4,9,908,11,3,1,140,2884,380,5407694,10
14877,roar,ror,31,28,3,19,12,roar,1,3,449,5,124,20,205,1842,122,1444070,4
14254,rate,ret,39,29,10,28,11,rate,1,3,331,5,125,48,1271,35665,5586,207637984,4
14654,reserve,rIzRv,2,1,1,1,1,reserve,2,5,531,8,6,9,366,7949,1534,35519791,6
16524,stuff,st^f,10,8,2,2,8,stuff,1,4,539,6,33,10,15653,27542,11015,81467658,5
2579,cape,kep,26,21,5,15,11,cape,1,3,324,5,87,33,420,3760,502,28850867,4
7254,go,go,26,16,10,17,9,go,1,2,290,3,145,47,193445,239504,102899,421086358,3
13911,pucker,p^kX,8,7,1,5,3,pucker,2,4,449,6,26,12,45,102,11,188643,4
3471,color,k^lX,8,4,4,2,6,color,2,4,386,6,78,7,2011,44922,2923,112974969,5
11865,odd,ad,15,5,10,13,2,odd,1,2,349,4,72,16,1226,7882,1390,11877432,3
1837,binge,bInJ,5,4,1,3,2,binge,1,4,380,6,25,22,47,849,122,850412,5
3310,clog,klag,6,5,1,2,4,clog,1,4,469,5,24,13,41,336,43,791336,5
9411,junction,J^GkS|n,2,1,1,2,0,junction,2,7,592,6,2,2,150,1164,114,9946903,5
4870,dictate,dIktet,1,0,1,0,1,dictate,2,6,379,8,4,5,89,1299,253,1492760,7
10016,litigate,lIt|get,1,1,0,1,0,litigate,3,7,670,9,1,3,4,130,25,174411,8
19061,winder,wYndX,2,2,0,2,0,winder,2,5,520,7,28,33,5,147,6,629454,6
5412,earnest,Rn|st,1,1,0,1,0,earnest,2,5,579,8,3,2,80,1772,140,1968639,6
1187,astral,@strL,1,1,0,1,0,astral,2,6,407,6,3,3,49,79,2,1205159,7
16149,splice,splYs,2,0,2,1,1,splice,1,5,718,7,3,4,20,88,12,1081416,6
2257,brush,br^S,5,4,1,4,1,brush,1,4,418,6,33,16,722,6823,548,10018684,5
3317,closure,kloZX,3,3,0,1,2,closure,2,5,456,8,9,3,158,2110,388,8208148,6
10220,mace,mes,29,25,4,18,11,mace,1,3,479,5,98,35,178,454,38,1297640,4
17177,testimony,tEst|moni,1,0,1,0,1,testimony,4,9,604,9,1,0,752,6978,2867,9893472,10
1160,assist,xsIst,1,0,1,1,0,assist,2,5,549,7,4,3,400,4926,445,29964870,6
3109,choppy,Capi,4,3,1,2,2,choppy,2,4,539,6,17,3,13,318,35,361375,4
17022,tax,t@ks,9,6,3,3,6,tax,1,4,433,4,95,36,742,40830,15658,146911524,5
348,affection,xfEkS|n,1,1,0,1,0,affection,3,7,718,10,1,1,431,2454,336,2332707,8
17872,tutor,tutX,8,7,1,5,3,tutor,2,4,331,6,42,5,235,789,52,4636301,5
16939,talent,t@l|nt,2,1,1,1,1,talent,2,6,449,7,9,3,1332,8405,1257,12712170,7
17121,tennis,tEn|s,4,3,1,1,3,tennis,2,5,472,7,13,5,695,6047,896,26272328,6
17439,toil,tOl,15,13,2,14,1,toil,1,3,479,5,57,14,51,357,25,610151,4
15187,saw,sc,23,18,5,11,12,saw,1,2,451,4,93,40,20527,68093,17933,48554082,3
7465,grow,gro,18,10,8,9,9,grow,1,3,362,5,82,20,3034,18931,3196,26701749,4
12251,pact,p@kt,10,6,4,4,6,pact,1,4,313,5,49,20,192,1647,302,2172780,5
2095,bound,bWnd,14,13,1,13,1,bound,1,4,329,6,29,13,940,7930,883,22303643,5
1055,arraign,xren,10,7,3,8,2,arraign,2,3,487,8,101,0,7,4,1,16889,4
15996,soon,sun,24,21,3,18,6,soon,1,3,488,5,86,28,13140,43520,7892,77046620,4
18551,Viking,vYkIG,1,1,0,1,0,viking,2,5,454,7,7,5,141,1064,81,5116423,6
6597,flute,flut,12,10,2,2,10,flute,1,4,409,6,29,9,108,881,86,4091997,5
17464,tone,ton,33,27,6,23,10,tone,1,3,529,5,100,47,860,10197,1292,17399919,4
11732,nugget,n^g|t,1,1,0,1,0,nugget,2,5,440,7,2,1,60,249,31,1148504,6
5211,doubly,d^bLi,1,0,1,0,1,doubly,2,5,440,6,14,2,28,494,59,649237,5
5818,erotic,IratIk,1,1,0,1,0,erotic,3,6,629,7,2,2,200,1185,77,17423350,7
948,apt,@pt,8,6,2,6,2,apt,1,3,462,4,29,17,89,1654,173,6186321,4
15893,sneeze,sniz,3,2,1,1,2,sneeze,1,4,566,7,46,2,150,352,72,366864,5
7462,grouse,grWs,6,6,0,0,6,grouse,1,4,418,7,32,12,23,427,4,805156,5
3102,cholera,kalXx,2,1,1,0,2,cholera,3,5,472,7,14,1,56,557,134,794749,6
19000,who,hu,31,25,6,19,12,who,1,2,402,4,178,16,113370,644483,171311,630937884,3
12999,pillage,pIlIJ,3,3,0,3,0,pillage,2,5,422,8,8,7,31,102,17,244338,6
10192,lurch,lRC,8,8,0,6,2,lurch,1,3,456,6,37,8,43,432,40,209481,4
18699,vomit,vamxt,1,1,0,1,0,vomit,2,5,589,6,3,2,272,593,65,767668,6
16434,straighten,stretN,1,0,1,0,1,straighten,2,7,482,11,5,2,571,1051,197,717631,8
12548,patriarchal,petriarkL,2,1,1,1,1,patriarchal,4,10,674,11,2,1,14,856,22,434296,10
14828,rigid,rIJ|d,1,0,1,1,0,rigid,2,5,393,6,5,1,95,2582,178,4240390,5
14111,quip,kwIp,10,8,2,4,6,quip,1,4,464,5,24,9,7,170,15,200205,5
7218,gloat,glot,8,6,2,4,4,gloat,1,4,486,6,18,7,80,96,16,115465,5
6708,former,formX,2,1,1,0,2,former,2,5,433,7,13,10,932,58385,16926,46917563,6
13143,pledge,plEJ,4,3,1,3,1,pledge,1,4,359,7,10,7,351,2605,992,6025016,5
3303,clip,klIp,11,9,2,5,6,clip,1,4,333,5,34,11,290,9267,7443,31268599,5
3333,cluck,kl^k,11,10,1,2,9,cluck,1,4,382,6,45,11,73,108,7,134048,5
9528,knee,ni,31,23,8,19,12,knee,1,2,279,5,192,10,749,8248,537,8426957,3
3020,cherish,CErIS,1,1,0,1,0,cherish,2,5,518,8,12,0,227,604,109,1056520,6
4141,crazy,krezi,1,0,1,0,1,crazy,2,5,491,5,11,4,13886,13306,3951,23058006,6
4687,dense,dEns,11,10,1,8,3,dense,1,4,399,6,44,14,108,3257,150,5225392,5
11231,muffin,m^fxn,2,2,0,2,0,muffin,2,5,349,7,9,7,297,810,46,1097058,6
9171,ion,Y|n,4,1,3,4,0,ion,2,3,414,4,67,53,20,1069,68,12088167,4
12974,pidgin,pIJ|n,1,1,0,1,0,pidgin,2,5,420,5,11,0,3,94,0,215572,6
1940,blockhead,blakhEd,1,1,0,1,0,blockhead,2,7,475,10,2,1,41,32,2,188383,8
7316,goulash,gulaS,1,1,0,1,0,goulash,2,5,497,6,3,0,41,55,12,270065,5
11322,mutter,m^tX,15,12,3,11,4,mutter,2,4,364,7,45,19,22,344,33,387001,5
6918,fuzz,f^z,10,10,0,7,3,fuzz,1,3,467,5,40,3,95,285,21,616736,4
17804,tub,t^b,17,16,1,11,6,tub,1,3,378,4,37,23,647,2127,254,8994914,4
2344,burial,bEriL,3,1,2,1,2,burial,3,6,444,7,15,3,242,1796,187,4258160,7
6158,fact,f@kt,6,3,3,3,3,fact,1,4,444,5,29,15,8801,92841,36348,93809393,5
3578,complacence,k^mplesNs,1,1,0,1,0,complacence,3,10,654,11,3,1,0,9,1,11639,11
13919,puff,p^f,14,14,0,7,7,puff,1,3,549,5,36,14,227,1052,115,1897207,4
5335,duet,duEt,1,0,1,1,0,duet,2,4,536,5,16,15,66,486,87,1335288,5
7399,Greek,grik,11,10,1,4,7,greek,1,4,296,6,48,8,578,6197,603,25060054,5
17527,tote,tot,30,23,7,18,12,tote,1,3,359,5,68,34,55,747,49,3762183,4
15560,shelve,SElv,5,3,2,2,3,shelve,1,4,463,7,14,3,10,81,7,144355,5
15517,shaken,Sek|n,3,3,0,3,0,shaken,2,5,464,6,12,6,169,1765,300,1218549,5
8143,hurtle,hRtL,6,5,1,4,2,hurtle,2,5,314,6,26,6,1,54,0,48093,5
9156,invoke,Invok,1,0,1,1,0,invoke,2,5,614,7,3,2,51,792,106,2318419,6
19030,wig,wIg,20,16,4,11,9,wig,1,3,398,4,72,29,426,847,156,2156534,4
7621,handle,h@ndL,7,6,1,4,3,handle,2,6,508,7,35,13,5529,14094,2810,32319924,7
346,affect,xfEkt,2,2,0,2,0,affect,2,5,511,7,4,4,568,13544,2444,24406141,6
7586,half,h@f,18,17,1,6,12,half,1,3,474,5,68,16,10156,75379,14263,86293469,4
1803,bid,bId,25,21,4,15,10,bid,1,3,281,4,83,36,642,4950,810,70433832,4
11180,moss,mcs,15,14,1,12,3,moss,1,3,480,5,90,44,145,2605,209,5520302,4
18423,verb,vRb,6,5,1,2,4,verb,1,3,411,5,20,16,54,1022,64,3727646,4
12011,order,ordX,5,2,3,4,1,order,2,4,331,6,16,12,7985,57313,9926,336636174,5
4340,cushion,kUS|n,1,1,0,1,0,cushion,2,5,402,8,10,2,110,1320,127,3556775,6
13244,polity,palxti,1,1,0,1,0,polity,3,6,485,6,1,5,0,531,8,514984,6
1715,believe,bxliv,2,2,0,0,2,believe,2,5,738,8,10,5,31882,78145,34199,75923984,6
3288,click,klIk,19,14,5,8,11,click,1,4,352,6,67,16,327,4675,804,536761994,5
14930,rotate,rotet,1,0,1,0,1,rotate,2,5,411,7,2,3,98,1030,87,2858195,6
4130,crate,kret,16,13,3,9,7,crate,1,4,419,6,46,19,209,750,47,2337346,5
14461,refuse,rIfyuz,1,1,0,0,1,refuse,2,6,738,7,5,11,1070,4023,737,7908041,7
139,accost,xkcst,2,1,1,2,0,accost,2,5,728,7,2,0,3,33,2,31284,6
12358,pants,p@ns,11,8,3,7,4,pants,1,5,549,6,42,22,2996,7382,787,16776712,6
16802,sway,swe,9,4,5,5,4,sway,1,3,435,5,38,19,129,1344,167,1540461,4
3308,clock,klak,15,13,2,5,10,clock,1,4,407,6,61,14,2990,10918,1884,26632748,5
10988,mobilize,mobxlYz,2,0,2,1,1,mobilize,3,7,686,9,6,2,52,966,182,869760,8
16917,tacit,t@s|t,1,1,0,1,0,tacit,2,5,365,6,10,3,7,533,43,600775,6
18255,utter,^tX,12,6,6,12,0,utter,2,3,370,6,35,17,257,1670,222,2096533,4
7332,grade,gred,14,12,2,4,10,grade,1,4,379,6,40,29,1493,18111,1672,54276217,5
13423,pound,pWnd,9,9,0,8,1,pound,1,4,480,6,25,12,708,9277,894,13620117,5
6884,funnel,f^nL,9,8,1,5,4,funnel,2,5,369,7,20,4,56,725,96,1073571,6
6994,gap,g@p,20,19,1,12,8,gap,1,3,407,4,68,43,218,8744,1323,17274391,4
14678,resource,risors,1,1,0,1,0,resource,2,6,512,9,3,1,83,8425,425,99975153,7
5438,echo,Eko,2,2,0,1,1,echo,2,3,350,5,40,4,350,2682,254,19417758,4
2384,buxom,b^ksxm,1,1,0,0,1,buxom,2,6,503,4,1,0,5,105,5,239088,5
17902,tycoon,tYkun,1,1,0,1,0,tycoon,2,5,624,7,3,1,52,334,56,2432605,6
17835,tune,tun,27,23,4,18,9,tune,1,3,447,5,76,20,796,4694,1202,10729632,4
12668,pennies,pEniz,1,0,1,0,1,pennies,2,5,446,7,19,2,174,748,141,979169,5
14768,revolve,rIvalv,3,2,1,3,0,revolve,2,6,644,8,4,7,35,427,38,576832,7
8771,inform,Inform,2,0,2,0,2,inform,2,6,601,7,3,2,644,3184,342,11659013,7
14359,reclaim,rIklem,1,1,0,1,0,reclaim,2,6,579,8,2,1,71,901,135,1292244,7
3696,confirm,kxnfRm,1,0,1,0,1,confirm,2,6,609,8,5,2,736,3786,851,22651956,7
9126,invent,InvEnt,4,4,0,2,2,invent,2,6,553,7,7,5,235,1153,154,1413503,7
7548,habit,h@b|t,2,2,0,2,0,habit,2,5,395,6,9,4,738,4621,437,4881794,6
14225,ransom,r@nsxm,3,2,1,2,1,ransom,2,6,563,7,11,8,498,818,262,1423196,7
17833,tuna,tunx,3,2,1,0,3,tuna,2,5,355,5,2,16,408,2198,270,2844261,4
5787,equalizer,ikwxlYzX,1,0,1,0,1,equalizer,4,8,761,9,2,3,21,132,17,1059636,8
5275,dresser,drEsX,1,0,1,0,1,dresser,2,5,483,8,16,14,182,1154,81,1652504,6
15349,section,sEkS|n,2,1,1,2,0,section,2,6,513,8,9,2,1394,24509,1347,232256332,7
4114,craftsman,kr@ftsmxn,1,1,0,1,0,craftsman,2,9,582,10,4,3,47,573,24,1891788,10
5812,erase,Ires,5,4,1,5,0,erase,2,4,659,6,11,13,317,1146,160,3086851,5
3402,coffee,kcfi,2,1,1,0,2,coffee,2,4,404,7,33,8,7371,17128,1589,42090859,5
6914,futility,fyUtIl|ti,1,0,1,1,0,futility,4,9,659,6,1,1,25,564,42,429773,5
4426,dander,d@ndX,5,5,0,3,2,dander,2,5,444,6,22,20,15,112,16,142544,6
14169,radius,redixs,1,1,0,0,1,radius,3,6,481,6,4,2,224,1079,78,8993343,6
3026,chess,CEs,11,9,2,8,3,chess,1,3,505,6,50,8,380,1812,305,8298391,4
18277,vague,veg,4,4,0,1,3,vague,1,3,426,6,23,10,231,2876,374,2784135,4
4263,cry,krY,10,7,3,6,4,cry,1,3,382,4,52,19,3348,8936,1708,11631614,4
14532,religion,rIlIJ|n,1,1,0,0,1,religion,3,7,411,9,3,2,707,15712,2580,40095624,8
9481,killing,kIlIG,7,6,1,7,0,killing,2,5,373,8,37,17,3965,12431,4276,12107628,6
11543,next,nEkst,2,1,1,1,1,next,1,4,493,5,59,10,23090,129681,39639,425919225,5
16531,stung,st^G,12,8,4,5,7,stung,1,4,562,5,23,12,78,917,87,409531,5
1065,arrow,@ro,18,11,7,16,2,arrow,2,3,298,6,101,16,400,2410,110,11564588,4
3403,coffer,kcfX,3,1,2,1,2,coffer,2,4,454,7,28,12,5,37,4,96057,5
15315,scuttle,sk^tL,2,1,1,1,1,scuttle,2,6,548,8,5,3,41,192,31,186519,7
9041,intern,IntRn,5,1,4,1,4,intern,2,5,488,7,8,2,232,981,113,3655396,6
11363,naivety,naivxti,1,1,0,0,1,naivety,4,7,486,7,0,2,1,20,10,67837,4
19015,why,hwY,6,1,5,1,5,why,1,2,405,4,141,16,114687,150781,58174,192016215,3
1904,blazer,blezX,2,1,1,0,2,blazer,2,5,477,7,21,13,62,764,55,1843932,6
3229,clam,kl@m,16,11,5,4,12,clam,1,4,569,5,58,24,200,512,62,1619241,5
15921,sober,sobX,3,3,0,2,1,sober,2,4,555,6,39,26,515,1811,372,1672710,5
17245,these,Diz,9,7,2,8,1,these,1,3,469,6,107,7,46104,335492,92666,541021418,4
12145,outside,WtsYd,2,1,1,0,2,outside,2,5,566,8,5,4,8671,53755,9911,67421208,6
5379,dust,d^st,8,8,0,6,2,dust,1,4,474,5,35,25,1216,9815,728,14997690,5
18353,vase,ves,16,15,1,13,3,vase,1,3,356,5,44,24,196,988,28,4094042,4
2256,brunt,br^nt,6,4,2,5,1,brunt,1,5,451,6,32,20,25,568,141,489270,6
15519,shale,Sel,27,26,1,21,6,shale,1,3,492,6,120,21,9,748,47,769742,4
15626,shrine,SrYn,5,4,1,3,2,shrine,1,4,619,7,24,7,151,1565,175,2302579,5
5347,dumb,d^m,29,26,3,18,11,dumb,1,3,589,5,94,8,2395,2940,629,5413109,4
11075,monkey,m^Gki,1,0,1,0,1,monkey,2,5,572,7,21,8,1709,2057,279,9992262,6
12108,outer,WtX,5,3,2,4,1,outer,2,3,397,6,30,17,463,4701,382,11245628,4
6577,flown,flon,7,4,3,4,3,flown,1,4,564,5,25,8,232,1874,486,1749635,4
12928,phrase,frez,13,10,3,6,7,phrase,1,4,499,7,67,4,464,6144,1377,13191958,5
15610,shove,S^v,7,6,1,3,4,shove,1,3,496,6,32,13,674,1017,194,847364,4
3265,clay,kle,10,7,3,6,4,clay,1,3,318,5,55,19,612,5733,427,13359113,4
12188,overlay,ovXle,2,1,1,0,2,overlay,3,5,543,8,8,7,31,467,38,2784204,6
13977,purgatory,pRg|tori,1,0,1,0,1,purgatory,4,8,582,7,1,0,57,513,15,581266,6
7520,gush,g^S,10,10,0,6,4,gush,1,3,363,5,44,22,36,244,24,495066,4
3219,civil,sIvL,7,4,3,3,4,civil,2,5,519,6,24,1,813,24939,6213,49496163,6
18307,valve,v@lv,3,2,1,0,3,valve,1,4,633,6,10,8,247,1614,108,11325360,5
8145,hush,h^S,14,14,0,5,9,hush,1,3,517,5,56,27,388,1013,113,1719699,4
1450,bake,bek,29,26,3,20,9,bake,1,3,419,5,116,45,323,5337,281,3791576,4
9238,isolate,Ysxlet,1,1,0,1,0,isolate,3,6,619,8,2,3,147,1248,213,2127204,7
634,amity,@mxti,1,1,0,1,0,amity,3,5,372,6,5,1,27,165,34,541103,6
4221,croquette,krokEt,1,0,1,1,0,croquette,2,6,487,8,0,1,2,10,3,18823,5
19021,wide,wYd,26,23,3,15,11,wide,1,3,298,5,100,27,1214,28320,1972,87666217,4
15535,sharpen,Sarpxn,1,1,0,1,0,sharpen,2,6,468,8,6,3,57,508,49,776397,7
4410,dally,d@li,14,13,1,13,1,dally,2,4,499,5,80,24,39,100,2,142954,5
1629,beacon,bik|n,4,4,0,4,0,beacon,2,5,364,7,34,7,197,1176,113,4191111,6
16437,strain,stren,9,4,5,3,6,strain,1,5,585,7,23,7,361,4475,515,9151339,6
8283,illume,Ilum,5,4,1,5,0,illume,2,4,718,6,8,0,1,2,0,28678,5
14807,rid,rId,29,25,4,16,13,rid,1,3,331,4,98,36,3052,6152,2415,7893552,4
16068,speak,spik,11,9,2,5,6,speak,1,4,459,6,38,10,9546,26985,7719,31326065,5
5723,entrain,Intren,1,1,0,1,0,entrain,2,6,503,7,0,1,0,16,2,33855,5
15763,skirt,skRt,10,8,2,2,8,skirt,1,4,516,6,29,5,508,3859,226,9982990,5
9361,joke,Jok,11,10,1,11,0,joke,1,3,382,5,67,20,3724,6656,1700,9046973,4
2772,cattle,k@tL,14,12,2,7,7,cattle,2,5,399,7,44,7,674,4090,351,8542988,6
3434,colic,kalIk,6,5,1,5,1,colic,2,5,449,6,39,10,26,124,26,482850,5
16804,sweat,swEt,9,5,4,3,6,sweat,1,4,470,6,24,10,1115,6179,467,4552290,5
11145,Mormon,mormxn,1,1,0,1,0,mormon,2,6,434,7,43,6,115,1555,335,1911630,7
14062,quality,kwal|ti,1,0,1,1,0,quality,3,7,477,7,3,3,947,33548,2907,189513895,8
8989,intent,IntEnt,4,4,0,2,2,intent,2,6,576,7,7,4,286,5850,985,11596706,7
13881,prune,prun,8,7,1,2,6,prune,1,4,468,6,39,9,75,324,13,688443,5
9501,king,kIG,17,15,2,8,9,king,1,3,421,5,75,32,6592,41108,17834,79811889,4
16959,tan,t@n,25,23,2,17,8,tan,1,3,428,4,113,59,439,2512,197,9751642,4
4086,covert,kovRt,1,0,1,1,0,covert,2,5,459,7,4,10,148,1182,301,1991310,6
11986,opus,opxs,1,1,0,0,1,opus,2,4,422,4,9,8,46,401,60,1820660,4
17277,thorax,Tor@ks,1,1,0,1,0,thorax,2,6,687,6,1,1,20,144,0,379763,5
12977,pied,pYd,20,17,3,12,8,pied,1,3,356,5,60,22,19,206,18,656612,3
3249,clash,kl@S,14,12,2,6,8,clash,1,4,445,6,33,7,68,1656,267,3531401,5
17147,terminate,tRmxnet,1,1,0,1,0,terminate,3,7,619,10,2,4,140,611,107,4661569,8
9128,inventive,InvEntIv,2,2,0,1,1,inventive,3,8,810,10,4,3,46,641,40,967751,9
19307,zest,zEst,11,11,0,11,0,zest,1,4,506,5,27,18,35,1457,72,655298,5
2350,burned,bRnd,9,7,2,6,3,burned,1,4,437,6,48,8,1448,7095,1174,4993504,5
3334,clump,kl^mp,4,3,1,4,0,clump,1,5,379,6,13,10,27,586,11,345355,6
3502,comet,kamxt,4,2,2,1,3,comet,2,5,482,6,14,7,157,1913,156,3125758,6
12569,pause,pcz,9,8,1,6,3,pause,1,3,457,6,78,13,275,4983,501,4606318,4
2958,charge,CarJ,8,6,2,3,5,charge,1,4,477,7,16,6,4559,19516,5409,56542975,5
11567,nimble,nImbL,3,2,1,2,1,nimble,2,6,539,6,9,3,30,483,30,412639,6
14937,rotten,ratN,5,4,1,3,2,rotten,2,5,380,7,39,12,891,1208,194,4886337,6
7905,him,hIm,20,19,1,11,9,him,1,3,357,4,69,33,177710,401145,91425,219526951,4
9597,laddie,l@di,7,6,1,4,3,laddie,2,4,376,5,41,4,98,31,1,112195,4
16089,speculation,spEkyUleS|n,1,0,1,1,0,speculation,4,11,948,12,1,1,118,3298,1092,2921087,12
18230,us,^s,10,5,5,9,1,us,1,2,394,3,66,52,86478,256306,108542,1229112622,3
16505,structure,str^kCX,1,1,0,1,0,structure,2,7,564,10,4,3,519,20123,1524,67193223,8
11880,offer,cfX,6,4,2,3,3,offer,2,3,472,6,32,8,3810,29215,3692,126228968,4
16420,store,stor,18,12,6,6,12,store,1,4,473,6,55,26,4178,25616,4153,291316410,5
14127,quota,kwotx,1,0,1,0,1,quota,2,5,414,6,5,2,95,1014,282,3248481,6
9368,joss,Jas,8,7,1,2,6,joss,1,3,484,5,44,31,20,250,37,1170742,4
7233,glove,gl^v,3,2,1,1,2,glove,1,4,376,6,11,10,515,2078,281,4715158,5
9953,linear,lIniX,1,1,0,0,1,linear,3,5,431,7,6,3,28,3332,49,22947205,6
17838,tunic,tunIk,2,2,0,2,0,tunic,2,5,419,6,7,7,28,649,10,727598,6
7241,glut,gl^t,6,4,2,2,4,glut,1,4,384,5,17,9,7,328,48,578220,5
2921,chancellor,C@nsLX,2,0,2,0,2,chancellor,2,6,678,11,3,1,210,1804,480,5165551,5
15753,skill,skIl,15,13,2,5,10,skill,1,4,413,6,31,9,404,8560,494,15837826,5
12366,paper,pepX,9,7,2,5,4,paper,2,4,402,6,36,18,5271,36023,3905,134945076,5
10888,minus,mYn|s,3,3,0,3,0,minus,2,5,486,6,15,15,401,1962,269,7025868,6
17128,tension,tEnC|n,6,4,2,4,2,tension,2,6,497,8,6,2,436,6786,1041,7095608,4
16962,tang,t@G,18,16,2,10,8,tang,1,3,343,5,69,44,114,727,15,2668036,4
4204,critical,krItIkL,1,0,1,0,1,critical,3,8,434,9,1,0,625,24490,3857,46136062,9
17349,tiff,tIf,11,9,2,5,6,tiff,1,3,375,5,46,13,44,93,11,3055768,4
18319,vanish,v@nIS,2,2,0,2,0,vanish,2,5,557,7,9,7,163,887,72,898091,6
2435,cake,kek,26,23,3,17,9,cake,1,3,377,5,105,30,2298,7045,938,16529672,4
2520,cancel,k@nsL,9,8,1,6,3,cancel,2,6,536,7,31,5,933,1442,348,21985949,7
7345,grand,gr@nd,7,5,2,5,2,grand,1,5,397,6,29,19,3214,16344,2944,56600270,6
9344,jitters,JItXz,1,1,0,1,0,jitters,2,5,482,7,9,6,66,250,61,263052,5
7577,hair,hEr,24,22,2,18,6,hair,1,3,418,5,125,28,7831,41994,4206,60061957,4
8014,hope,hop,21,19,2,14,7,hope,1,3,435,5,78,33,16352,45569,16745,74166687,4
18483,vestal,vEstL,5,3,2,2,3,vestal,2,6,539,6,12,3,14,52,2,471189,6
10686,menial,miniL,2,2,0,2,0,menial,3,6,411,6,1,7,26,235,32,164002,5
790,antelope,@ntxlop,1,0,1,1,0,antelope,3,7,504,6,1,0,50,631,57,1215883,6
15741,size,sYz,12,10,2,6,6,size,1,3,668,5,126,17,2353,34136,3110,214853921,4
1280,audit,cd|t,2,1,1,1,1,audit,2,4,359,6,2,8,57,2290,194,20786450,5
12147,outsize,WtsYz,1,1,0,0,1,outsize,2,5,619,8,4,2,1,191,2,47985,6
19282,youth,yuT,7,6,1,3,4,youth,1,3,417,6,59,8,858,16926,1513,51433820,4
7048,gear,gIr,21,20,1,18,3,gear,1,3,482,5,82,30,816,7489,646,44575901,4
18904,were,wX,5,5,0,0,5,were,1,2,399,5,117,32,84804,691166,154071,570706296,3
29,aberration,@bXeS|n,2,2,0,2,0,aberration,4,7,856,11,2,1,28,450,95,447538,8
3996,corrode,kXod,1,0,1,1,0,corrode,2,4,485,8,16,2,5,71,9,116553,5
5216,dove,dov,16,14,2,7,9,dove,1,3,420,5,47,30,284,1708,117,3254883,4
8417,implement,Implxmxnt,1,1,0,1,0,implement,3,9,589,10,2,1,63,4391,546,20723680,10
8892,insert,InsRt,5,4,1,1,4,insert,2,5,458,7,7,6,141,1557,149,20141949,6
9221,irrigate,Irxget,2,2,0,1,1,irrigate,3,6,587,9,1,2,31,161,8,180995,7
15082,salad,s@lxd,3,3,0,3,0,salad,2,5,585,6,8,11,868,6847,478,8924350,6
16652,suit,sut,27,24,3,19,8,suit,1,3,479,5,80,13,3499,13928,1871,19821509,4
10393,manifest,m@nxfEst,1,0,1,0,1,manifest,3,8,605,9,2,3,188,1670,122,3199511,9
18868,weather,wEDX,6,6,0,6,0,weather,2,4,315,8,26,6,1746,16597,4207,103332440,5
7443,groom,grum,10,8,2,3,7,groom,1,4,364,6,41,10,399,1127,128,2637912,5
15827,sloop,slup,14,11,3,6,8,sloop,1,4,491,4,21,7,10,136,4,295991,5
19048,willow,wIlo,8,6,2,3,5,willow,2,4,415,7,38,6,318,1776,519,5211634,5
13456,prayer,prEr,4,1,3,2,2,prayer,1,4,358,7,25,15,805,7584,1178,16763247,5
6133,exult,Igz^lt,1,1,0,0,1,exult,2,6,489,6,2,2,0,38,1,156525,7
2135,brain,bren,19,16,3,8,11,brain,1,4,325,6,85,23,3928,20398,3876,33620286,5
4704,depend,dxpEnd,2,1,1,2,0,depend,2,6,501,7,3,2,504,5473,857,10224873,7
1945,bloom,blum,11,7,4,8,3,bloom,1,4,425,6,35,12,281,2985,356,5457662,5
16790,swank,sw@Gk,3,2,1,3,0,swank,1,5,502,6,7,13,24,403,132,695208,4
19028,wife,wYf,15,14,1,6,9,wife,1,3,434,5,52,12,17795,47936,11952,46948695,4
17199,the,Dx,7,6,1,2,5,the,1,2,349,4,32,30,1501908,13780893,2694449,23135851162,3
14727,retreat,rItrit,1,1,0,0,1,retreat,2,6,520,8,2,2,484,3910,488,6768521,7
4483,dealt,dElt,17,12,5,10,7,dealt,1,4,401,5,42,5,379,4261,1284,6176237,5
10495,martyr,martX,7,6,1,5,2,martyr,2,5,569,7,41,5,132,683,121,924489,6
16124,spine,spYn,18,13,5,6,12,spine,1,4,550,6,37,22,293,2984,269,5371287,5
11244,mule,myul,6,4,2,3,3,mule,1,4,509,5,19,14,358,1190,66,2139180,5
5283,drive,drYv,9,5,4,5,4,drive,1,4,437,6,14,7,7810,31375,4433,107811067,5
7391,graze,grez,15,12,3,7,8,graze,1,4,458,6,60,19,39,508,26,365199,5
10505,mask,m@sk,8,6,2,6,2,mask,1,4,486,5,51,25,1010,4934,478,11656356,5
13713,profession,prxfES|n,2,1,1,1,1,profession,3,8,465,11,3,3,461,6691,677,9208483,9
11661,norm,norm,8,5,3,3,5,norm,1,4,378,5,26,13,170,3140,445,5303059,5
9388,judge,J^J,6,5,1,4,2,judge,1,3,470,6,16,11,4063,26228,11590,30906773,4
1635,beaker,bikX,4,3,1,1,3,beaker,2,4,361,7,63,23,22,140,1,419744,5
3318,clot,klat,12,10,2,6,6,clot,1,4,454,5,44,18,92,403,87,531650,5
4579,deferential,dEfXEnCL,1,1,0,1,0,deferential,4,9,798,8,2,0,5,223,26,107462,7
18416,venture,vEnCX,4,4,0,3,1,venture,2,5,552,8,15,9,241,5378,494,15188993,6
5198,dorsal,dorsL,1,1,0,1,0,dorsal,2,6,509,7,9,3,27,252,10,1191905,7
11686,note,not,26,24,2,19,7,note,1,3,341,5,87,36,2731,25745,3541,166665374,4
9131,inverse,InvRs,2,2,0,0,2,inverse,2,5,521,8,2,0,14,567,19,3222808,6
16969,tango,t@Ggo,2,2,0,1,1,tango,2,5,469,6,3,11,274,745,138,2728553,6
2168,breast,brEst,6,3,3,6,0,breast,1,5,348,7,30,5,457,10694,2117,40334563,6
12805,pert,pRt,23,21,2,17,6,pert,1,3,278,5,77,30,25,151,6,459016,4
9830,lesion,liZ|n,1,1,0,1,0,lesion,2,5,504,7,13,3,30,723,27,1340294,6
11539,news,nuz,16,12,4,9,7,news,1,3,503,5,110,19,8399,83198,45830,755449582,4
13592,press,prEs,6,5,1,4,2,press,1,4,499,6,36,21,3070,41358,10261,179658541,5
12146,outsider,WtsYdX,2,1,1,1,1,outsider,3,6,590,9,6,4,121,1621,363,1163206,7
14287,ray,re,38,19,19,22,16,ray,1,2,433,4,183,59,4966,12925,2922,32122704,3
3620,conceive,kxnsiv,4,4,0,0,4,conceive,2,6,725,9,6,2,117,975,130,1280874,7
19306,zero,zIro,1,1,0,1,0,zero,2,4,443,5,28,17,1094,7854,1827,30753901,5
5309,drug,dr^g,8,6,2,3,5,drug,1,4,347,5,17,9,2306,37213,8980,79428645,5
12422,parent,p@rxnt,3,0,3,2,1,parent,2,6,386,7,14,6,670,14979,2746,46516566,7
4023,cost,kcst,5,3,2,4,1,cost,1,4,431,5,44,34,2801,44211,8210,158893271,5
14802,rich,rIC,21,20,1,10,11,rich,1,3,439,5,83,24,4100,23965,4320,37207657,4
212,actuary,@kCuEri,1,0,1,0,1,actuary,4,7,718,7,1,0,7,146,37,583033,8
9903,lifeless,lYflxs,1,1,0,1,0,lifeless,2,6,708,6,1,0,64,666,30,464235,5
10133,lounge,lWnJ,1,1,0,1,0,lounge,1,4,468,7,6,4,401,2031,156,16473972,5
6179,faith,feT,11,10,1,2,9,faith,1,3,450,6,42,9,2363,19515,3712,35943362,4
472,alert,xlRt,9,9,0,4,5,alert,2,4,449,6,16,6,1051,4758,1238,32474768,5
19294,zeal,zil,15,13,2,14,1,zeal,1,3,649,5,114,15,31,819,64,1084831,4
7712,hazard,h@zXd,1,1,0,1,0,hazard,2,5,474,7,6,4,197,1626,239,8003332,6
14539,remain,rImen,3,3,0,3,0,remain,2,5,466,7,9,8,1694,21498,3144,30630717,6
15104,salve,s@v,12,12,0,5,7,salve,1,3,513,6,37,14,29,207,14,423303,4
3,aback,xb@k,3,2,1,2,1,aback,2,4,501,5,8,3,15,541,71,277737,4
10534,match,m@C,14,14,0,7,7,match,1,3,474,6,61,16,2521,11895,1735,53534883,4
11507,nestling,nEslIG,2,2,0,2,0,nestling,2,6,559,9,7,4,0,66,2,202655,7
12547,patriarch,petriark,2,1,1,1,1,patriarch,3,8,649,10,4,4,16,732,68,780160,9
16689,sunk,s^Gk,17,11,6,14,3,sunk,1,4,434,5,37,25,237,1196,159,1217793,5
9722,lax,l@ks,11,7,4,5,6,lax,1,4,492,4,102,40,87,805,175,2097303,5
8372,impatience,ImpeS|ns,1,1,0,0,1,impatience,3,8,708,9,2,0,35,723,66,410968,8
12729,perform,pXform,1,1,0,0,1,perform,2,6,549,8,5,2,821,10137,1211,30382862,7
3053,chigger,CIgX,4,4,0,3,1,chigger,2,4,441,8,15,2,6,21,0,26880,5
5314,drunk,dr^Gk,5,4,1,5,0,drunk,1,5,429,6,15,9,3904,5689,1061,10521138,6
12492,passage,p@sIJ,3,3,0,1,2,passage,2,5,526,8,4,3,390,8122,728,11035170,6
15559,shelter,SEltX,1,1,0,1,0,shelter,2,5,480,8,17,9,595,5853,1135,9025593,6
9324,jetty,JEti,4,3,1,2,2,jetty,2,4,419,5,67,13,13,147,7,765224,4
7066,general,JEnXL,1,1,0,0,1,general,2,6,453,8,9,5,5885,68838,15570,311763794,7
1150,assess,xsEs,1,0,1,1,0,assess,2,4,498,7,4,2,83,7033,562,12614289,5
282,adoration,@dXeS|n,3,2,1,3,0,adoration,4,7,571,6,2,0,30,361,29,542469,4
12541,pathos,peTas,1,1,0,1,0,pathos,2,5,557,6,0,3,12,290,14,298643,3
9811,lend,lEnd,17,14,3,12,5,lend,1,4,469,5,54,32,595,2298,378,2927365,5
17357,tile,tYl,29,26,3,20,9,tile,1,3,407,5,111,32,108,1617,68,8516834,4
4878,did,dId,21,20,1,13,8,did,1,3,294,4,66,32,119410,418955,146254,275375820,4
16262,stalk,stck,9,7,2,1,8,stalk,1,4,520,6,42,9,86,817,53,936028,5
3436,collaborate,kxl@bXet,1,0,1,1,0,collaborate,4,8,644,12,1,2,31,1071,74,2564383,9
10168,lug,l^g,22,20,2,16,6,lug,1,3,347,4,50,33,132,306,18,2224803,4
16999,tarry,t@ri,14,12,2,10,4,tarry,2,4,357,6,121,18,23,87,2,248483,5
4235,crowd,krWd,8,8,0,3,5,crowd,1,4,470,6,30,7,1906,16237,2929,11409218,5
4534,declaratory,dIkl@rxtori,1,1,0,1,0,declaratory,5,11,948,9,0,0,4,48,4,461662,8
8918,inspire,InspYr,1,1,0,1,0,inspire,2,6,645,8,2,2,198,2209,363,3577983,7
19124,woke,wok,18,16,2,14,4,woke,1,3,369,5,72,19,1344,4223,733,2630931,4
9925,liking,lYkIG,3,2,1,3,0,liking,2,5,456,6,15,9,320,1044,181,1758841,4
12444,parlor,parlX,3,3,0,1,2,parlor,2,5,394,7,15,6,303,1610,116,1180891,6
6098,extern,EkstRn,1,0,1,0,1,extern,2,6,437,7,3,0,0,5,1,3048776,7
14226,rant,r@nt,13,9,4,7,6,rant,1,4,486,5,58,39,34,394,80,3685673,5
6815,frisk,frIsk,2,1,1,2,0,frisk,1,5,499,6,16,10,79,86,20,152512,6
11756,nut,n^t,25,23,2,18,7,nut,1,3,357,4,63,23,797,1967,306,6459502,4
13000,pillar,pIlX,9,6,3,4,5,pillar,2,4,387,7,58,7,81,1021,95,2493688,5
1714,belief,bxlif,2,2,0,0,2,belief,2,5,467,7,8,7,388,10193,1357,12108534,6
11847,occur,xkR,2,1,1,2,0,occur,2,3,456,6,46,2,379,10856,1243,24679212,4
4883,dies,dYz,16,15,1,8,8,dies,1,3,609,5,119,49,1270,2755,536,7535471,4
7162,gilt,gIlt,11,10,1,8,3,gilt,1,4,370,5,37,20,9,351,5,1157227,5
3098,choice,COs,3,3,0,3,0,choice,1,3,509,7,21,4,4975,29714,6937,68226096,4
5421,easel,izL,6,3,3,4,2,easel,2,4,416,5,16,10,14,584,11,791426,5
4557,decree,dxkri,2,2,0,2,0,decree,2,5,609,7,17,4,98,981,127,3299967,6
18833,watch,wcC,5,5,0,2,3,watch,1,3,509,6,51,12,16831,35474,10269,92013600,4
9699,latter,l@tX,21,17,4,15,6,latter,2,4,359,7,58,29,64,8057,285,14044005,5
16622,succumb,sxk^m,2,1,1,2,0,succumb,2,5,457,8,5,1,19,508,66,370914,6
17302,thrill,TrIl,7,6,1,6,1,thrill,1,4,467,7,17,5,429,2027,380,2690731,5
9872,liberate,lIbXet,1,0,1,0,1,liberate,3,6,532,9,2,6,59,580,144,592656,7
427,agriculture,@grIk^lCX,1,0,1,0,1,agriculture,4,9,732,12,1,0,56,6939,792,29218031,10
16934,tailor,telX,6,5,1,3,3,tailor,2,4,440,7,67,8,213,1069,111,3143833,5
14183,rail,rel,36,30,6,25,11,rail,1,3,360,5,154,40,233,4334,419,17293944,4
7737,heat,hit,25,22,3,19,6,heat,1,3,313,5,95,27,2044,30601,2405,39974452,4
10081,loft,lcft,7,4,3,5,2,loft,1,4,533,5,20,16,186,1205,48,2960259,5
15760,skip,skIp,15,10,5,5,10,skip,1,4,489,5,26,16,1076,2582,307,44682957,5
9556,Korean,kXixn,1,0,1,0,1,korean,2,5,518,7,28,13,506,5723,1144,15187137,6
17798,trust,tr^st,6,3,3,4,2,trust,1,5,435,6,23,14,9087,18301,4424,55160158,6
3234,clan,kl@n,12,11,1,3,9,clan,1,4,480,5,49,27,209,2155,130,6798554,5
1467,ballast,b@l|st,1,0,1,0,1,ballast,2,6,561,8,8,3,60,347,12,1277921,7
10523,mastery,m@stXi,2,1,1,1,1,mastery,3,6,584,7,8,5,29,1984,44,2161704,6
17764,trophy,trofi,3,2,1,1,2,trophy,2,5,366,6,2,2,385,2215,173,4731863,6
14364,recognizance,rIkagn|z|ns,1,0,1,1,0,recognizance,4,10,803,10,0,0,18,46,16,96952,5
18327,vapor,vepX,4,4,0,4,0,vapor,2,4,347,6,12,3,31,1135,67,3744912,5
431,ahoy,xhO,1,1,0,1,0,ahoy,2,3,539,4,5,3,189,58,2,448868,3
15645,shy,SY,23,20,3,17,6,shy,1,2,569,4,138,19,937,4063,685,4252874,3
5610,emigration,EmxgreS|n,1,1,0,1,0,emigration,4,9,848,11,2,2,13,726,59,834941,10
18849,wax,w@ks,4,3,1,3,1,wax,1,4,500,4,82,28,461,2184,136,6477139,5
13011,pin,pIn,31,28,3,21,10,pin,1,3,364,4,114,47,835,3440,549,25098207,4
3742,conjure,kanJX,2,1,1,0,2,conjure,2,5,543,8,10,2,64,584,43,422440,6
13578,presence,prEzNs,1,1,0,0,1,presence,2,7,520,9,2,1,1064,19547,2084,28603601,8
3869,contrite,kxntrYt,1,1,0,0,1,contrite,2,7,511,8,2,1,11,149,27,97621,7
8950,insufficient,InsxfIS|nt,1,0,1,1,0,insufficient,4,10,695,13,0,0,54,1950,136,4869704,11
1863,bison,bYsN,2,2,0,2,0,bison,2,5,378,4,33,11,17,870,58,2006472,5
4434,dangle,d@GgL,8,7,1,8,0,dangle,2,6,403,7,21,17,68,337,37,1000999,7
2290,built,bIlt,18,15,3,10,8,built,1,4,309,5,49,6,2099,28910,3840,61502894,5
14380,recorder,rIkordX,1,0,1,0,1,recorder,3,7,599,9,4,5,252,1588,249,13394033,8
10185,luncheon,l^nC|n,1,1,0,1,0,luncheon,2,6,416,9,3,1,167,884,95,2363638,7
3179,circa,sRkx,1,1,0,0,1,circa,2,4,419,6,21,1,35,785,22,3475462,5
19211,wrong,rcG,13,10,3,10,3,wrong,1,3,519,6,56,8,26678,42030,15791,49161005,4
16201,spun,sp^n,11,8,3,3,8,spun,1,4,576,5,24,10,86,2379,121,1854414,5
2377,butter,b^tX,13,10,3,9,4,butter,2,4,318,7,52,26,1042,10850,766,9727886,5
19184,worthy,wRDi,2,1,1,1,1,worthy,2,4,490,6,9,4,527,3912,397,6907063,5
15658,siege,siJ,15,14,1,4,11,siege,1,3,451,6,77,14,118,1719,400,2518643,4
7857,heron,hErxn,1,1,0,1,0,heron,2,5,329,6,81,26,14,414,18,1576813,6
7522,gust,g^st,11,8,3,8,3,gust,1,4,447,5,38,28,24,445,42,1012909,5
18491,vesture,vEsCX,3,3,0,2,1,vesture,2,5,732,5,6,2,1,5,0,35673,4
229,addition,xdIS|n,5,2,3,4,1,addition,3,6,503,9,5,3,395,27926,2101,73434482,7
5273,dress,drEs,9,6,3,5,4,dress,1,4,448,6,26,15,4447,15265,2432,27322995,5
16060,spat,sp@t,12,8,4,3,9,spat,1,4,441,5,30,21,79,951,64,638324,5
6798,fresh,frES,4,3,1,3,1,fresh,1,4,499,6,27,8,2780,25161,2862,38789267,5
8020,hormone,hormon,1,0,1,0,1,hormone,2,6,569,8,3,1,69,2049,371,8108841,7
4329,curry,kRi,14,10,4,5,9,curry,2,3,409,6,106,18,124,2144,319,4030691,4
13583,preservation,prEzXveS|n,1,0,1,1,0,preservation,4,10,754,13,1,1,55,3279,170,9429116,11
16716,supervisor,supXvYzX,2,0,2,0,2,supervisor,4,8,831,11,6,2,304,3046,415,12156446,9
7713,haze,hez,19,16,3,13,6,haze,1,3,492,5,157,22,77,1302,64,2099823,4
13577,prescribe,prIskrYb,1,1,0,1,0,prescribe,2,8,595,10,2,4,74,849,162,1998175,7
14277,ravage,r@vIJ,2,2,0,1,1,ravage,2,5,579,7,7,5,27,85,3,153694,6
414,agleam,xglim,1,0,1,1,0,agleam,2,5,639,5,4,1,0,9,0,7201,5
16805,sweater,swEtX,3,0,3,1,2,sweater,2,5,549,8,13,5,704,2443,226,3798820,6
18813,warranty,wcrxnti,1,0,1,0,1,warranty,3,7,559,8,3,2,42,884,50,33921186,8
5619,emotion,ImoS|n,1,0,1,1,0,emotion,3,6,527,8,5,6,423,4323,912,4733256,7
17757,troll,trol,9,5,4,4,5,troll,1,4,441,6,29,11,138,714,50,2080526,5
3376,cockney,kakni,1,0,1,0,1,cockney,2,5,413,5,12,4,18,112,17,233845,4
11580,nipple,nIpL,7,6,1,2,5,nipple,2,5,320,7,27,10,144,631,36,7595055,6
13217,poison,pOzN,2,0,2,0,2,poison,2,5,609,7,6,4,1252,2623,499,5058523,6
18646,viva,vivx,3,3,0,1,2,viva,2,4,353,5,18,16,159,300,44,2480756,5
6235,farther,farDX,1,0,1,1,0,farther,2,5,465,7,11,2,287,5490,467,2666579,5
15884,snake,snek,6,5,1,3,3,snake,1,4,529,6,19,10,1140,3557,312,7609672,5
1557,barony,b@rxni,1,0,1,0,1,barony,3,6,501,6,7,8,2,12,1,240720,6
14957,rove,rov,26,20,6,13,13,rove,1,3,502,5,84,29,58,1816,1329,2059348,4
1541,bargain,barg|n,1,1,0,1,0,bargain,2,6,599,8,23,2,612,3167,682,19913018,7
14021,puzzle,p^zL,5,5,0,3,2,puzzle,2,5,405,7,9,7,374,3011,1028,14083532,6
1678,been,bIn,27,25,2,19,8,been,1,3,529,5,146,32,88573,497421,140390,575029687,4
3541,commotion,kxmoS|n,1,1,0,1,0,commotion,3,7,492,6,2,0,106,681,76,619971,5
15546,sheathe,SiD,11,9,2,3,8,sheathe,1,3,402,8,37,2,5,4,0,14350,4
12532,paternal,pxtRnL,1,1,0,1,0,paternal,3,7,649,9,1,1,41,621,31,605369,8
10429,many,mEni,7,5,2,3,4,many,2,4,398,4,92,29,18331,243561,53009,318977612,5
14055,quail,kwel,7,5,2,3,4,quail,1,4,370,6,29,6,68,652,33,1278967,5
13149,plenty,plEnti,1,1,0,0,1,plenty,2,6,381,6,3,1,3178,12095,2241,14365248,6
9224,irritable,IrxtxbL,1,1,0,1,0,irritable,4,8,529,9,1,1,74,482,40,979803,6
16890,syrup,sRxp,1,0,1,1,0,syrup,2,5,443,6,6,1,260,2451,176,3110920,5
14895,rogue,rog,18,15,3,6,12,rogue,1,3,339,6,91,13,190,1269,286,4578158,4
17445,told,told,11,8,3,9,2,told,1,4,446,5,43,19,35679,100473,25767,57250931,5
17221,theory,TIri,7,5,2,6,1,theory,2,4,521,7,31,1,1459,23351,2194,50278307,5
5345,duly,duli,9,9,0,8,1,duly,2,4,529,4,69,14,69,467,58,2823211,4
14821,rifle,rYfL,6,3,3,3,3,rifle,2,5,407,6,23,7,743,4461,592,5048209,6
17268,thirteen,TRtin,1,0,1,0,1,thirteen,2,5,689,9,5,0,268,2850,421,3267766,6
1513,banshee,b@nSi,1,1,0,0,1,banshee,2,5,488,5,5,0,57,75,3,656140,4
13421,poultry,poltri,1,1,0,1,0,poultry,2,6,500,6,4,0,51,1477,185,5148028,6
10810,might,mYt,28,24,4,19,9,might,1,3,387,6,81,12,26334,132329,27148,123202464,4
268,admission,xdmIS|n,1,0,1,1,0,admission,3,7,490,10,4,2,181,4560,491,16358995,8
17813,tubular,tubyUlX,1,1,0,1,0,tubular,3,7,515,6,0,0,14,288,5,1645135,5
14655,reserved,rIzRvd,1,0,1,0,1,reserved,2,6,591,8,6,8,258,3526,263,256443930,6
15180,saute,scte,2,0,2,1,1,saute,2,4,555,6,6,11,3,778,66,546457,5
7036,gauze,gcz,11,11,0,5,6,gauze,1,3,472,4,71,3,73,446,24,556178,3
7988,hone,hon,23,20,3,15,8,hone,1,3,396,5,129,50,37,403,46,875783,4
12848,pew,pyu,9,5,4,7,2,pew,1,3,265,4,53,31,53,1478,259,1115032,4
18928,when,hwEn,6,3,3,2,4,when,1,3,329,5,121,17,103739,593332,149122,650640447,4
228,addiction,xdIkS|n,2,0,2,2,0,addiction,3,7,537,10,4,2,199,3809,967,9334031,8
11304,mustang,m^st@G,1,1,0,0,1,mustang,2,6,559,8,3,1,175,701,69,5921227,7
7967,holster,holstX,2,2,0,2,0,holster,2,6,524,8,9,6,111,508,47,1794771,7
18758,waist,west,8,7,1,7,1,waist,1,4,512,6,36,13,262,4094,294,5013500,5
3627,concern,kxnsRn,2,2,0,0,2,concern,2,6,557,8,7,3,1332,22352,5288,24611878,7
5910,evaluate,Iv@lyuet,1,1,0,1,0,evaluate,4,8,589,9,3,7,88,5254,394,15958090,9
1581,basil,b@zL,6,6,0,2,4,basil,2,5,529,6,19,18,69,3217,147,2757984,5
52,abode,xbod,4,2,2,1,3,abode,2,4,509,4,10,4,33,213,12,1250165,3
5404,eagle,igL,8,5,3,6,2,eagle,2,4,453,6,50,24,586,3504,288,16790604,5
17499,torch,torC,8,6,2,1,7,torch,1,4,389,6,29,8,254,1260,161,3361755,5
11961,opiate,opixt,1,1,0,0,1,opiate,3,5,378,7,2,1,20,215,19,499790,6
15643,shutter,S^tX,10,8,2,7,3,shutter,2,4,449,8,33,10,74,626,40,3293516,5
16142,splatter,spl@tX,3,1,2,2,1,splatter,2,6,533,9,5,3,44,137,20,293660,7
9267,jab,J@b,14,13,1,9,5,jab,1,3,449,4,50,31,171,443,73,731910,4
11849,ocean,oS|n,6,2,4,6,0,ocean,2,4,454,6,30,3,1545,11374,1433,31930797,5
14256,ratification,r@t|fxkeS|n,1,0,1,1,0,ratification,5,11,867,7,2,2,5,593,69,1657571,6
217,ad,@d,25,10,15,15,10,ad,1,2,539,3,82,61,694,9589,2671,78774169,3
6281,feast,fist,10,8,2,8,2,feast,1,4,489,6,33,13,342,2087,157,4166305,5
8359,impair,ImpEr,2,1,1,0,2,impair,2,5,649,7,3,1,8,283,22,1051194,6
9500,kinfolk,kInfok,1,0,1,0,1,kinfolk,2,6,619,4,1,1,18,39,1,42954,4
3997,corrugate,kcrxget,1,1,0,0,1,corrugate,3,7,568,10,2,2,0,2,0,12273,8
11196,motor,motX,9,7,2,6,3,motor,2,4,369,6,44,6,671,7752,595,40618876,5
10463,market,mark|t,1,0,1,0,1,market,2,6,450,7,27,14,1848,56087,10065,162393273,7
15576,shingle,SIGgL,6,5,1,6,0,shingle,2,6,589,8,20,7,38,260,17,641972,7
12989,pike,pYk,23,20,3,15,8,pike,1,3,417,5,71,26,234,1784,217,5086607,4
8897,insider,InsYdX,3,2,1,0,3,insider,3,6,520,8,9,6,36,1838,467,13278905,7
12573,paw,pc,19,15,4,11,8,paw,1,2,357,4,78,37,159,1030,39,2007280,3
14825,right,rYt,35,28,7,23,12,right,1,3,333,6,105,18,204428,292287,154266,273635706,4
3352,coat,kot,31,26,5,19,12,coat,1,3,333,5,114,26,2146,9353,609,12207989,4
15341,secretary,sEkrxtEri,1,0,1,0,1,secretary,4,9,878,10,2,0,1694,25139,12362,46013973,10
9857,levity,lEvxti,2,2,0,2,0,levity,3,6,506,6,8,3,19,104,11,157342,6
2156,brazier,breZX,1,1,0,1,0,brazier,3,6,460,8,4,6,2,103,0,202480,5
2051,book,bUk,18,17,1,16,2,book,1,3,329,5,70,31,9026,67743,19088,330969639,4
6813,fringe,frInJ,2,2,0,2,0,fringe,1,5,668,7,5,6,85,1598,243,3682671,6
2309,bump,b^mp,9,8,1,8,1,bump,1,4,306,5,22,15,630,2074,346,4621054,5
10211,lyre,lYr,25,23,2,15,10,lyre,1,3,344,4,64,18,4,98,4,300168,4
15642,shut,S^t,21,18,3,15,6,shut,1,3,352,5,69,18,13455,14304,2706,11691029,4
4101,coy,kO,14,10,4,5,9,coy,1,2,313,4,100,50,88,362,49,808775,3
8899,insight,InsYt,7,7,0,3,4,insight,2,5,514,8,14,1,143,4781,690,14082681,6
8131,hunger,h^GgX,2,2,0,1,1,hunger,2,5,425,7,7,10,300,3658,525,5358049,6
1724,bellow,bElo,12,10,2,8,4,bellow,2,4,384,7,69,13,23,538,25,492951,5
8401,impersonator,ImpRsNetX,1,0,1,0,1,impersonator,5,10,685,13,4,1,28,116,43,215439,11
7579,hairline,hErlYn,1,1,0,1,0,hairline,2,6,532,6,4,2,62,409,23,229472,5
5359,dung,d^G,17,16,1,7,10,dung,1,3,378,5,55,28,90,502,41,973533,4
6610,fodder,fadX,3,3,0,2,1,fodder,2,4,344,4,20,6,19,621,111,990472,4
3914,cook,kUk,15,13,2,13,2,cook,1,3,354,5,57,25,2324,18139,1603,24413307,4
9548,knowledge,nalIJ,2,2,0,2,0,knowledge,2,5,489,10,3,0,1302,35563,2199,89756307,6
10716,merger,mRJX,7,6,1,3,4,merger,2,4,375,7,15,17,202,1946,353,6021111,5
18748,waggle,w@gL,4,2,2,2,2,waggle,2,5,409,7,20,7,20,34,0,40713,6
382,after,@ftX,5,2,3,4,1,after,2,4,402,6,13,6,34812,288288,59624,372953923,5
10591,me,mi,32,25,7,18,14,me,1,2,364,3,180,68,471339,446444,132170,566617666,3
17583,tram,tr@m,11,7,4,5,6,tram,1,4,450,5,38,27,70,407,27,1364261,5
9527,knead,nid,21,16,5,11,10,knead,1,3,408,6,105,3,9,295,3,238706,4
19136,women,wImxn,1,1,0,1,0,women,2,5,318,6,49,6,9978,133585,26074,242539828,6
14833,rile,rYl,26,24,2,16,10,rile,1,3,349,5,112,31,17,78,9,68294,4
1576,base,bes,27,20,7,15,12,base,1,3,355,5,101,57,1804,24222,4264,81899289,4
10433,maple,mepL,2,1,1,1,1,maple,2,5,396,6,12,14,165,2409,97,9704795,6
12616,pediment,pEdxmxnt,1,1,0,1,0,pediment,3,8,547,5,0,1,1,26,0,80201,5
17192,than,D@n,12,11,1,11,1,than,1,3,404,5,65,35,37679,405521,68981,502620262,3
15464,sergeant,sarJ|nt,2,1,1,2,0,sergeant,2,7,659,9,2,3,3210,4040,1318,3154308,8
12986,pigment,pIgmxnt,1,1,0,1,0,pigment,2,7,469,8,3,2,15,726,31,1629945,8
9589,lacrosse,lxkrcs,1,0,1,1,0,lacrosse,2,6,643,8,1,4,53,848,300,4641532,5
12476,particle,partIkL,1,0,1,1,0,particle,3,8,432,9,3,4,91,1656,73,8329460,9
17179,testy,tEsti,5,3,2,2,3,testy,2,5,390,5,19,7,49,222,59,169557,6
11469,negation,nIgeS|n,1,1,0,1,0,negation,3,7,551,7,0,1,5,233,3,667373,4
140,account,xkWnt,2,1,1,2,0,account,2,5,523,8,4,1,2280,20141,2500,203612136,6
18854,we,wi,30,22,8,18,12,we,1,2,351,3,173,60,459607,1180341,561627,1390661912,3
10491,Martian,marS|n,2,2,0,0,2,martian,2,6,481,8,29,7,88,871,74,1273255,7
15197,scallion,sk@lyxn,2,2,0,2,0,scallion,2,7,591,9,5,4,8,131,3,99383,8
12062,oscillate,asxlet,3,2,1,1,2,oscillate,3,6,589,10,4,2,3,74,1,158117,7
16405,stole,stol,15,11,4,2,13,stole,1,4,559,6,54,22,2711,2959,635,2814273,5
11356,nag,n@g,17,16,1,12,5,nag,1,3,449,4,58,36,111,252,34,1163727,4
12197,overseas,ovXsiz,1,1,0,0,1,overseas,3,6,608,8,7,2,233,5354,1741,14774938,6
10350,mammal,m@mL,1,1,0,1,0,mammal,2,5,257,7,26,4,62,734,60,1251818,6
19132,woman,wUmxn,2,1,1,2,0,woman,2,5,364,6,18,18,22166,87183,25220,70621563,6
14006,pussy,pUsi,2,2,0,1,1,pussy,2,4,354,6,10,7,1309,484,20,59207680,5
8844,innate,Inet,4,2,2,2,2,innate,2,4,599,7,9,1,39,907,61,1052902,5
18718,vulgar,v^lgX,1,1,0,0,1,vulgar,2,5,393,7,3,0,167,660,109,1186559,6
6913,futile,fyutL,2,1,1,1,1,futile,2,6,529,6,3,1,82,1052,94,956638,5
15270,scout,skWt,10,9,1,3,7,scout,1,4,516,6,28,11,657,3061,351,6176724,5
865,apiece,xpis,5,4,1,1,4,apiece,2,4,547,4,13,1,202,934,131,496659,4
1350,avenge,xvEnJ,1,1,0,0,1,avenge,2,5,605,7,2,3,154,282,32,365931,6
16417,stop,stap,11,8,3,5,6,stop,1,4,427,5,40,17,36071,48253,13759,77765310,5
2278,budget,b^J|t,1,1,0,1,0,budget,2,5,353,7,9,4,513,25954,8731,59106421,6
5600,emcee,Emsi,1,1,0,0,1,emcee,2,4,540,4,20,0,26,172,30,297965,5
15405,senator,sEn|tX,2,0,2,0,2,senator,3,6,583,8,12,2,1691,26139,19577,15023396,7
16786,swallow,swalo,1,0,1,1,0,swallow,2,5,445,8,10,3,649,2206,237,3832303,6
3485,comb,kom,24,20,4,13,11,comb,1,3,469,5,106,17,309,1057,103,2329108,4
4314,curd,kRd,19,17,2,11,8,curd,1,3,383,4,79,15,22,201,18,285733,4
7252,gnome,nom,18,15,3,10,8,gnome,1,3,387,6,69,3,32,142,6,12612960,4
522,allied,xlYd,12,10,2,6,6,allied,2,4,427,7,17,7,147,3336,821,7508812,5
13234,polio,polio,3,1,2,2,1,polio,3,5,425,5,14,13,45,647,198,1298845,5
10550,matriarchal,metriarkL,3,2,1,1,2,matriarchal,4,10,635,10,1,1,1,57,2,59197,9
2244,brought,brct,10,8,2,3,7,brought,1,4,363,8,33,6,8786,40456,9791,39794764,5
1104,ascension,xsEnC|n,1,1,0,1,0,ascension,3,7,570,6,2,0,44,381,20,1825408,5
14221,ranger,renJX,3,2,1,2,1,ranger,2,5,559,7,15,25,379,1853,207,5077778,6
178,acorn,ekorn,2,1,1,2,0,acorn,2,5,678,6,7,9,37,933,448,1832026,6
15184,save,sev,22,18,4,13,9,save,1,3,544,5,57,38,8278,21762,5218,186096288,4
7363,grape,grep,16,13,3,4,12,grape,1,4,341,6,38,21,204,1679,121,3638159,5
1418,back,b@k,32,28,4,20,12,back,1,3,289,5,137,36,102467,310025,94822,488046401,4
6319,felt,fElt,13,12,1,9,4,felt,1,4,420,5,41,22,6111,60477,10064,33323938,5
17052,tedium,tidixm,2,2,0,1,1,tedium,3,6,562,5,2,1,13,182,6,142578,6
1600,bath,b@T,17,17,0,7,10,bath,1,3,271,5,52,30,1587,3963,498,30538510,4
15883,snail,snel,5,3,2,4,1,snail,1,4,495,6,18,5,90,546,26,1580640,5
13132,please,pliz,6,3,3,2,4,please,1,4,438,7,43,8,56149,23462,7181,380056867,5
8225,icon,Ykan,1,0,1,1,0,icon,2,4,429,5,16,13,88,2476,337,33967723,5
10319,malediction,m@lxdIkS|n,1,1,0,1,0,malediction,4,10,998,5,0,0,1,11,0,22486,8
6724,fortify,fort|fY,1,1,0,1,0,fortify,3,7,748,8,1,1,12,191,12,265168,8
12967,picky,pIki,10,7,3,2,8,picky,2,4,407,5,56,8,111,467,62,711200,5
16362,stiff,stIf,10,9,1,3,7,stiff,1,4,479,6,32,9,523,3986,331,3492842,5
10519,master,m@stX,8,4,4,6,2,master,2,5,599,7,39,33,4450,14288,1196,61724225,6
14822,rift,rIft,12,8,4,9,3,rift,1,4,399,5,27,12,55,786,120,1120157,5
17879,tweak,twik,4,2,2,2,2,tweak,1,4,311,6,12,4,34,420,67,1706037,5
15176,saucer,scsX,1,0,1,0,1,saucer,2,4,639,7,22,11,140,616,67,1390639,5
1044,armor,armX,6,4,2,0,6,armor,2,4,340,6,26,8,372,2129,368,6001844,5
15562,shepherd,SEpXd,1,1,0,1,0,shepherd,2,5,609,9,14,5,379,2667,501,5168067,6
18902,went,wEnt,19,17,2,11,8,went,1,4,393,5,51,33,20987,97425,30047,68134843,5
1705,beige,beZ,9,8,1,0,9,beige,1,3,395,6,43,9,69,808,40,4288747,4
2791,caution,kcS|n,2,2,0,1,1,caution,2,5,502,8,21,3,263,3235,568,6542160,6
368,afield,xfild,1,0,1,1,0,afield,2,5,484,4,7,1,6,299,24,435380,5
2172,breathe,briD,6,5,1,1,5,breathe,1,4,440,8,24,7,2474,4128,639,3935994,5
14397,rectify,rEkt|fY,1,0,1,0,1,rectify,3,7,678,8,3,0,42,266,51,725228,8
3515,commander,kxm@ndX,2,1,1,0,2,commander,3,7,569,10,6,4,1887,7127,2262,10044607,8
12247,package,p@kIJ,1,1,0,1,0,package,2,5,412,8,4,4,1162,11990,3336,78425554,6
7989,honest,an|st,1,1,0,1,0,honest,2,5,416,7,6,2,3689,8693,3212,11109403,6
14651,resent,rIzEnt,2,2,0,2,0,resent,2,6,478,7,4,10,293,910,257,1235579,7
5725,entrant,Entrxnt,1,1,0,0,1,entrant,2,7,398,8,3,1,1,125,11,670173,8
7771,held,hEld,11,9,2,4,7,held,1,4,313,5,46,20,2165,45447,6584,76101626,5
4064,coupe,kupe,3,2,1,1,2,coupe,1,3,249,6,93,11,31,489,12,4874541,4
18822,wash,wcS,7,4,3,2,5,wash,1,3,418,5,51,31,2077,7064,663,12614330,4
15983,some,s^m,23,19,4,16,7,some,1,3,433,5,88,16,88089,425712,130750,548849339,4
14238,rapt,r@pt,5,2,3,1,4,rapt,1,4,375,5,33,11,12,291,9,171589,5
7326,gown,gWn,8,8,0,6,2,gown,1,3,499,5,41,18,334,2281,216,2883434,4
5952,exam,Igz@m,1,1,0,0,1,exam,2,5,522,5,2,6,684,2547,359,18370372,6
12737,peril,pErL,7,5,2,2,5,peril,2,5,330,6,67,6,98,1101,172,1258951,6
11242,mulch,m^lC,4,2,2,1,3,mulch,1,4,461,6,16,9,22,830,26,833160,5
5506,elapse,xl@ps,3,1,2,3,0,elapse,2,5,649,7,9,4,0,50,4,176096,6
17890,twill,twIl,10,8,2,5,5,twill,1,4,411,6,17,7,13,109,1,1489828,5
2261,brutally,brutLi,1,0,1,0,1,brutally,3,7,599,7,1,0,92,891,325,772345,7
7715,hazy,hezi,6,5,1,4,2,hazy,2,4,497,4,31,6,41,706,47,589765,5
1919,blew,blu,12,8,4,8,4,blew,1,3,376,5,57,12,1610,4526,885,2473593,4
16234,squirm,skwRm,2,2,0,0,2,squirm,1,5,624,7,2,3,42,290,21,208497,6
12571,pavilion,pxvIlyxn,1,1,0,1,0,pavilion,3,8,641,9,3,2,49,1098,26,6278119,9
15325,search,sRC,11,9,2,6,5,search,1,3,481,7,37,2,2467,22428,3836,1024100061,4
15469,serrate,sXet,5,4,1,5,0,serrate,2,5,615,8,8,2,0,0,0,46329,6
8279,illicit,IlIs|t,2,1,1,2,0,illicit,3,6,495,8,2,0,36,1517,105,1820862,7
16015,sort,sort,14,8,6,10,4,sort,1,4,462,5,56,23,7584,44758,25292,86986269,5
14358,reckon,rEk|n,1,1,0,1,0,reckon,2,5,403,7,18,3,596,610,38,1162034,6
7994,honorable,anXxbL,1,1,0,1,0,honorable,4,7,587,9,2,1,369,1859,370,3346100,6
17092,temple,tEmpL,4,3,1,0,4,temple,2,6,401,7,14,11,895,6067,580,16052337,7
2182,briar,brYX,8,8,0,4,4,briar,2,4,358,6,53,4,39,173,25,630788,5
16044,span,sp@n,9,8,1,2,7,span,1,4,593,5,28,28,101,3273,383,9050838,5
7948,hock,hak,23,21,2,17,6,hock,1,3,473,5,134,32,110,217,36,385004,4
15293,scroll,skrol,2,2,0,1,1,scroll,1,5,589,7,8,5,116,676,28,8741548,6
6325,femur,fimX,3,3,0,1,2,femur,2,4,419,4,31,3,58,283,20,446480,4
7299,gorge,gorJ,5,4,1,1,4,gorge,1,4,469,6,22,13,67,803,29,1950264,5
1229,atop,xtap,2,1,1,2,0,atop,2,4,459,4,4,7,52,3546,143,1558107,4
6271,fauna,fcnx,1,0,1,0,1,fauna,2,4,519,6,13,5,27,572,20,2298940,5
17900,twopence,t^pxns,1,1,0,0,1,twopence,2,7,618,7,1,0,0,3,0,23014,7
11941,ooze,uz,10,3,7,9,1,ooze,1,2,418,5,111,5,27,289,15,656481,3
19053,wily,wYli,4,3,1,2,2,wily,2,4,342,4,62,14,32,273,23,353458,4
3244,clarification,kl@rxfxkeS|n,1,1,0,1,0,clarification,5,12,731,14,0,2,30,755,127,3741132,7
8529,inch,InC,8,1,7,6,2,inch,1,3,429,5,33,18,631,18072,831,35632579,4
1508,banner,b@nX,10,8,2,4,6,banner,2,4,382,7,53,22,302,1872,294,19201681,5
12208,overtone,ovXton,1,1,0,0,1,overtone,3,6,547,9,3,3,3,59,14,120768,7
7680,hash,h@S,22,21,1,11,11,hash,1,3,470,5,78,30,180,509,81,5821495,4
2683,carrier,k@riX,5,4,1,3,2,carrier,3,5,517,8,41,18,326,3150,548,22919197,6
11341,mystical,mIstIkL,1,0,1,0,1,mystical,3,8,521,7,0,0,144,1193,76,2010560,7
17004,task,t@sk,9,7,2,5,4,task,1,4,440,5,30,17,649,19791,1846,39834604,5
15972,solo,solo,9,7,2,5,4,solo,2,4,629,5,40,24,436,3763,408,14360887,5
17687,trestle,trEsL,4,2,2,1,3,trestle,2,6,455,8,15,3,8,120,5,227251,7
6624,follow,falo,7,6,1,6,1,follow,2,4,407,7,42,4,6283,27283,4922,68984111,5
54,abolition,@bxlIS|n,1,1,0,1,0,abolition,4,8,532,10,0,0,10,523,49,1132361,9
14966,rubble,r^bL,13,10,3,7,6,rubble,2,5,421,5,40,6,89,1528,470,890671,5
18796,warden,wordN,3,2,1,1,2,warden,2,6,396,7,28,19,573,918,139,1571954,7
14177,rage,reJ,19,16,3,7,12,rage,1,3,425,5,75,41,577,4047,766,6296355,4
15735,sit,sIt,36,28,8,25,11,sit,1,3,444,4,88,45,15879,24780,6613,19803302,4
16103,spew,spyu,3,1,2,2,1,spew,1,4,549,5,7,12,24,203,26,337669,5
6075,exposition,EkspxzIS|n,1,1,0,0,1,exposition,4,10,715,11,2,1,40,874,32,2184743,11
14156,radiant,redixnt,1,0,1,1,0,radiant,3,7,505,7,4,1,110,986,40,2507085,7
14581,rent,rEnt,17,15,2,12,5,rent,1,4,485,5,63,36,1762,5797,835,50768193,5
12348,pansy,p@nzi,1,1,0,0,1,pansy,2,5,440,5,16,8,99,102,4,420775,6
12831,petal,pEtL,12,9,3,6,6,petal,2,5,337,6,36,8,45,273,8,896103,6
5681,engine,EnJ|n,1,1,0,1,0,engine,2,5,569,7,10,2,1626,10873,900,78081635,6
18765,waiver,wevX,7,5,2,3,4,waiver,2,4,401,7,41,8,49,760,185,5625238,5
5907,evacuate,Iv@kyuet,1,1,0,1,0,evacuate,4,8,594,9,1,4,286,850,469,695163,7
11877,offend,xfEnd,7,5,2,6,1,offend,2,5,514,7,11,2,266,852,262,1254866,6
17564,traction,tr@kS|n,2,1,1,2,0,traction,2,7,526,6,2,1,96,1268,152,2679952,5
3005,cheek,Cik,21,19,2,16,5,cheek,1,3,341,6,76,10,365,4412,267,2681244,4
998,architectural,ark|tEkCXL,1,0,1,0,1,architectural,5,11,795,14,0,0,65,2484,75,10225722,10
13721,profit,praf|t,1,1,0,0,1,profit,2,6,454,7,4,3,559,9504,1789,34761746,7
5085,distort,dIstort,1,1,0,1,0,distort,2,7,604,8,2,1,20,565,86,697012,8
16184,spray,spre,7,4,3,2,5,spray,1,4,435,6,14,5,492,5135,485,15148400,5
14844,rip,rIp,32,28,4,20,12,rip,1,3,410,4,98,33,1028,2180,437,7815274,4
14182,raid,red,29,24,5,18,11,raid,1,3,446,5,136,29,436,2390,800,8208670,4
12835,petite,pxtit,1,1,0,0,1,petite,2,5,453,7,5,6,54,827,69,5796298,5
13669,privy,prIvi,3,3,0,0,3,privy,2,5,326,5,6,0,76,482,117,742055,6
14867,rivet,rIvxt,7,5,2,5,2,rivet,2,5,428,6,10,7,17,112,7,616847,6
6227,farmhand,farmh@nd,1,1,0,0,1,farmhand,2,8,498,9,2,2,3,37,1,46983,9
16528,stumble,st^mbL,2,0,2,1,1,stumble,2,7,482,8,4,4,100,962,140,1117097,8
76,absence,@bs|ns,1,1,0,0,1,absence,2,6,768,8,1,1,322,8527,524,14681896,7
3764,consent,kxnsEnt,1,1,0,1,0,consent,2,7,698,8,2,5,379,4407,664,20943616,8
11488,neon,nian,2,2,0,2,0,neon,2,4,353,5,17,13,146,1496,89,5191960,5
10070,locker,lakX,9,8,1,5,4,locker,2,4,442,7,60,21,815,3030,447,3985812,5
18883,weed,wid,24,20,4,17,7,weed,1,3,384,5,101,22,600,2075,194,6039195,4
9603,lag,l@g,27,25,2,17,10,lag,1,3,413,4,77,44,75,1067,96,2786744,4
16902,table,tebL,9,7,2,8,1,table,2,5,326,6,25,16,5387,73702,4844,165344305,6
426,agricultural,@grIk^lCXL,1,0,1,0,1,agricultural,5,11,1048,13,1,0,48,6893,426,24511454,12
6341,fertile,fRtL,6,6,0,6,0,fertile,2,5,615,7,18,0,80,1543,109,1697599,6
16186,spree,spri,5,3,2,3,2,spree,1,4,483,6,26,4,109,717,251,1218040,5
19145,wooden,wUdN,3,2,1,1,2,wooden,2,5,439,6,27,7,367,8201,279,13564576,6
16258,stair,stEr,12,10,2,5,7,stair,1,4,517,6,45,10,69,508,14,2012524,5
15169,saturation,s@CXeS|n,1,1,0,1,0,saturation,4,8,698,9,1,2,28,575,64,2162437,6
2141,brand,br@nd,8,3,5,4,4,brand,1,5,450,6,32,24,712,9638,2300,82812478,6
3535,commit,kxmIt,1,0,1,0,1,commit,2,5,497,7,17,2,984,4554,1619,17299863,6
11276,murder,mRdX,5,5,0,2,3,murder,2,4,382,7,28,4,5717,17209,8602,15032081,5
14096,quickie,kwIki,2,1,1,0,2,quickie,2,5,539,6,11,0,53,188,18,664065,5
14317,reason,rizN,6,5,1,6,0,reason,2,5,480,7,33,13,9858,46135,13149,65071192,6
5825,error,ErX,5,3,2,2,3,error,2,3,461,6,63,3,473,6675,787,89407443,4
917,apply,xplY,3,0,3,2,1,apply,2,4,493,6,6,3,638,11425,1743,76341879,5
4485,dear,dIr,29,27,2,21,8,dear,1,3,318,5,97,37,11395,8260,1181,20614145,4
13308,poplin,papl|n,1,0,1,1,0,poplin,2,6,392,5,8,6,3,42,0,250399,5
1814,bigot,bIg|t,1,1,0,1,0,bigot,2,5,404,6,11,5,31,204,105,258267,6
5887,etymology,EtxmalxJi,1,0,1,1,0,etymology,5,9,778,9,2,0,7,166,7,633299,5
10853,mimic,mImIk,1,1,0,1,0,mimic,2,5,568,6,13,3,40,1044,73,1189177,6
3486,combat,kamb@t,1,1,0,1,0,combat,2,6,431,7,4,4,706,8136,2275,14972690,7
377,afraid,xfred,2,1,1,1,1,afraid,2,5,536,4,1,0,12631,16554,5014,10859260,4
12261,page,peJ,16,14,2,7,9,page,1,3,545,5,44,29,1912,28267,3773,1082139666,4
14329,rebuttal,rIb^tL,1,0,1,0,1,rebuttal,3,7,408,9,2,1,39,321,101,732926,8
14764,revocation,rEvxkeS|n,1,1,0,1,0,revocation,4,9,726,11,2,3,2,111,12,2086612,10
6700,formal,formL,3,2,1,1,2,formal,2,6,429,7,8,5,424,10117,844,22274656,7
165,ache,ek,24,12,12,15,9,ache,1,2,329,5,89,19,127,1047,60,1073348,3
6609,focus,fok|s,1,1,0,1,0,focus,2,5,515,6,10,3,1499,34865,7002,65636235,6
1476,balm,bam,13,12,1,6,7,balm,1,3,373,5,104,26,30,580,29,1851587,4
7000,garden,gardN,2,1,1,1,1,garden,2,6,452,7,34,19,1354,19403,1092,119016327,7
16824,swing,swIG,12,10,2,5,7,swing,1,4,473,6,28,18,1325,6943,993,12736938,5
16156,spoil,spOl,6,3,3,1,5,spoil,1,4,551,6,11,3,593,751,102,1419609,5
5193,dope,dop,20,18,2,11,9,dope,1,3,327,5,60,29,820,852,218,1490576,4
7436,groat,grot,14,11,3,4,10,groat,1,4,306,5,40,9,3,13,2,94121,5
19096,wit,wIt,31,25,6,21,10,wit,1,3,273,4,100,39,302,1766,174,5154711,4
9470,khaki,k@ki,12,12,0,5,7,khaki,2,4,399,6,62,1,42,603,19,1481504,5
2400,cable,kebL,8,7,1,8,0,cable,2,5,479,6,46,25,1108,9562,1538,70084276,6
1969,bluff,bl^f,5,3,2,3,2,bluff,1,4,569,6,15,7,317,1200,141,3906971,5
9687,latchkey,l@Cki,2,1,1,1,1,latchkey,2,5,580,6,6,0,16,73,27,44170,4
7186,glad,gl@d,9,5,4,4,5,glad,1,4,395,5,24,15,8740,9592,3480,14587046,5
9491,kind,kYnd,7,6,1,6,1,kind,1,4,449,5,28,22,30125,104455,50734,70424712,5
17478,tool,tul,23,20,3,15,8,tool,1,3,469,5,88,17,548,9630,928,65017834,4
5363,dunk,d^Gk,13,10,3,10,3,dunk,1,4,404,5,34,24,132,662,177,1187671,5
11262,mum,m^m,23,21,2,12,11,mum,1,3,314,4,64,26,1108,992,67,3767227,4
5819,errand,Erxnd,2,1,1,1,1,errand,2,5,509,7,18,4,204,433,30,351729,6
12363,papal,pepL,4,4,0,3,1,papal,2,5,370,6,11,7,27,737,105,755092,5
70,abroad,xbrcd,2,1,1,1,1,abroad,2,5,649,5,4,1,250,5754,929,14838366,4
14808,riddance,rIdNs,2,1,1,0,2,riddance,2,6,609,5,1,0,88,132,19,336933,6
1878,black,bl@k,10,7,3,6,4,black,1,4,469,6,50,15,8565,102441,14607,244730556,5
13120,platter,pl@tX,10,4,6,4,6,platter,2,5,499,8,22,17,149,1386,65,1470060,6
1545,bark,bark,15,11,4,7,8,bark,1,4,334,5,78,37,280,2199,149,3560716,5
6496,flame,flem,11,7,4,6,5,flame,1,4,396,6,26,13,461,2760,274,8528941,5
9202,irregular,IrEgyUlX,1,0,1,1,0,irregular,4,8,551,10,2,1,129,1277,84,3098125,9
12319,pamper,p@mpX,3,3,0,2,1,pamper,2,5,529,7,12,13,26,126,21,720825,6
16428,stove,stov,8,6,2,0,8,stove,1,4,602,6,20,12,387,3105,170,3914849,5
16980,tap,t@p,26,23,3,17,9,tap,1,3,349,4,81,43,752,4562,531,8780413,4
15916,soak,sok,23,18,5,18,5,soak,1,3,405,5,98,17,176,1511,121,1700767,4
15495,sew,so,29,21,8,14,15,sew,1,2,424,4,161,42,280,503,60,1759009,3
7260,goat,got,26,20,6,19,7,goat,1,3,327,5,73,20,537,2377,145,5235987,4
9735,leach,liC,22,19,3,8,14,leach,1,3,409,6,91,17,38,771,152,1516929,4
922,apportion,xporS|n,2,1,1,2,0,apportion,3,7,632,10,3,0,0,70,13,157850,8
17824,tumble,t^mbL,8,5,3,7,1,tumble,2,6,411,7,15,13,79,1034,160,1925795,7
15888,snarl,snarl,1,0,1,1,0,snarl,1,5,548,6,3,6,27,312,15,185848,6
14089,quest,kwEst,2,1,1,2,0,quest,1,5,499,6,11,8,327,4094,410,14259468,6
4143,cream,krim,12,10,2,3,9,cream,1,4,375,6,63,12,2484,12932,1161,25904212,5
11337,myself,mYsElf,1,1,0,1,0,myself,2,6,558,4,0,0,17470,36579,7766,37995464,4
14841,rink,rIGk,19,11,8,15,4,rink,1,4,369,5,66,35,109,741,107,1259898,5
1524,bar,bar,24,17,7,12,12,bar,1,3,499,4,146,57,4385,20009,1962,77386125,4
10048,loam,lom,23,21,2,13,10,loam,1,3,365,5,84,13,3,211,2,559498,4
18118,unnecessarily,^nEs|sErxli,1,0,1,1,0,unnecessarily,6,12,1038,11,0,0,41,600,95,917919,10
3985,corpus,korpxs,2,1,1,1,1,corpus,2,6,474,7,6,8,77,1334,200,5137372,7
8137,hurdle,hRdL,5,4,1,3,2,hurdle,2,5,439,7,16,5,37,880,190,1048302,6
7388,gray,gre,18,8,10,7,11,gray,1,3,449,5,61,31,1077,16298,1305,21425871,4
8523,incentive,InsEntIv,1,1,0,1,0,incentive,3,8,778,10,3,3,100,3588,636,8145211,9
1126,asp,@sp,7,3,4,4,3,asp,1,3,423,4,15,17,6,353,5,16795329,4
15488,settler,sEtlX,2,0,2,0,2,settler,2,5,495,8,36,18,4,463,48,561352,6
15743,sizzle,sIzL,6,6,0,2,4,sizzle,2,5,404,7,22,3,32,350,37,392168,6
5630,employer,ImplOX,2,1,1,0,2,employer,3,6,584,9,8,6,274,4135,962,24681017,7
4223,cross,krcs,5,4,1,1,4,cross,1,4,483,6,53,19,2807,22765,3248,74233408,5
14521,release,rIlis,2,2,0,0,2,release,2,5,485,8,9,2,1851,14725,3474,125346004,6
13354,posit,paz|t,1,1,0,1,0,posit,2,5,496,6,3,3,6,297,17,292939,6
759,annual,@nyuL,1,0,1,1,0,annual,3,6,475,7,2,4,367,18643,1286,85045142,7
14278,rave,rev,26,22,4,15,11,rave,1,3,410,5,78,42,129,545,93,2750781,4
3695,confine,kxnfYn,3,3,0,0,3,confine,2,6,664,8,4,4,50,373,37,580746,7
13102,plant,pl@nt,8,2,6,3,5,plant,1,5,351,6,19,19,1408,22580,2700,53249198,6
17054,teeny,tini,11,11,0,7,4,teeny,2,4,397,5,58,8,128,293,73,750932,4
18625,visor,vYzX,6,5,1,4,2,visor,2,4,559,6,34,6,30,398,16,1851832,5
10113,loose,lus,23,20,3,14,9,loose,1,3,421,6,109,18,2131,8673,1058,12556710,4
15747,sketch,skEC,3,2,1,1,2,sketch,1,4,538,7,7,3,252,2190,319,4119537,5
633,amiss,xmIs,5,4,1,2,3,amiss,2,4,460,5,10,6,38,274,39,273918,4
1636,beam,bim,16,14,2,9,7,beam,1,3,443,5,94,25,445,3469,153,11828265,4
8843,innards,InXdz,1,0,1,1,0,innards,2,5,464,7,3,2,20,236,9,143971,5
11738,numb,n^m,17,17,0,12,5,numb,1,3,371,5,60,3,249,1189,180,1255499,4
2973,chase,Ces,17,13,4,12,5,chase,1,3,410,6,38,21,1673,6499,1242,10975462,4
10254,maggot,m@g|t,3,2,1,2,1,maggot,2,5,443,7,13,4,81,433,15,296057,6
7072,generation,JEnXeS|n,1,1,0,1,0,generation,4,8,704,11,4,3,619,19142,3324,39915989,9
2215,broad,brcd,13,11,2,2,11,broad,1,4,400,6,34,9,751,13232,1515,21370804,5
5282,drip,drIp,9,7,2,4,5,drip,1,4,337,5,20,8,261,1119,127,1856411,5
11166,mortar,mortX,4,3,1,3,1,mortar,2,5,609,7,24,5,117,1247,194,2046739,6
8741,infield,Infild,1,1,0,0,1,infield,2,6,618,8,5,3,24,467,23,449788,7
154,accuse,xkyuz,5,3,2,2,3,accuse,2,5,599,7,16,3,290,1197,389,1048371,6
1457,bald,bcld,4,2,2,3,1,bald,1,4,371,5,30,22,496,2136,219,5944017,5
7395,greasy,grisi,1,0,1,0,1,greasy,2,5,555,6,23,2,199,964,48,863561,6
7675,harsh,harS,7,7,0,1,6,harsh,1,4,416,6,39,11,362,4290,784,4087715,5
7519,gurgle,gRgL,3,3,0,2,1,gurgle,2,5,399,6,11,2,12,121,0,65729,6
17567,trade,tred,13,9,4,4,9,trade,1,4,460,6,30,8,1795,33288,6150,110088441,5
112,accent,@ksEnt,1,1,0,0,1,accent,2,6,556,7,4,4,621,3344,405,6037126,7
11895,often,cfxn,4,1,3,3,1,often,2,4,374,6,13,9,2925,90164,9149,92552476,5
6554,float,flot,13,11,2,3,10,float,1,4,479,6,25,8,381,2463,227,8810443,5
16273,stance,st@ns,1,1,0,0,1,stance,1,5,571,7,15,6,96,3464,394,3257959,6
7709,hay,he,26,22,4,15,11,hay,1,2,273,4,158,47,325,2166,136,5692533,3
11604,node,nod,20,17,3,13,7,node,1,3,390,5,89,23,25,903,31,22292005,4
14856,rising,rYzIG,3,3,0,3,0,rising,2,5,445,7,15,8,429,13266,1783,14080002,6
16038,spa,spa,6,3,3,1,5,spa,1,3,511,4,21,16,239,2418,160,31723651,4
13773,prop,prap,7,5,2,4,3,prop,1,4,254,5,29,17,188,2206,269,4259890,5
10239,madden,m@dN,5,4,1,2,3,madden,2,5,383,7,45,15,29,548,89,3637592,6
17901,twopenny,t^pxni,1,1,0,0,1,twopenny,3,7,526,7,1,0,0,1,0,8177,7
10100,longer,lcGgX,2,2,0,2,0,longer,2,5,434,7,2,14,5046,42136,6803,54063969,6
10623,median,midixn,1,1,0,0,1,median,3,6,658,7,5,6,20,2914,188,12384523,6
18556,vilify,vIlxfY,2,1,1,1,1,vilify,3,6,618,7,0,1,8,86,30,56266,5
8646,indict,IndYt,3,3,0,3,0,indict,2,5,445,7,4,3,45,368,208,160138,6
5505,elaborate,xl@bXet,1,0,1,1,0,elaborate,4,7,758,10,1,2,242,4016,454,3295794,8
8954,insulation,InsxleS|n,2,1,1,2,0,insulation,4,9,777,9,3,0,51,1440,102,5074667,7
16041,spacious,speS|s,1,1,0,1,0,spacious,2,6,683,6,4,1,58,1118,35,4793663,6
18599,virtual,vRCuL,1,0,1,0,1,virtual,3,6,659,8,2,0,133,5844,561,50848529,7
4316,cure,kyUr,1,1,0,1,0,cure,1,4,353,5,11,25,1063,4535,1068,10047578,5
9705,laugh,l@f,19,19,0,9,10,laugh,1,3,509,6,65,12,3206,11520,2720,9824355,4
18492,vet,vEt,16,14,2,13,3,vet,1,3,415,4,62,30,296,1319,214,4985571,4
13978,purge,pRJ,14,10,4,7,7,purge,1,3,437,6,43,9,82,504,66,1367409,4
5143,dodge,daJ,8,8,0,3,5,dodge,1,3,392,6,40,11,396,2356,287,14768509,4
16220,squash,skwaS,5,3,2,2,3,squash,1,5,612,7,5,2,223,2311,103,3985349,6
15174,sauce,scs,10,8,2,6,4,sauce,1,3,579,6,68,8,795,10143,510,10969320,4
15069,saga,sagx,1,1,0,0,1,saga,2,4,424,5,23,26,40,1190,218,4046853,5
11679,nosy,nozi,7,6,1,6,1,nosy,2,4,609,4,28,9,144,221,21,195434,5
14688,respond,rIspand,2,2,0,1,1,respond,2,7,730,8,3,3,719,13311,3825,23761961,8
16326,steer,stIr,15,12,3,7,8,steer,1,4,497,6,42,25,305,1809,169,2159937,5
14253,ratchet,r@C|t,4,4,0,4,0,ratchet,2,5,459,8,5,1,38,314,72,1049663,6
15829,slope,slop,9,7,2,3,6,slope,1,4,360,6,27,12,150,3582,231,6470260,5
17388,tinsel,tInsL,2,2,0,2,0,tinsel,2,6,442,7,16,4,24,169,15,277040,7
9424,jurist,JUr|st,1,1,0,1,0,jurist,2,6,629,7,2,4,13,154,30,471278,6
16665,sully,s^li,8,7,1,7,1,sully,2,4,419,6,52,13,192,365,62,458846,5
16823,swine,swYn,10,8,2,6,4,swine,1,4,668,6,26,16,226,786,288,1579187,5
13819,prostate,prastet,1,0,1,0,1,prostate,2,7,452,9,1,1,85,1681,287,6027360,8
18964,whip,hwIp,10,9,1,2,8,whip,1,3,279,5,87,16,671,2432,569,3424153,4
10551,matriarchy,metriarki,2,1,1,0,2,matriarchy,4,9,659,10,2,2,1,34,1,50050,9
8381,impel,ImpEl,2,2,0,0,2,impel,2,5,479,6,3,4,3,56,4,86447,6
4063,county,kWnti,3,2,1,1,2,county,2,5,476,7,11,4,1722,36919,5855,227576453,6
6831,frontier,fr^ntIr,1,1,0,0,1,frontier,2,7,565,9,5,2,167,3182,306,6329201,8
3186,circular,sRkyUlX,1,1,0,1,0,circular,3,7,619,9,2,1,81,2222,78,7991762,8
5332,dude,dud,20,18,2,10,10,dude,1,3,479,5,78,27,5071,1885,368,6425633,4
7364,graph,gr@f,7,5,2,1,6,graph,1,4,431,6,36,3,38,3127,59,15527368,5
2604,caption,k@pS|n,2,2,0,0,2,caption,2,6,434,8,11,3,18,1221,90,4588270,7
15375,seize,siz,22,17,5,9,13,seize,1,3,639,6,188,7,246,1716,411,1910081,4
6448,fireman,fYrmxn,1,1,0,1,0,fireman,2,6,430,8,15,7,149,458,118,1001611,7
908,apple,@pL,8,5,3,6,2,apple,2,4,375,6,28,6,1207,10229,1204,50562141,5
4215,crook,krUk,8,6,2,3,5,crook,1,4,337,6,26,12,289,711,119,1069614,5
12168,overboard,ovXbord,1,1,0,1,0,overboard,3,7,663,7,1,0,259,772,189,705494,6
6316,felon,fEl|n,3,2,1,2,1,felon,2,5,565,6,52,8,128,399,133,392714,6
8804,inhabit,Inh@bxt,1,1,0,1,0,inhabit,3,7,610,8,2,2,33,866,34,766321,8
11208,mouse,mWs,14,12,2,11,3,mouse,1,3,629,6,63,23,975,3760,456,33668364,4
9990,lira,lIrx,4,1,3,1,3,lira,2,4,441,5,25,22,32,158,20,1663407,5
3166,cider,sYdX,8,5,3,5,3,cider,2,4,518,4,69,8,97,1206,64,1743446,5
8745,infinite,Infxn|t,1,0,1,0,1,infinite,3,7,401,9,1,3,178,1756,107,6798243,8
17903,tyke,tYk,25,24,1,16,9,tyke,1,3,337,3,83,12,27,61,13,97529,4
17045,technique,tEknik,1,1,0,0,1,technique,2,6,409,10,3,1,456,8363,625,18830686,7
4255,crunch,kr^nC,2,1,1,1,1,crunch,1,5,353,7,6,4,179,1798,331,1794967,6
1564,barrel,b@rL,7,7,0,2,5,barrel,2,5,385,7,74,15,542,4743,937,6568339,6
13931,pulley,pUli,6,4,2,4,2,pulley,2,4,346,7,34,10,22,288,18,1139985,5
11268,mumps,m^mps,1,1,0,1,0,mumps,1,5,589,5,8,6,60,88,23,520114,5
15407,send,sEnd,18,13,5,13,5,send,1,4,526,5,46,27,9169,21808,6821,274117675,5
1587,basket,b@sk|t,3,3,0,3,0,basket,2,6,718,7,9,6,672,3871,357,45026577,7
7684,hassock,h@sxk,4,4,0,4,0,hassock,2,5,537,6,16,1,1,38,0,14265,5
14918,rosary,rozXi,3,2,1,2,1,rosary,3,5,485,6,12,1,61,380,24,1140145,6
11550,nick,nIk,23,20,3,14,9,nick,1,3,367,5,95,29,3062,7092,1199,18714124,4
8050,host,host,10,10,0,10,0,host,1,4,465,5,42,31,766,18993,8892,49921391,5
8257,iffy,Ifi,4,1,3,3,1,iffy,2,3,319,3,26,3,26,172,30,200989,4
10964,mister,mIstX,7,4,3,4,3,mister,2,5,402,7,31,20,2326,1869,440,2192815,6
9866,libel,lYbL,3,2,1,3,0,libel,2,5,401,6,31,6,56,431,99,866830,6
1928,bliss,blIs,4,3,1,0,4,bliss,1,4,484,6,32,9,160,1184,98,3710967,5
5167,dolt,dolt,10,8,2,7,3,dolt,1,4,334,5,34,20,27,45,7,87178,5
15278,scrawl,skrcl,4,3,1,3,1,scrawl,1,5,425,7,9,2,12,137,5,119040,6
7921,hire,hYr,18,16,2,13,5,hire,2,3,441,5,110,35,1302,5588,1410,36746174,4
6608,foci,fosY,1,1,0,1,0,foci,2,4,519,4,7,5,1,210,3,430193,4
6899,furry,fRi,16,12,4,7,9,furry,2,3,479,5,70,16,122,536,47,1887605,4
10797,middle,mIdL,12,11,1,7,5,middle,2,5,387,7,45,11,4549,54702,13205,70166019,6
8522,incense,InsEns,1,1,0,1,0,incense,2,6,588,8,3,2,92,609,31,3033124,7
4865,dice,dYs,19,16,3,11,8,dice,1,3,460,5,85,28,533,1292,267,6027947,4
19198,wrestle,rEsL,8,7,1,5,3,wrestle,2,5,469,8,39,5,176,689,139,718785,6
16455,straw,strc,3,2,1,0,3,straw,1,4,557,6,15,8,318,3224,566,3958211,5
12337,panel,p@nL,7,6,1,2,5,panel,2,5,379,6,30,12,372,12028,3031,53785270,6
1156,assign,xsYn,5,4,1,3,2,assign,2,4,688,7,10,1,138,1157,98,7009078,5
15584,shirk,SRk,16,14,2,14,2,shirk,1,3,500,6,89,12,13,127,21,194196,4
14547,remind,rImYnd,2,2,0,1,1,remind,2,6,629,7,6,3,1883,5309,1365,5560705,7
14607,reply,rIplY,1,0,1,0,1,reply,2,5,522,6,6,6,245,3310,222,184779691,6
2701,case,kes,22,19,3,12,10,case,1,3,362,5,100,44,14403,98299,33259,235573247,4
15467,sermon,sRmxn,7,6,1,7,0,sermon,2,5,442,7,60,6,139,1371,140,2693657,6
11931,onion,^nyxn,1,0,1,1,0,onion,2,5,429,6,8,4,216,5978,225,6385010,6
16062,spatial,speSL,1,1,0,1,0,spatial,2,6,594,8,2,1,29,3438,18,9538736,7
3100,choke,Cok,17,16,1,15,2,choke,1,3,410,6,60,11,330,1095,176,1450199,4
7419,grim,grIm,12,11,1,4,8,grim,1,4,346,5,39,19,244,2637,375,2653525,5
14530,relief,rIlif,2,2,0,0,2,relief,2,5,524,7,5,6,744,12453,2936,26483610,5
14197,ram,r@m,31,24,7,19,12,ram,1,3,441,4,122,69,328,1808,149,23869519,4
6945,gala,gelx,3,2,1,0,3,gala,2,4,385,5,37,31,90,983,69,2685970,5
4270,cub,k^b,18,17,1,12,6,cub,1,3,346,4,58,26,107,719,119,2239911,4
1428,bad,b@d,30,27,3,19,11,bad,1,3,407,4,90,46,27804,54828,17089,95105339,4
14078,quash,kwaS,5,4,1,2,3,quash,1,4,579,6,7,4,11,123,10,209847,5
230,additional,xdIS|nL,1,0,1,0,1,additional,4,8,497,11,2,0,300,20060,2293,132188550,9
9679,lash,l@S,26,21,5,16,10,lash,1,3,498,5,80,35,85,594,87,810482,4
14809,ridden,rIdN,10,8,2,5,5,ridden,2,5,479,6,45,9,109,1409,121,1322007,6
2275,buddy,b^di,6,5,1,4,2,buddy,2,4,330,6,59,14,5247,3988,858,23617675,5
4442,darken,dark|n,1,1,0,1,0,darken,2,6,549,7,15,9,20,268,7,277778,7
15238,scholar,skalX,2,0,2,2,0,scholar,2,5,519,8,20,3,186,3598,379,6110169,6
9579,lace,les,29,25,4,18,11,lace,1,3,475,5,89,37,189,1851,120,7439814,4
16023,sound,sWnd,10,9,1,10,0,sound,1,4,574,6,25,11,7313,37590,5785,100018539,5
19239,Yankee,y@Gki,3,2,1,2,1,yankee,2,5,444,7,16,4,459,1670,280,4515905,6
15503,sexton,sEkst|n,1,0,1,0,1,sexton,2,7,608,5,5,7,23,394,94,909942,8
632,amid,xmId,2,1,1,1,1,amid,2,4,449,5,6,22,45,4764,553,2995677,5
5918,eve,iv,15,6,9,7,8,eve,1,2,515,4,53,23,1437,5435,952,13243304,3
15226,scenic,sinIk,3,3,0,3,0,scenic,2,5,598,5,7,0,53,1326,47,6313122,4
5354,dumps,d^mps,3,2,1,1,2,dumps,1,5,379,6,15,11,137,639,87,1200749,6
10422,manual,m@nyuL,1,0,1,1,0,manual,3,7,500,7,5,3,408,4775,555,49700214,8
999,architecture,ark|tEkCX,1,0,1,0,1,architecture,4,9,675,13,2,1,162,4734,213,41479644,10
6633,food,fud,11,10,1,10,1,food,1,3,579,5,50,17,7876,64656,10124,180152837,4
15808,slicker,slIkX,7,5,2,3,4,slicker,2,5,526,8,25,13,42,206,22,212619,6
12533,paternity,pxtRn|ti,1,1,0,1,0,paternity,4,8,548,7,1,1,49,574,250,1122549,6
19203,wrist,rIst,16,11,5,11,5,wrist,1,4,391,6,63,14,527,3655,250,6143580,5
15730,siren,sYrxn,1,1,0,1,0,siren,2,5,639,6,19,11,334,798,106,1355000,6
18589,viral,vYrL,4,3,1,1,3,viral,2,5,452,5,12,6,45,1228,188,5973237,6
14122,quiz,kwIz,7,7,0,1,6,quiz,1,4,423,5,21,8,252,1180,270,11868500,5
16479,strike,strYk,7,7,0,0,7,strike,1,5,524,7,30,10,2324,11056,2885,18622172,6
9571,labor,lebX,7,6,1,5,2,labor,2,4,384,6,49,16,621,21153,3551,37867464,5
12232,oyster,OstX,5,4,1,5,0,oyster,2,4,471,7,16,7,156,1183,103,2621847,5
16425,story,stori,5,2,3,1,4,story,2,5,537,6,36,12,11260,81409,29771,138440672,6
1473,ballot,b@l|t,6,5,1,5,1,ballot,2,5,555,7,25,9,69,3649,1444,6136404,6
12107,outdoors,Wtdorz,1,0,1,0,1,outdoors,2,6,589,9,2,1,107,2631,184,27062564,7
15346,sect,sEkt,5,3,2,0,5,sect,1,4,442,5,39,8,37,638,152,2262094,5
10970,misty,mIsti,5,2,3,1,4,misty,2,5,495,5,19,8,80,809,148,2652959,6
12423,parental,pXEntL,1,1,0,0,1,parental,3,7,504,8,1,0,105,5370,389,6191119,5
9469,kettle,kEtL,8,8,0,7,1,kettle,2,5,344,7,38,9,143,649,35,2341770,6
3430,cola,kolx,9,7,2,3,6,cola,2,4,442,5,86,38,282,1960,242,4541953,5
5320,dub,d^b,22,20,2,12,10,dub,1,3,280,4,64,34,55,234,18,4026648,4
3339,clutter,kl^tX,4,2,2,3,1,clutter,2,5,455,8,15,5,48,864,82,3650519,6
7860,herself,hXsElf,1,1,0,1,0,herself,2,6,619,6,3,0,2675,31783,3378,13480512,4
2047,bonus,bon|s,2,1,1,2,0,bonus,2,5,437,6,12,9,469,2857,321,27822012,6
15652,side,sYd,23,17,6,15,8,side,1,3,589,5,96,33,10247,80872,16264,141164931,4
7042,gay,ge,27,18,9,15,12,gay,1,2,323,4,133,49,3013,13074,3797,167613385,3
18394,vend,vEnd,14,11,3,10,4,vend,1,4,579,5,27,14,0,12,0,188697,5
19179,worst,wRst,10,7,3,7,3,worst,1,4,463,6,40,9,2874,16383,5017,16976651,5
3049,chief,Cif,12,12,0,8,4,chief,1,3,498,6,35,4,3973,33008,9590,45700315,4
4499,debris,dxbri,2,2,0,2,0,debris,2,5,369,6,8,0,159,3558,721,3809179,6
15359,sediment,sEdxmxnt,2,2,0,2,0,sediment,3,8,533,9,2,2,21,1303,38,4441599,9
19242,yard,yard,10,10,0,9,1,yard,1,4,385,5,26,13,1278,12247,975,15076149,5
17587,trance,tr@ns,3,3,0,2,1,trance,1,5,537,7,14,8,268,671,24,7394147,6
4910,dill,dIl,31,29,2,23,8,dill,1,3,340,5,115,30,90,749,44,986552,4
1885,bladder,bl@dX,2,1,1,1,1,bladder,2,5,429,8,10,4,202,1041,97,3621454,6
15556,shell,SEl,21,18,3,16,5,shell,1,3,444,6,115,20,674,6341,709,20602041,4
10496,marvel,marvL,2,2,0,0,2,marvel,2,6,449,7,23,14,99,1103,137,5804124,7
9732,lazy,lezi,7,6,1,4,3,lazy,2,4,524,4,40,8,591,2136,288,5814660,5
3655,condemn,kxndEm,1,1,0,0,1,condemn,2,6,445,8,2,1,121,1214,406,1457478,7
5317,dryer,drYX,7,5,2,4,3,dryer,2,4,418,6,37,13,231,996,99,5592001,5
15504,sexual,sEkSuL,1,0,1,1,0,sexual,3,7,668,7,1,1,1693,26196,4657,33598687,8
6303,feed,fid,19,16,3,12,7,feed,1,3,436,5,73,25,2162,8454,1319,62664768,4
8232,ideal,Ydil,3,1,2,1,2,ideal,2,4,503,6,17,4,374,8795,598,26049328,5
15835,sludge,sl^J,7,7,0,1,6,sludge,1,4,569,6,11,3,24,600,56,1916282,5
2398,cabin,k@b|n,1,1,0,1,0,cabin,2,5,377,6,34,12,1002,5187,363,8052267,6
13759,promote,prxmot,1,0,1,0,1,promote,2,6,469,8,2,4,225,9316,912,33113581,7
4848,dialectic,dYxlEktIk,1,0,1,0,1,dialectic,4,9,748,10,1,1,7,430,5,355805,10
6587,flunk,fl^Gk,6,3,3,4,2,flunk,1,5,335,6,14,10,92,81,22,81741,6
17577,trail,trel,13,10,3,5,8,trail,1,4,485,6,35,10,979,13197,1626,23650382,5
2901,chair,CEr,20,18,2,17,3,chair,1,3,429,6,94,12,2511,19652,1787,40765136,4
15810,slide,slYd,10,8,2,4,6,slide,1,4,595,6,33,12,909,6072,544,22342722,5
12494,passe,p@se,4,2,2,1,3,passe,2,4,659,6,13,17,14,169,34,528622,4
12772,perpetrator,pRpxtretX,1,0,1,0,1,perpetrator,4,9,666,12,4,1,86,675,183,621967,10
6981,gang,g@G,15,15,0,8,7,gang,1,3,395,5,58,38,1537,6198,2038,16620142,4
6228,farmland,farml@nd,1,1,0,0,1,farmland,2,8,534,9,2,3,20,1030,99,1367501,9
4769,desperation,dEspXeS|n,1,1,0,1,0,desperation,4,9,789,9,2,0,154,1478,291,1181444,8
4575,defective,dIfEktIv,1,1,0,1,0,defective,3,8,628,8,5,1,110,729,94,4191532,8
19100,with,wIT,13,12,1,4,9,with,1,3,306,5,56,13,257465,1712763,334429,3183141788,4
4872,dictator,dIktetX,1,0,1,0,1,dictator,3,7,567,9,7,2,108,1479,561,1370656,8
27,abed,xbEd,5,4,1,2,3,abed,2,4,433,5,14,19,10,88,10,150367,5
216,acute,xkyut,2,1,1,1,1,acute,2,5,449,6,2,1,150,3508,229,11128841,6
9568,label,lebL,11,9,2,8,3,label,2,5,539,6,33,18,351,6099,859,41362819,6
10699,mentor,mEntor,1,1,0,1,0,mentor,2,6,609,7,3,6,178,2869,330,5539473,7
5964,exception,IksEpS|n,1,1,0,1,0,exception,3,8,600,10,2,1,409,6484,950,18052835,9
13967,pupil,pyupL,1,1,0,0,1,pupil,2,6,422,6,5,2,160,1215,60,4167137,7
511,alleluia,@lxluyx,1,0,1,1,0,alleluia,4,7,604,6,0,0,31,49,27,219252,4
17419,TNT,tiEnti,1,1,0,1,0,tnt,3,6,620,2,1,10,58,566,69,2606622,5
19161,work,wRk,20,18,2,14,6,work,1,3,412,5,91,23,40699,204858,39966,419498036,4
4108,crack,kr@k,18,14,4,5,13,crack,1,4,431,6,62,11,1675,7127,1522,16639894,5
203,action,@kS|n,3,1,2,3,0,action,2,5,351,7,14,7,3115,38931,8159,162029265,6
14939,rotunda,rot^ndx,1,0,1,0,1,rotunda,3,7,589,7,1,2,27,291,40,362388,8
13177,plunge,pl^nJ,2,0,2,1,1,plunge,1,5,445,7,4,4,114,1424,195,1668493,6
9757,leather,lEDX,10,10,0,6,4,leather,2,4,459,8,42,7,693,7272,336,42716044,5
4257,crush,kr^S,7,6,1,3,4,crush,1,4,439,6,35,9,857,2255,354,3577655,5
13128,plea,pli,17,10,7,8,9,plea,1,3,304,5,96,15,349,2482,914,3445286,4
11447,necessarily,nEs|sErxli,1,0,1,1,0,necessarily,5,10,733,10,0,0,575,12047,3780,15867816,8
13358,posse,pasi,4,4,0,1,3,posse,2,4,428,6,27,11,221,529,109,1038358,5
9955,linen,lIn|n,2,1,1,0,2,linen,2,5,519,6,39,13,149,1687,47,4961488,6
10992,mock,mak,24,20,4,17,7,mock,1,3,365,5,130,26,274,1900,210,3161960,4
9922,likely,lYkli,1,1,0,1,0,likely,2,5,455,6,8,1,1314,51211,6504,55669730,6
2927,change,CenJ,3,2,1,2,1,change,1,4,508,7,17,7,12258,80896,18784,210606359,5
18202,uptown,^ptWn,1,1,0,0,1,uptown,2,5,518,5,4,1,246,664,89,1683524,4
15951,solar,solX,13,11,2,7,6,solar,2,4,499,6,89,15,236,9611,875,20427276,4
18606,visa,vizx,2,2,0,0,2,visa,2,4,422,5,21,22,216,1720,392,22906674,5
7940,hoarse,hors,11,9,2,5,6,hoarse,1,4,465,7,43,4,25,486,34,245236,5
524,alliterate,xlItXet,1,0,1,1,0,alliterate,4,8,559,10,0,1,0,1,0,6747,5
9690,lateral,l@tXL,2,1,1,1,1,lateral,3,6,577,6,4,1,78,1714,32,4547513,5
15597,shop,Sap,16,15,1,12,4,shop,1,3,384,5,96,20,2731,15046,1834,212807264,4
7705,hawk,hck,18,14,4,13,5,hawk,1,3,382,5,89,14,650,2431,319,6531503,4
12465,part,part,17,12,5,9,8,part,1,4,345,5,55,35,13337,130109,33847,302741007,5
5732,entrust,Intr^st,1,1,0,0,1,entrust,2,7,603,8,5,3,37,187,39,505100,8
18558,village,vIlIJ,3,3,0,3,0,village,2,5,559,8,6,5,1712,16423,1478,42339742,6
894,appellant,xpElxnt,1,0,1,0,1,appellant,3,7,510,8,1,0,7,24,1,4776547,5
3108,chop,Cap,18,16,2,13,5,chop,1,3,397,5,57,19,694,1922,240,2317116,4
15656,siding,sYdIG,4,3,1,4,0,siding,2,5,529,5,19,11,68,827,122,2490194,5
3137,chronic,kranIk,3,1,2,2,1,chronic,2,6,431,8,9,1,252,6034,578,13653202,7
8857,innumerable,InumXxbL,1,0,1,1,0,innumerable,5,9,675,5,1,0,10,552,31,661389,6
1465,ball,bcl,24,21,3,19,5,ball,1,3,278,5,124,42,5353,22439,2756,43407316,4
6749,fox,faks,8,5,3,6,2,fox,1,4,599,4,54,25,1102,12291,5020,23801385,5
9560,kraut,krWt,7,6,1,3,4,kraut,1,4,230,6,34,9,79,87,7,254150,5
10236,madam,m@dM,3,2,1,0,3,madam,2,5,376,6,12,12,2244,880,269,2023575,6
17910,typical,tIpIkL,1,0,1,1,0,typical,3,7,454,8,2,3,642,12210,1578,20693008,6
12483,partly,partli,4,2,2,1,3,partly,2,6,369,6,17,3,175,6788,988,13790568,6
2369,bust,b^st,17,15,2,13,4,bust,1,4,432,5,55,37,1406,2132,407,4547742,5
3297,clinch,klInC,3,2,1,3,0,clinch,1,5,371,7,14,5,34,397,50,578103,6
19259,yellow,yElo,7,6,1,5,2,yellow,2,4,516,7,25,6,1724,15507,891,82029392,5
7328,grace,gres,16,14,2,4,12,grace,1,4,507,6,55,29,2157,9873,1300,17646408,5
10065,localize,lokxlYz,1,1,0,1,0,localize,3,7,668,9,4,2,1,91,7,378081,8
1830,billion,bIlyxn,3,3,0,2,1,billion,2,6,396,8,21,12,568,39127,10929,31586983,7
14703,restraint,rIstrent,1,0,1,0,1,restraint,2,8,537,10,2,4,131,2028,380,2590802,9
354,affirm,xfRm,1,0,1,1,0,affirm,2,4,738,7,5,1,17,850,82,1680655,5
3157,church,CRC,8,8,0,4,4,church,1,3,388,7,19,0,3553,48057,7319,84560388,4
4406,dairy,dEri,11,9,2,10,1,dairy,2,4,416,6,125,7,142,2607,190,8781961,5
13659,prisoner,prIzNX,1,0,1,0,1,prisoner,2,6,418,9,5,3,1180,2971,698,5124810,7
10481,marriage,m@rIJ,2,2,0,2,0,marriage,2,5,457,9,17,3,3930,22739,4931,30592388,6
12845,petty,pEti,9,8,1,6,3,petty,2,4,263,5,69,21,438,1977,394,3195594,5
2049,booby,bubi,6,5,1,3,3,booby,2,4,439,5,46,7,129,249,55,381428,4
14731,retrieve,rItriv,2,2,0,1,1,retrieve,2,6,583,9,2,5,210,1559,125,6442033,7
10304,make,mek,25,23,2,16,9,make,1,3,392,5,105,40,70775,229111,63967,405099240,4
16352,stern,stRn,10,5,5,4,6,stern,1,4,507,6,29,11,327,3975,1003,4643904,5
14948,round,rWnd,12,10,2,12,0,round,1,4,433,6,30,16,3393,22922,2380,61839542,5
1917,bless,blEs,6,4,2,1,5,bless,1,4,478,6,27,10,1788,1956,796,5481678,5
16359,stick,stIk,18,13,5,4,14,stick,1,4,433,6,60,19,4953,11876,2438,22401369,5
19138,wonder,w^ndX,5,4,1,5,0,wonder,2,5,403,7,14,14,5966,17638,4344,22807901,6
9766,ledge,lEJ,18,13,5,10,8,ledge,1,3,449,6,50,13,179,1136,49,1157873,4
17246,thesis,Tis|s,1,1,0,1,0,thesis,2,5,495,6,4,4,174,2133,136,10415875,5
2890,cessation,sEseS|n,1,0,1,1,0,cessation,3,7,697,5,1,0,10,766,103,2137188,4
4532,declaration,dEklXeS|n,1,0,1,1,0,declaration,4,9,695,12,2,2,180,3564,783,12609210,10
1802,bicycle,bYsIkL,1,0,1,1,0,bicycle,3,7,500,8,3,2,337,2795,250,8345968,8
15368,seethe,siD,16,15,1,5,11,seethe,1,3,502,7,71,3,5,55,3,50100,4
8837,inlaid,Inled,2,1,1,1,1,inlaid,2,5,501,5,2,1,9,280,7,492826,5
12638,pelt,pElt,14,12,2,9,5,pelt,1,4,322,5,40,24,48,274,23,353623,5
13026,pinnacle,pInIkL,2,2,0,2,0,pinnacle,3,7,467,9,1,1,22,551,64,4336213,6
16415,stool,stul,12,10,2,3,9,stool,1,4,544,6,51,8,179,1604,89,3031945,5
13909,publish,p^blIS,1,1,0,0,1,publish,2,6,509,8,3,0,260,2508,425,14255645,7
5427,eat,it,24,11,13,17,7,eat,1,2,268,4,80,39,12846,24034,4479,29245847,3
16,abbey,@bi,10,5,5,9,1,abbey,2,3,479,6,57,4,162,1069,281,4224864,4
4550,decoration,dEkXeS|n,1,0,1,1,0,decoration,4,8,619,11,2,1,94,1131,46,4702490,9
15635,shrug,Sr^g,3,2,1,2,1,shrug,1,4,469,6,13,3,20,1291,43,720506,5
16295,starve,starv,4,3,1,0,4,starve,1,5,563,7,20,5,314,705,176,546035,6
1728,belt,bElt,17,15,2,10,7,belt,1,4,275,5,64,31,1242,7322,870,17247634,5
15920,sob,sab,18,16,2,13,5,sob,1,3,549,4,65,32,77,513,54,800059,4
6810,frigid,frIJ|d,1,0,1,1,0,frigid,2,6,452,7,2,2,71,836,80,315044,6
1027,arise,xrYz,7,4,3,4,3,arise,2,3,668,6,73,15,151,3062,199,8337093,4
17185,text,tEkst,2,1,1,1,1,text,1,5,446,5,15,10,267,16376,945,208792303,6
15568,shield,Sild,4,4,0,4,0,shield,1,4,542,7,45,6,418,3277,561,9374878,5
5942,evolution,EvxluS|n,2,0,2,2,0,evolution,4,8,808,10,4,2,272,7447,539,25682930,9
12870,pheasant,fEzNt,1,1,0,1,0,pheasant,2,6,524,9,4,3,41,294,11,884202,7
11116,moon,mun,21,19,2,16,5,moon,1,3,343,5,83,36,2548,13778,1130,28383832,4
16494,stroll,strol,6,4,2,2,4,stroll,1,5,576,7,21,8,211,1337,66,1693118,6
9910,light,lYt,35,26,9,22,13,light,1,3,362,6,96,20,8425,63737,5356,126705720,4
6466,five,fYv,12,11,1,6,6,five,1,3,495,5,38,18,14558,97854,20728,104171991,4
13220,poker,pokX,8,6,2,4,4,poker,2,4,398,6,39,15,819,1501,266,129058482,5
9897,lied,lit,40,29,11,23,17,lied,1,3,509,5,88,26,2234,2722,1078,2215843,4
6827,frond,frand,2,1,1,2,0,frond,1,5,415,6,8,5,2,72,1,88985,6
16324,steep,stip,10,8,2,3,7,steep,1,4,373,6,41,15,125,4143,238,3399504,5
11710,novice,navxs,2,2,0,2,0,novice,2,5,476,7,5,5,41,1203,49,3498131,6
14776,rhesus,ris|s,2,2,0,1,1,rhesus,2,5,473,4,7,0,9,100,7,345267,6
12534,path,p@T,14,14,0,5,9,path,1,3,462,5,39,31,1252,15170,1953,45912706,4
1854,birch,bRC,15,14,1,8,7,birch,1,3,379,6,83,7,79,1162,55,2936180,4
2793,cautious,kcS|s,2,2,0,1,1,cautious,2,5,659,9,4,2,171,2839,689,1901221,6
8152,hut,h^t,27,26,1,17,10,hut,1,3,301,4,96,41,674,2019,105,3476174,4
7914,hinge,hInJ,4,4,0,3,1,hinge,1,4,547,6,19,17,29,664,59,1759781,5
14875,roam,rom,28,24,4,16,12,roam,1,3,364,5,117,19,173,823,107,1054358,4
15364,seek,sik,31,25,6,19,12,seek,1,3,515,5,140,26,934,12361,1441,24141213,4
2094,bounce,bWns,4,3,1,3,1,bounce,1,4,418,7,14,10,502,1905,460,4384896,5
14986,ruler,rulX,3,2,1,1,2,ruler,2,4,499,6,45,12,162,1341,140,2615823,5
11894,oft,cft,7,3,4,3,4,oft,1,3,362,4,19,19,21,663,24,1310380,4
5817,erode,Irod,2,0,2,2,0,erode,2,4,475,6,18,6,6,596,87,774411,5
3120,chose,Coz,12,11,1,9,3,chose,1,3,492,6,84,16,952,9686,1744,9409845,4
2265,buck,b^k,29,26,3,16,13,buck,1,3,346,5,115,33,1721,4894,585,6670099,4
14252,rat,r@t,37,31,6,23,14,rat,1,3,368,4,113,60,1663,2717,412,10634958,4
11466,needy,nidi,4,3,1,1,3,needy,2,4,449,5,44,11,155,1078,121,1636137,5
2147,brat,br@t,11,8,3,2,9,brat,1,4,259,5,47,26,317,375,50,889407,5
8813,inhibit,InhIbxt,1,1,0,1,0,inhibit,3,7,543,8,3,2,17,786,51,1931066,8
11513,neural,nUrL,1,1,0,1,0,neural,2,5,372,6,5,1,100,963,38,5293535,6
4104,cozy,kozi,5,5,0,4,1,cozy,2,4,400,5,47,11,288,1798,195,2331741,5
13299,poop,pup,14,14,0,13,1,poop,1,3,280,5,63,20,285,310,52,1589608,4
3890,convention,kxnvEnC|n,1,1,0,1,0,convention,3,9,539,11,4,3,629,10166,3552,27974338,10
14710,retail,ritel,3,3,0,2,1,retail,2,5,521,7,10,5,118,5959,873,58188936,6
16412,stone,ston,14,11,3,4,10,stone,1,4,571,6,43,21,2072,18395,2160,42499580,5
15999,soothe,suD,9,7,2,3,6,soothe,1,3,499,7,31,3,66,609,49,675582,4
9755,leash,liS,16,15,1,2,14,leash,1,3,350,6,79,10,219,742,95,1310125,4
12432,parish,p@rIS,3,3,0,2,1,parish,2,5,462,7,16,14,154,3567,493,10808822,6
1059,array,xre,12,9,3,10,2,array,2,2,423,6,129,2,108,4855,280,25151784,3
18401,veneration,vEnXeS|n,1,1,0,1,0,veneration,4,8,739,9,1,1,2,200,5,182663,6
5294,drone,dron,12,11,1,5,7,drone,1,4,413,6,35,17,144,930,178,725818,5
8061,hound,hWnd,9,9,0,9,0,hound,1,4,527,6,22,10,257,591,58,2228633,5
10724,merry,mEri,11,9,2,9,2,merry,2,4,463,6,131,14,1994,1634,453,6373348,5
6156,facing,fesIG,1,1,0,1,0,facing,2,5,533,7,15,7,548,12739,3061,13385115,6
6388,fiesta,fiEstx,1,1,0,1,0,fiesta,3,6,628,6,2,3,64,718,45,4095121,4
7728,heard,hRd,20,18,2,12,8,heard,1,3,425,5,77,17,19775,56385,19688,45439231,4
11201,mound,mWnd,11,11,0,10,1,mound,1,4,649,6,26,13,77,1929,81,2259654,5
15361,sedition,sIdIS|n,2,1,1,2,0,sedition,3,7,514,8,2,3,23,136,24,374392,7
18559,villain,vIl|n,2,2,0,1,1,villain,2,5,475,8,32,3,212,933,251,1302147,6
14919,rose,roz,26,22,4,13,13,rose,1,3,438,5,188,56,2704,21689,3252,38921703,4
8742,infighting,InfYtIG,1,1,0,1,0,infighting,3,7,492,5,3,0,12,249,54,169089,4
16098,spend,spEnd,5,3,2,3,2,spend,1,5,668,6,18,9,4757,24466,6789,26713780,6
4265,cryptic,krIptIk,2,1,1,1,1,cryptic,2,7,479,6,3,0,53,489,34,795088,6
2298,bull,bUl,13,12,1,10,3,bull,1,3,269,5,60,29,1403,4710,696,10234576,4
13446,pram,pram,5,4,1,1,4,pram,1,4,451,5,33,26,11,44,0,580828,5
16789,swan,swan,11,10,1,1,10,swan,1,4,528,5,41,24,348,1129,128,4767599,5
6949,gall,gcl,24,23,1,18,6,gall,1,3,389,5,104,40,101,606,69,1441994,4
4561,dedication,dEdIkeS|n,1,1,0,1,0,dedication,4,9,681,9,2,1,173,1697,197,4357261,7
17,abbot,@bxt,3,2,1,1,2,abbot,2,4,532,6,13,1,43,320,21,992552,5
3208,citadel,sIt|dL,1,1,0,1,0,citadel,3,7,718,8,1,0,23,606,62,1552954,8
18682,volley,vali,7,7,0,7,0,volley,2,4,469,7,72,19,24,336,31,550438,5
2869,ceramic,sX@mIk,1,1,0,0,1,ceramic,3,6,557,8,2,2,62,1668,35,9532177,7
17682,trend,trEnd,5,2,3,3,2,trend,1,5,482,6,11,8,106,8761,1285,15747246,6
15221,scavenge,sk@vxnJ,1,0,1,0,1,scavenge,2,7,678,9,1,1,10,80,2,100042,8
16900,tabby,t@bi,10,8,2,5,5,tabby,2,4,378,5,42,6,37,200,11,504455,4
9325,Jew,Ju,26,22,4,18,8,jew,1,2,509,4,149,26,549,2212,294,2805498,3
11976,optical,aptIkL,3,2,1,1,2,optical,3,7,634,8,3,2,56,2718,72,26672631,8
11620,nominee,namxni,3,3,0,2,1,nominee,3,6,461,8,3,2,40,3871,2564,3218094,7
6191,FALSE,fcls,4,3,1,2,2,FALSE,1,4,487,6,21,4,1078,8572,1892,33477065,5
12201,overshoot,ovXSut,1,0,1,0,1,overshoot,3,6,549,10,2,2,7,53,11,190146,7
15613,showman,Somxn,4,3,1,4,0,showman,2,5,659,8,48,1,17,194,37,158605,6
13895,psychologist,sYkalxJ|st,1,1,0,1,0,psychologist,4,10,948,13,1,1,183,4086,835,2678215,11
4760,designation,dEzIgneS|n,1,1,0,1,0,designation,4,10,646,12,2,3,11,1112,54,6157234,8
16935,taint,tent,8,7,1,7,1,taint,1,4,391,6,20,10,40,304,59,381803,5
11044,molten,moltN,1,0,1,0,1,molten,2,6,498,6,24,9,59,628,43,915434,5
2121,bra,bra,3,3,0,0,3,bra,1,3,351,4,50,33,557,1276,195,8318955,4
4251,crumb,kr^m,11,9,2,5,6,crumb,1,4,390,6,56,6,92,526,79,675360,5
4928,dingle,dIGgL,7,6,1,7,0,dingle,2,6,347,7,23,16,12,71,15,357021,7
4564,deed,did,18,17,1,13,5,deed,1,3,421,5,101,27,475,1041,96,4207607,4
6257,fate,fet,29,24,5,18,11,fate,1,3,388,5,86,35,1375,6063,965,7165648,4
6501,flange,fl@nJ,1,1,0,0,1,flange,1,5,537,7,4,2,12,167,1,1552260,6
14639,require,rIkwYr,1,1,0,0,1,require,3,6,614,8,1,5,542,17978,1779,53495303,6
13444,praise,prez,11,7,4,7,4,praise,1,4,509,7,53,7,482,4168,587,8892678,5
12123,outing,WtIG,1,1,0,1,0,outing,2,4,352,7,14,10,51,891,92,1684723,5
19199,wrestling,rEslIG,1,1,0,1,0,wrestling,2,6,576,10,9,3,446,2120,406,10996646,5
11734,null,n^l,17,16,1,12,5,null,1,3,369,5,80,17,27,641,84,30740645,4
68,abreast,xbrEst,2,0,2,2,0,abreast,2,6,828,5,6,1,26,344,26,758922,4
6870,fun,f^n,25,22,3,19,6,fun,1,3,388,4,91,25,12010,24061,7103,108402779,4
5296,droop,drup,9,7,2,4,5,droop,1,4,324,6,30,6,17,142,2,160489,5
16938,talc,t@lk,5,4,1,0,5,talc,1,4,365,5,15,6,12,57,2,342091,5
10476,marquee,marki,4,2,2,0,4,marquee,2,5,551,8,55,4,27,548,88,1137374,6
11939,onyx,anIks,1,0,1,1,0,onyx,2,5,569,3,14,3,17,220,8,2323594,4
4582,deficit,dEfxs|t,1,1,0,0,1,deficit,3,7,678,8,2,1,55,9589,4966,6564569,8
17431,toe,to,31,19,12,16,15,toe,1,2,338,4,151,56,647,3359,330,14254439,3
10795,midday,mIde,4,3,1,0,4,midday,2,5,466,6,1,1,42,970,84,1059877,4
18182,uppermost,^pXmost,2,1,1,2,0,uppermost,3,7,651,7,1,0,5,200,26,304426,5
6557,flog,flag,4,4,0,1,3,flog,1,4,597,5,25,18,15,56,5,227677,5
19258,yell,yEl,19,16,3,14,5,yell,1,3,329,5,77,20,939,1555,269,1654034,4
6612,fog,fcg,10,9,1,7,3,fog,1,3,518,4,51,30,482,3065,233,6897025,4
9033,interment,IntRmxnt,1,0,1,0,1,interment,3,8,590,8,1,4,6,48,9,656046,8
15853,smear,smIr,8,6,2,7,1,smear,1,4,480,6,32,9,111,881,232,1289528,5
14057,quake,kwek,9,6,3,3,6,quake,1,4,422,6,25,7,82,1466,323,4544751,5
4282,cuff,k^f,16,16,0,10,6,cuff,1,3,389,5,64,14,291,1339,99,2625819,4
6277,fear,fIr,31,27,4,23,8,fear,1,3,429,5,104,28,3523,27002,5643,28053342,4
14315,rear,rIr,32,29,3,21,11,rear,1,3,489,5,101,35,634,7406,459,22323354,4
5358,dune,dun,27,26,1,18,9,dune,1,3,408,5,113,29,51,476,20,1927380,4
7679,has,h@z,20,18,2,8,12,has,1,3,473,4,90,58,57830,657027,172721,1046332086,4
10824,mileage,mYlIJ,1,1,0,1,0,mileage,2,5,678,5,5,1,101,1145,161,6029552,5
14477,regimen,rEJ|mxn,1,0,1,0,1,regimen,3,7,504,8,2,6,40,1213,77,1615927,8
10136,lousy,lWzi,2,1,1,2,0,lousy,2,4,448,5,17,4,1210,1342,277,1095083,5
1920,blight,blYt,12,10,2,7,5,blight,1,4,332,7,28,8,29,550,27,906914,5
6996,garage,gXaZ,1,1,0,1,0,garage,2,4,566,7,2,6,1388,5331,746,16907329,5
4072,court,kort,17,14,3,8,9,court,1,4,400,6,81,6,5137,66292,24723,127722336,5
7380,gravel,gr@vL,6,4,2,4,2,gravel,2,6,579,7,14,16,73,2430,92,3294483,7
1643,beat,bit,33,26,7,22,11,beat,1,3,385,5,122,37,6716,21369,3686,27621105,4
11388,narrow,n@ro,6,5,1,6,0,narrow,2,4,394,7,52,15,358,10916,909,18585597,5
9767,ledger,lEJX,6,5,1,1,5,ledger,2,4,589,7,35,10,62,737,131,2840827,5
10979,mix,mIks,7,5,2,5,2,mix,1,4,446,4,74,26,834,12485,1451,32437743,5
5696,enough,In^f,1,1,0,1,0,enough,2,4,496,7,6,1,25568,94927,19713,83595746,5
2289,build,bIld,11,9,2,3,8,build,1,4,399,6,45,5,2452,24757,4959,77204399,5
8277,illegitimate,IlIJItxmxt,1,0,1,1,0,illegitimate,5,10,620,11,0,0,68,667,156,628435,9
2583,capillary,k@pxlEri,1,1,0,1,0,capillary,4,8,704,9,1,0,12,240,5,1154362,9
10675,memorial,mxmoriL,2,1,1,2,0,memorial,4,8,573,9,2,1,360,7007,1665,20161664,9
7339,grail,grel,16,13,3,5,11,grail,1,4,499,5,51,9,137,538,89,1122474,5
412,agitation,@J|teS|n,2,2,0,2,0,agitation,4,8,752,8,2,0,25,518,27,890368,6
3348,coarse,kors,16,12,4,5,11,coarse,1,4,414,7,85,5,69,1431,39,2768915,5
7370,grass,gr@s,13,10,3,5,8,grass,1,4,497,6,48,21,856,10708,652,12868953,5
18971,whirl,hwRl,8,5,3,4,4,whirl,1,4,414,6,15,5,89,599,42,623768,5
1901,blatant,bletNt,1,0,1,1,0,blatant,2,7,570,8,1,0,58,757,142,1013927,8
409,agile,@JL,2,2,0,2,0,agile,2,4,488,5,10,3,20,479,36,1808955,5
562,altar,cltX,5,1,4,4,1,altar,2,4,469,6,21,13,259,2233,171,2628192,5
1570,barrow,b@ro,10,9,1,7,3,barrow,2,4,337,7,77,24,61,471,11,2049454,5
15607,should,SUd,10,10,0,8,2,should,1,3,411,7,30,1,54159,198201,53707,402032013,4
7206,glee,gli,15,7,8,10,5,glee,1,3,354,5,87,12,58,765,135,524041,4
17301,thrift,TrIft,3,2,1,3,0,thrift,1,5,432,7,10,4,22,1006,143,1384574,6
3633,concession,kxnsES|n,1,0,1,0,1,concession,3,8,589,11,3,3,69,1108,215,2202890,9
6969,gambit,g@mbxt,1,0,1,0,1,gambit,2,6,427,7,1,2,19,264,42,680847,5
14188,rain,ren,38,28,10,24,14,rain,1,3,414,5,199,47,2494,15084,2069,26429782,4
15590,shock,Sak,21,20,1,17,4,shock,1,3,427,6,130,16,1468,9056,1919,14853008,4
8101,human,hyumxn,2,2,0,0,2,human,2,6,559,6,15,22,6363,70897,9504,160580309,7
18208,urban,Rb|n,5,3,2,4,1,urban,2,4,459,6,32,11,237,16732,1214,38091310,5
7098,gentle,JEntL,7,5,2,4,3,gentle,2,6,499,7,14,6,844,4558,374,6917025,7
3239,clap,kl@p,16,11,5,4,12,clap,1,4,223,5,38,17,241,574,79,1497714,5
9975,lion,lY|n,5,2,3,4,1,lion,2,4,354,5,53,24,783,3327,441,11536320,5
13206,poet,poxt,4,4,0,0,4,poet,2,4,314,5,15,19,470,4710,465,6468704,5
456,album,@lbxm,1,0,1,1,0,album,2,5,432,6,7,5,522,7854,1951,77922007,6
2619,caramel,k@rxmL,2,2,0,1,1,caramel,3,7,579,8,1,3,63,839,64,1339260,8
4948,direct,dXEkt,1,1,0,1,0,direct,2,5,425,7,7,9,1226,20386,2742,102239882,6
7272,going,goIG,1,1,0,1,0,going,2,4,356,6,22,11,108288,308524,189123,155293861,5
12203,oversize,ovXsYz,2,2,0,0,2,oversize,3,6,702,9,4,2,0,642,5,1118405,7
8930,instead,InstEd,1,1,0,0,1,instead,2,6,583,5,3,2,4043,49464,6622,56500892,5
9614,lamb,l@m,27,23,4,16,11,lamb,1,3,437,5,100,17,542,3186,321,6532527,4
1656,beaver,bivX,3,3,0,1,2,beaver,2,4,519,7,41,18,246,1197,74,8683140,5
17258,thieves,Tivz,5,3,2,4,1,thieves,1,4,475,8,23,3,464,1435,307,2201031,4
1167,assort,xsort,2,1,1,2,0,assort,2,5,455,7,3,1,0,3,1,50353,6
16228,squeeze,skwiz,2,2,0,0,2,squeeze,1,5,648,8,6,2,769,3521,467,3017492,6
4146,create,kriet,3,0,3,0,3,create,2,5,619,7,8,8,1289,32554,5415,137075022,6
2626,carbine,karbYn,1,1,0,0,1,carbine,2,6,537,7,7,6,15,92,8,446513,6
9773,left,lEft,11,8,3,7,4,left,1,4,380,5,24,14,24707,112127,19989,171759371,5
7200,glass,gl@s,7,4,3,4,3,glass,1,4,511,6,30,12,3096,24721,1598,63565118,5
12357,pantry,p@ntri,3,2,1,2,1,pantry,2,6,486,5,5,7,89,853,64,1268228,5
16053,spark,spark,5,2,3,2,3,spark,1,5,651,6,20,14,320,2163,277,4847230,6
11202,mount,mWnt,7,5,2,5,2,mount,1,4,567,6,14,8,597,7754,759,36648936,5
4513,decay,dxke,1,1,0,0,1,decay,2,4,479,6,19,7,105,1582,103,4956909,5
15525,shame,Sem,17,16,1,11,6,shame,1,3,517,6,58,16,2120,5146,972,6785654,4
15848,smack,sm@k,9,7,2,5,4,smack,1,4,515,6,26,12,485,1065,182,1453682,5
13069,pity,pIti,12,10,2,9,3,pity,2,4,335,5,51,12,1199,2361,189,2642047,5
5264,dreamed,drimd,2,1,1,0,2,dreamed,1,5,446,7,8,4,784,2823,398,1698333,5
2799,cavern,k@vXn,1,1,0,1,0,cavern,2,5,539,7,5,6,56,459,10,1364330,6
11333,myriad,mIri|d,1,1,0,1,0,myriad,3,6,401,6,3,1,28,1680,76,1848958,6
11925,oncoming,cnk^mIG,1,1,0,1,0,oncoming,3,7,488,5,1,1,22,471,51,327800,3
10095,loin,lOn,11,11,0,9,2,loin,1,3,388,5,57,20,18,332,17,543246,4
17465,tong,tcG,12,11,1,7,5,tong,1,3,457,5,49,37,116,254,48,1310252,4
17492,topping,tapIG,1,1,0,0,1,topping,2,5,379,8,21,14,45,1365,126,1431763,6
9709,laurel,lcrL,5,4,1,4,1,laurel,2,5,410,7,46,4,188,1708,58,4366332,6
10331,malign,mxlYn,1,0,1,1,0,malign,2,5,599,7,12,3,10,120,8,179108,6
17632,transport,tr@nsport,1,0,1,0,1,transport,2,9,495,10,3,2,571,4131,409,47047997,10
4084,cover,k^vX,4,4,0,1,3,cover,2,4,409,6,27,31,4808,29453,5492,94503381,5
15301,scud,sk^d,6,5,1,3,3,scud,1,4,452,5,18,6,31,767,448,248971,5
12994,piled,pYld,5,3,2,3,2,piled,1,4,377,5,25,12,76,1955,146,818173,4
3284,clerk,klRk,8,7,1,2,6,clerk,1,4,395,6,25,5,658,2869,444,11924752,5
7808,hemp,hEmp,4,2,2,1,3,hemp,1,4,419,5,22,15,17,520,50,2200098,5
6537,flicker,flIkX,5,3,2,2,3,flicker,2,5,472,8,18,8,35,805,34,814398,6
16332,stench,stEnC,1,1,0,1,0,stench,1,5,569,6,10,3,113,742,44,508722,5
4016,cosmic,kazmIk,1,0,1,1,0,cosmic,2,6,512,5,2,4,184,2370,99,4195062,6
9320,jest,JEst,18,16,2,15,3,jest,1,4,452,5,53,25,68,266,22,866519,5
11306,muster,m^stX,7,4,3,4,3,muster,2,5,540,7,32,21,76,1007,115,952213,6
2997,check,CEk,15,14,1,12,3,check,1,3,367,6,65,9,14228,26608,6771,244508125,4
125,acclaim,xklem,2,1,1,2,0,acclaim,2,5,540,8,5,1,22,561,66,1784066,6
6416,filter,fIltX,3,2,1,2,1,filter,2,5,581,7,14,9,162,3128,201,54112798,6
8335,immobilize,ImobxlYz,1,0,1,1,0,immobilize,4,8,661,11,3,1,7,92,10,78080,9
17579,trait,tret,19,15,4,9,10,trait,1,4,357,6,43,9,55,2261,92,1705417,5
2584,capital,k@p|tL,1,1,0,0,1,capital,3,7,486,8,3,5,648,24095,5425,68993136,8
4095,cowlick,kWlIk,3,2,1,2,1,cowlick,2,5,427,8,8,2,4,55,0,13785,6
6830,frontal,fr^ntL,1,0,1,0,1,frontal,2,7,446,7,1,0,96,996,113,1692472,6
6018,exhume,Igzum,2,2,0,0,2,exhume,2,7,601,7,2,2,24,66,30,32546,8
6903,fury,fyUri,2,2,0,0,2,fury,2,5,382,4,9,18,195,1748,188,3497938,6
6189,fallout,fclWt,2,0,2,1,1,fallout,2,5,619,8,4,2,111,1308,564,1293318,6
2538,canned,k@nd,16,10,6,8,8,canned,1,4,402,7,57,14,214,1814,121,2721212,5
8002,hooey,hui,8,6,2,2,6,hooey,2,3,420,4,85,12,43,52,12,53374,3
9612,laity,lexti,1,1,0,1,0,laity,3,5,428,5,2,4,0,427,23,375609,4
9851,level,lEvL,6,6,0,3,3,level,2,5,341,6,21,14,2633,64540,8543,202574338,6
6860,full,fUl,15,14,1,13,2,full,1,3,659,5,48,23,8512,61522,9168,309938387,4
11753,nursery,nRsXi,1,1,0,1,0,nursery,3,5,557,8,3,1,207,2069,149,8938613,6
13637,primer,prImX,2,1,1,0,2,primer,2,5,426,7,19,9,30,816,37,4864138,6
14669,resin,rEzN,5,5,0,4,1,resin,2,5,478,6,17,11,30,615,11,4967033,6
6305,feel,fil,30,27,3,24,6,feel,1,3,426,5,142,25,31989,85845,27081,91932639,4
9689,latent,letNt,1,0,1,1,0,latent,2,6,480,6,4,3,39,1042,32,1857217,6
3880,contumely,kxntumxli,1,1,0,0,1,contumely,3,9,778,6,0,0,1,12,0,14562,5
17609,transformer,tr@nsformX,1,0,1,0,1,transformer,3,10,718,12,5,2,27,197,21,2743177,11
6351,fetch,fEC,9,8,1,4,5,fetch,1,3,488,6,38,8,559,1278,55,2898830,4
4486,dearth,dRT,10,9,1,7,3,dearth,1,3,459,5,33,4,5,516,15,372449,4
17534,toupee,tupe,1,1,0,1,0,toupee,2,4,589,5,9,0,64,94,14,101483,4
10021,litter,lItX,13,10,3,8,5,litter,2,4,371,7,53,22,200,1336,105,3706977,5
3169,cinch,sInC,8,6,2,5,3,cinch,1,4,529,6,26,13,182,354,31,427775,5
4778,destine,dEst|n,1,0,1,0,1,destine,2,6,438,8,1,5,1,6,0,35051,5
4781,destitution,dEst|tuS|n,1,1,0,1,0,destitution,4,10,768,9,0,1,2,94,6,109081,8
9747,leap,lip,30,27,3,15,15,leap,1,3,344,5,108,22,340,3316,461,4774012,4
14392,rectal,rEktL,4,4,0,2,2,rectal,2,6,440,6,6,2,46,228,36,1676607,7
15714,sing,sIG,22,17,5,14,8,sing,1,3,479,5,81,44,4977,8057,2215,11117648,4
7531,gym,JIm,14,13,1,8,6,gym,1,3,393,4,63,11,927,4629,561,9874822,4
14154,radar,redar,1,1,0,0,1,radar,2,5,430,6,5,9,1811,3359,707,14985698,6
17652,travel,tr@vL,3,2,1,2,1,travel,2,6,567,7,12,8,1702,20340,2914,287722710,7
13714,professional,prxfES|nL,1,0,1,0,1,professional,4,10,649,13,4,3,1646,25972,2469,123169695,11
14947,roulette,rulEt,1,1,0,1,0,roulette,2,5,493,9,14,5,126,321,59,11361112,6
17261,thin,TIn,16,14,2,13,3,thin,1,3,393,5,83,20,1029,14572,1182,16008458,4
10544,math,m@T,15,15,0,8,7,math,1,3,492,5,53,30,836,7192,1162,28636716,4
136,accord,xkord,4,3,1,4,0,accord,2,5,434,7,12,5,83,2285,284,5034197,6
16245,stack,st@k,16,13,3,6,10,stack,1,4,507,6,59,22,311,3149,282,11091123,5
15709,sin,sIn,31,25,6,21,10,sin,1,3,390,4,125,52,813,4503,505,17951039,4
18407,venom,vEnM,4,4,0,1,3,venom,2,5,516,6,7,1,119,559,79,1892608,6
2689,cartilage,kartLIJ,2,1,1,0,2,cartilage,3,8,549,6,1,0,37,678,61,1325533,7
8916,inspect,InspEkt,2,1,1,1,1,inspect,2,7,538,8,4,2,130,1217,171,3286565,8
16866,symptomatic,sImtxm@tIk,1,1,0,1,0,symptomatic,4,11,942,8,1,1,29,551,54,859065,8
1690,beg,bEg,14,13,1,8,6,beg,1,3,319,4,71,29,2600,1751,343,2619968,4
2725,castor,k@stX,6,4,2,5,1,castor,2,5,478,7,50,9,67,831,186,971100,6
6253,fatal,fetL,7,5,2,3,4,fatal,2,5,360,6,9,7,362,3232,719,6786528,6
14690,response,rIspans,1,1,0,0,1,response,2,7,602,9,3,4,821,31928,5346,84066971,8
11505,nest,nEst,15,13,2,11,4,nest,1,4,380,5,52,33,566,3389,255,5602029,5
7010,garnish,garnIS,2,2,0,2,0,garnish,2,6,495,8,7,5,27,1979,39,735054,7
7143,ghetto,gEto,1,0,1,0,1,ghetto,2,4,363,7,19,1,282,961,177,3551951,5
15795,sled,slEd,10,8,2,7,3,sled,1,4,476,5,20,17,149,790,54,1135340,5
2353,burnt,bRnt,5,4,1,2,3,burnt,1,4,373,5,51,10,488,1250,132,3221640,5
3289,client,klY|nt,1,1,0,1,0,client,2,6,425,7,8,3,2715,10729,1557,69195184,7
5263,dream,drim,7,3,4,3,4,dream,1,4,376,6,24,10,6798,18286,3790,33535334,5
18876,web,wEb,10,8,2,3,7,web,1,3,322,4,38,14,470,22463,4762,619583946,4
16080,speck,spEk,8,7,1,1,7,speck,1,4,523,6,30,11,95,590,52,758600,5
6318,felony,fEl|ni,1,0,1,0,1,felony,3,6,512,6,10,2,285,1502,604,2828329,7
10800,middling,mIdlIG,1,0,1,1,0,middling,2,6,450,6,8,8,7,204,11,130475,5
15573,shin,SIn,20,19,1,16,4,shin,1,3,394,5,108,26,157,572,37,2289926,4
18347,various,vErixs,2,0,2,0,2,various,3,6,728,8,3,0,456,29497,3208,91156590,7
7124,germination,JRmxneS|n,2,2,0,2,0,germination,4,9,641,9,1,1,1,203,0,758724,7
10513,massage,mxsaZ,1,1,0,1,0,massage,2,5,613,8,3,7,565,2074,170,17684555,6
7564,had,h@d,31,28,3,18,13,had,1,3,369,4,91,48,85472,803646,146951,480246305,4
12660,penis,pin|s,3,3,0,3,0,penis,2,5,424,6,2,8,684,1282,142,18478409,6
4105,crab,kr@b,10,8,2,3,7,crab,1,4,382,5,36,17,352,1915,121,3824989,5
17303,thrive,TrYv,5,4,1,3,2,thrive,1,4,427,7,7,4,89,1795,190,1823247,5
11396,natal,netL,4,4,0,2,2,natal,2,5,569,6,14,11,5,652,84,3010028,5
10129,lotion,loS|n,5,3,2,5,0,lotion,2,5,475,7,29,5,166,814,58,4349478,6
3226,claim,klem,8,4,4,5,3,claim,1,4,427,6,33,6,1295,16548,3027,40085342,5
1051,aromatic,@rxm@tIk,3,2,1,3,0,aromatic,4,8,848,7,3,0,14,520,22,1817946,5
11299,Muslim,m^zlxm,1,1,0,1,0,muslim,2,6,596,7,4,3,121,10639,2362,11454192,7
7176,girth,gRT,10,9,1,7,3,girth,1,3,372,5,33,8,22,268,8,492919,3
11884,office,cfxs,3,2,1,1,2,office,2,4,613,7,9,4,10399,62461,12963,266797332,5
14674,resolve,rIzalv,2,2,0,2,0,resolve,2,6,611,8,3,3,247,5310,1174,10442928,7
12739,period,pIri|d,1,1,0,1,0,period,3,6,403,7,3,3,1417,34936,6177,103907438,7
16818,swift,swIft,1,0,1,1,0,swift,1,5,591,6,10,4,197,2677,405,5854122,6
7224,gloom,glum,9,7,2,6,3,gloom,1,4,373,6,21,6,59,1069,105,878238,5
10034,liver,lIvX,10,6,4,6,4,liver,2,4,459,6,31,29,729,3241,527,12139938,5
5215,dour,dWr,13,10,3,6,7,dour,2,3,350,5,63,24,8,308,17,191669,4
15078,saint,sent,6,4,2,4,2,saint,1,4,488,6,22,10,914,6076,770,38937465,5
10728,mesh,mES,6,6,0,2,4,mesh,1,3,419,5,54,15,35,1673,71,23651613,4
5277,dribble,drIbL,3,2,1,1,2,dribble,2,6,316,8,14,8,68,293,12,328197,7
9912,lighter,lYtX,14,12,2,8,6,lighter,2,4,401,8,57,11,457,3849,419,6287712,5
6536,flick,flIk,14,12,2,3,11,flick,1,4,500,6,49,18,257,1032,105,2226500,5
19026,width,wIdT,2,1,1,0,2,width,1,4,325,6,6,6,35,2029,39,25183551,5
1950,blotch,blaC,5,4,1,1,4,blotch,1,5,438,7,5,5,10,51,1,89691,6
17208,them,DEm,5,4,1,3,2,them,1,3,484,5,34,20,90720,419247,114124,403011598,4
15493,several,sEvXL,1,0,1,0,1,several,2,6,506,8,3,1,1978,76018,10507,107590145,7
10579,may,me,32,23,9,15,17,may,1,2,385,4,161,60,26080,232650,41170,827841285,3
2986,chatter,C@tX,13,10,3,9,4,chatter,2,4,394,8,24,9,238,1131,127,1773397,5
6071,export,Eksport,1,0,1,0,1,export,2,7,635,7,2,4,65,4033,514,24764718,8
16321,steam,stim,8,5,3,3,5,steam,1,4,484,6,39,13,686,4303,462,11148945,5
17328,thus,D^s,6,5,1,6,0,thus,1,3,555,5,35,15,628,35070,766,59454918,4
17006,taste,test,9,8,1,7,2,taste,1,4,375,6,34,14,2617,14001,1677,17312480,5
90,abstract,@bstr@kt,1,0,1,0,1,abstract,2,8,623,9,1,1,111,4713,221,55954667,9
11314,mute,myut,6,4,2,3,3,mute,1,4,310,5,17,22,127,922,79,2352445,5
18998,whittle,hwItL,2,1,1,0,2,whittle,2,5,258,8,42,5,21,363,125,466046,6
14686,respite,rEspxt,1,1,0,1,0,respite,2,6,456,6,1,1,24,704,38,1318533,5
97,abut,xb^t,5,4,1,1,4,abut,2,4,361,5,13,7,6,85,20,190877,5
14258,rating,retIG,3,2,1,3,0,rating,2,5,392,7,28,16,112,8140,1039,207859211,6
7422,grin,grIn,9,9,0,0,9,grin,1,4,371,5,64,25,138,3231,83,2073169,5
2085,bother,baDX,3,3,0,2,1,bother,2,4,371,7,19,14,3436,4885,1058,5113916,5
5100,ditty,dIti,10,10,0,6,4,ditty,2,4,298,5,46,12,40,101,10,289139,5
17528,totem,totM,2,1,1,0,2,totem,2,5,347,6,5,5,44,336,29,955513,6
14292,reach,riC,20,17,3,10,10,reach,1,3,513,6,102,18,2903,24496,4000,35690985,4
13715,professor,prxfEsX,1,0,1,0,1,professor,3,7,597,10,5,2,3548,26379,5576,40572636,8
14490,regular,rEgyUlX,1,0,1,1,0,regular,3,7,668,8,1,2,1727,17829,2752,62312043,4
17024,taxi,t@ksi,2,0,2,0,2,taxi,2,5,639,5,17,7,1318,2320,287,7293662,6
785,ante,@nti,5,1,4,2,3,ante,2,4,417,5,34,20,111,757,140,1994218,5
15877,smuggle,sm^gL,2,1,1,1,1,smuggle,2,6,619,8,3,4,102,291,84,214976,7
12338,panelist,p@nLxst,1,0,1,1,0,panelist,3,8,598,9,2,2,1,251,150,453625,7
19103,wither,wIDX,9,7,2,6,3,wither,2,4,348,7,29,19,47,258,29,340249,5
12242,pacific,pxsIfIk,1,0,1,1,0,pacific,3,7,584,8,3,2,493,10420,1284,54260271,8
14838,ring,rIG,23,21,2,11,12,ring,1,3,509,5,82,39,4730,12222,1864,54346434,4
15520,shall,S@l,13,10,3,6,7,shall,1,3,559,6,68,17,9441,8999,1299,191970203,4
6771,frappe,fr@p,3,2,1,3,0,frappe,1,4,589,6,15,2,5,11,3,66821,5
8324,immense,ImEns,1,1,0,0,1,immense,2,5,476,8,0,1,82,2382,271,2354605,6
17561,tract,tr@kt,5,1,4,3,2,tract,1,5,465,6,24,12,73,1741,69,5897046,6
8640,Indian,Indixn,1,1,0,0,1,indian,3,6,363,7,7,3,175,19216,1291,54649019,7
11681,notable,notxbL,2,1,1,2,0,notable,3,7,589,8,2,3,31,3072,145,5045328,8
543,aloft,xlcft,1,0,1,1,0,aloft,2,5,605,4,1,2,37,647,25,497342,4
10610,meat,mit,25,22,3,18,7,meat,1,3,371,5,87,24,2226,12116,1342,17654214,4
7062,gender,JEndX,3,3,0,3,0,gender,2,5,415,7,18,21,143,16727,851,29249698,6
10720,merit,mEr|t,1,1,0,1,0,merit,2,5,455,6,34,7,173,2570,288,6451424,6
4681,denim,dEnM,4,3,1,1,3,denim,2,5,386,5,11,3,33,965,72,4738242,5
14536,relish,rElIS,2,2,0,1,1,relish,2,5,420,7,8,3,96,1035,80,903789,6
16104,sphere,sfIr,6,4,2,6,0,sphere,1,4,478,7,16,2,126,2562,131,5523301,5
11440,neat,nit,25,23,2,19,6,neat,1,3,499,5,103,21,635,2943,462,4643885,4
16430,straddle,str@dL,2,1,1,1,1,straddle,2,7,589,9,5,3,26,244,29,289396,8
12485,partridge,partrIJ,1,1,0,1,0,partridge,2,7,629,10,2,4,173,245,11,1095499,6
2707,casing,kesIG,1,1,0,1,0,casing,2,5,509,7,16,14,96,518,103,1563984,6
14715,retch,rEC,13,11,2,7,6,retch,1,3,401,4,64,9,15,112,1,38897,4
11307,musty,m^sti,6,5,1,4,2,musty,2,5,678,5,15,12,25,406,12,240811,6
13816,prosper,praspX,1,0,1,0,1,prosper,2,6,589,8,5,7,56,679,90,1155265,7
9239,isolation,YsxleS|n,1,1,0,1,0,isolation,4,8,830,10,1,0,158,4179,444,6968755,9
11270,mundane,m^nden,1,0,1,0,1,mundane,2,6,552,6,5,0,41,1126,95,1132496,6
17694,tribe,trYb,9,7,2,1,8,tribe,1,4,503,6,21,11,325,3743,476,7895214,5
19168,world,wRld,5,4,1,4,1,world,1,4,460,6,35,5,23216,193305,43143,431966449,5
4117,cram,kr@m,16,13,3,6,10,cram,1,4,619,5,74,28,77,427,39,917616,5
7216,glitter,glItX,4,1,3,2,2,glitter,2,5,419,8,10,6,104,676,65,2788928,6
4808,deuce,dus,20,17,3,11,9,deuce,1,3,539,4,80,3,146,136,17,970434,4
1113,ashen,@S|n,5,1,4,5,0,ashen,2,4,530,6,24,8,9,257,6,187890,5
4932,dinner,dInX,13,10,3,4,9,dinner,2,4,297,7,52,15,10336,20999,2657,25976630,5
12982,pig,pIg,19,18,1,10,9,pig,1,3,509,4,58,33,1996,2828,431,7033063,4
17480,tooth,tuT,14,10,4,5,9,tooth,1,3,429,6,47,9,692,2027,278,5551049,4
4552,decorator,dEkXetX,1,0,1,0,1,decorator,4,7,536,10,2,1,107,322,19,845861,8
14343,reception,rIsEpS|n,2,1,1,1,1,reception,3,8,583,10,2,2,568,3813,350,13317222,9
3292,climactic,klYm@ktIk,1,0,1,0,1,climactic,3,9,622,7,1,1,11,266,21,239178,7
6743,founder,fWndX,2,0,2,1,1,founder,2,5,536,8,14,10,108,6931,1187,11180601,6
7508,gum,g^m,16,15,1,12,4,gum,1,3,335,4,61,27,683,1876,218,4504757,4
6522,fleck,flEk,11,9,2,1,10,fleck,1,4,469,6,31,11,7,147,4,454261,5
1630,bead,bid,26,21,5,17,9,bead,1,3,459,5,114,26,57,761,12,4917836,4
10617,medal,mEdL,7,7,0,5,2,medal,2,5,275,6,36,11,590,3518,590,7747036,6
19078,wink,wIGk,14,10,4,10,4,wink,1,4,392,5,58,33,180,1037,117,2195002,5
6411,filling,fIlIG,6,5,1,6,0,filling,2,5,470,8,43,14,494,6003,632,9103402,6
9710,lava,lavx,3,2,1,2,1,lava,2,4,372,5,23,23,176,1244,98,2472631,4
9792,legibility,lEJ|bIl|ti,1,0,1,1,0,legibility,5,10,683,6,0,0,0,110,0,184676,6
2184,brick,brIk,13,10,3,4,9,brick,1,4,334,6,74,22,519,4497,295,8095470,5
11150,moron,moran,2,1,1,1,1,moron,2,5,454,6,19,22,754,312,44,1017782,6
18337,variant,vErixnt,1,1,0,0,1,variant,3,7,588,8,3,3,9,827,21,4444856,8
15644,shuttle,S^tL,5,4,1,1,4,shuttle,2,5,360,8,14,4,282,4531,1231,8441019,6
15339,secretarial,sEkrxtEriL,1,0,1,0,1,secretarial,5,11,764,11,0,1,16,167,13,2095099,10
14742,revel,rEvL,9,7,2,5,4,revel,2,5,327,6,24,17,41,330,20,546277,6
9776,leg,lEg,15,14,1,7,8,leg,1,3,499,4,62,36,2882,11679,1348,17360515,4
6792,french,frEnC,4,3,1,3,1,french,1,5,529,7,11,5,3541,24999,3381,81398445,6
16799,swat,swat,16,13,3,7,9,swat,1,4,526,5,30,17,196,882,208,1476384,5
6777,fraught,frct,11,8,3,3,8,fraught,1,4,393,5,21,2,35,751,79,459290,4
13470,precede,prisid,1,1,0,1,0,precede,2,6,485,8,7,6,14,307,22,677234,7
2324,bunt,b^nt,12,8,4,8,4,bunt,1,4,326,5,59,25,41,140,5,374480,5
4183,crib,krIb,3,2,1,1,2,crib,1,4,262,5,34,9,316,965,118,3849386,5
6530,flew,flu,14,10,4,6,8,flew,1,3,425,5,49,13,785,5579,1100,3529715,4
12437,parkway,parkwe,1,0,1,0,1,parkway,2,6,474,5,2,0,53,1489,48,4318674,5
6939,gaiety,gexti,1,1,0,1,0,gaiety,3,5,502,5,2,0,23,92,3,150778,3
6200,famed,femd,2,0,2,0,2,famed,1,4,522,5,17,19,42,1371,185,1326101,4
11152,morose,mXos,1,1,0,0,1,morose,2,4,668,6,9,4,18,170,9,133059,4
6538,flier,flYX,6,4,2,2,4,flier,2,4,482,6,34,10,109,533,82,542812,5
7211,glimmer,glImX,2,2,0,1,1,glimmer,2,5,471,8,12,5,40,575,93,658110,6
12993,pile,pYl,28,25,3,20,8,pile,1,3,398,5,99,28,672,5040,411,4828878,4
4884,diet,dYxt,1,1,0,1,0,diet,2,4,365,5,30,20,784,9615,1529,44677719,5
11385,narration,nEreS|n,1,0,1,1,0,narration,3,7,644,8,1,0,14,896,20,918263,5
13060,pith,pIT,14,13,1,4,10,pith,1,3,309,5,43,20,10,160,3,189736,4
15682,silicone,sIlxkon,1,1,0,0,1,silicone,3,7,465,9,2,2,40,828,227,3835328,8
2118,box,baks,5,3,2,4,1,box,1,4,429,4,83,32,4577,26697,2764,169242820,5
3827,content,kxntEnt,2,2,0,1,1,content,2,7,545,8,5,11,389,17597,1047,188885464,8
10483,marry,m@ri,11,10,1,10,1,marry,2,4,396,6,131,30,5322,5543,1022,4388137,5
4109,cracker,kr@kX,2,1,1,0,2,cracker,2,5,428,8,26,8,294,609,70,2104527,6
17517,tortoise,tort|s,1,1,0,1,0,tortoise,2,6,529,9,4,2,57,423,21,1133746,7
14699,restoration,rEstXeS|n,1,1,0,1,0,restoration,4,9,928,12,2,1,48,3062,273,12203006,10
17666,treat,trit,10,7,3,3,7,treat,1,4,293,6,38,8,2646,10298,2293,19442899,5
7185,glacier,gleSX,2,2,0,0,2,glacier,2,5,461,8,5,2,38,1438,90,3021561,6
9101,introduce,Intrxdus,1,1,0,0,1,introduce,3,8,768,10,2,4,1771,4899,1193,13104630,9
9465,kept,kEpt,3,2,1,2,1,kept,1,4,367,4,16,5,4559,33434,5824,27838368,4
14615,repress,rIprEs,3,3,0,3,0,repress,2,6,638,8,4,6,19,226,35,281218,7
14240,rare,rEr,22,20,2,17,5,rare,1,3,352,5,122,30,1087,12194,1902,29730256,4
6502,flank,fl@Gk,8,6,2,6,2,flank,1,5,520,6,20,13,236,955,58,910609,6
1221,atom,@tM,5,4,1,3,2,atom,2,4,351,5,14,7,140,1042,69,32778984,5
2977,chaste,Cest,9,8,1,6,3,chaste,1,4,513,7,20,5,30,238,13,289676,4
17153,terrace,tErxs,1,1,0,1,0,terrace,2,5,491,8,32,4,173,1442,32,7531575,6
1820,bilge,bIlJ,8,7,1,1,7,bilge,1,4,384,6,25,7,56,145,4,412304,4
4846,dial,dYl,26,24,2,18,8,dial,1,3,330,5,108,19,452,2454,323,16718282,4
6565,florid,flcrxd,1,1,0,0,1,florid,2,6,544,7,6,9,4,157,2,124612,7
2533,candy,k@ndi,10,6,4,3,7,candy,2,5,494,6,43,23,1825,5139,929,13780648,6
7161,gill,gIl,28,24,4,23,5,gill,1,3,275,5,99,34,87,1272,78,3673631,4
4416,dame,dem,23,21,2,17,6,dame,1,3,549,5,75,36,702,2968,315,5936558,4
10577,maximal,m@ksxmL,1,0,1,0,1,maximal,3,8,688,7,2,1,2,420,4,2067922,8
11031,mole,mol,33,28,5,22,11,mole,1,3,355,5,139,42,411,891,108,2257108,4
10666,melt,mElt,15,13,2,11,4,melt,1,4,401,5,51,23,373,2249,240,3154944,5
12111,outfight,WtfYt,2,2,0,1,1,outfight,2,5,505,6,2,1,3,12,2,4468,4
15269,scourge,skRJ,5,4,1,2,3,scourge,1,4,599,8,6,2,67,401,41,605240,5
6542,flinch,flInC,5,2,3,3,2,flinch,1,5,482,7,10,3,58,440,37,161064,6
15697,simmer,sImX,5,3,2,3,2,simmer,2,4,569,7,47,21,87,2578,56,1059011,5
17444,token,tok|n,3,2,1,3,0,token,2,5,420,6,18,9,205,1274,213,5673161,6
5233,dozen,d^zN,2,1,1,1,1,dozen,2,5,480,6,11,10,1231,14001,1913,9776227,6
4675,den,dEn,33,29,4,22,11,den,1,3,332,4,127,57,312,1924,115,13652148,4
7210,glide,glYd,5,4,1,3,2,glide,1,4,396,6,22,7,120,812,64,1732328,5
15681,silicon,sIlxk|n,1,1,0,0,1,silicon,3,7,562,8,6,1,87,2692,262,9261010,7
17398,tipsy,tIpsi,1,1,0,1,0,tipsy,2,5,410,5,7,3,33,203,18,280136,5
17255,thief,Tif,8,8,0,6,2,thief,1,3,420,6,37,6,1238,1677,348,2971021,4
9991,lisle,lYl,24,22,2,14,10,lisle,2,4,411,4,24,10,8,122,0,644347,4
12354,panther,p@nTX,3,2,1,1,2,panther,2,5,488,8,8,3,131,694,108,3557196,6
2650,cargo,kargo,2,1,1,2,0,cargo,2,5,421,6,25,13,459,3132,407,9748668,6
17163,terror,tErX,5,2,3,1,4,terror,2,4,503,7,38,2,459,7598,3064,11981945,5
16489,striving,strYvIG,1,1,0,0,1,striving,2,7,678,9,3,3,24,1119,91,2302058,8
14971,rudder,r^dX,4,4,0,2,2,rudder,2,4,413,7,32,7,198,291,27,757465,5
5107,dive,dYv,17,14,3,9,8,dive,1,3,494,5,54,28,654,2367,302,8258687,4
5289,drizzle,drIzL,3,3,0,1,2,drizzle,2,6,380,7,6,2,22,1279,23,640385,7
14748,reverence,rEvXxns,1,0,1,1,0,reverence,3,7,649,8,5,2,68,824,54,899445,7
12600,peck,pEk,20,19,1,15,5,peck,1,3,321,5,101,28,180,931,229,1961752,4
5145,doe,do,29,18,11,14,15,doe,1,2,409,4,165,57,221,2024,398,7947836,3
17533,tough,t^f,17,15,2,10,7,tough,1,3,355,6,43,15,4616,21755,9246,13560922,4
19332,zoom,zum,8,7,1,7,1,zoom,1,3,529,5,30,8,181,1030,130,31376977,4
15423,sensory,sEnsXi,2,1,1,0,2,sensory,3,6,595,7,8,2,55,1606,57,3394914,6
7755,hedge,hEJ,11,10,1,5,6,hedge,1,3,394,6,50,11,79,2028,289,4041805,4
18023,undershirt,^ndXSRt,1,1,0,0,1,undershirt,3,7,620,11,2,1,15,157,4,85144,8
11610,noise,nOz,4,3,1,3,1,noise,1,3,432,6,50,12,1779,10040,1100,25173489,4
19182,worth,wRT,13,12,1,7,6,worth,1,3,433,6,40,14,5569,25581,5236,48076607,4
17299,threw,Tru,10,8,2,7,3,threw,1,3,340,5,34,5,2082,8913,1305,4411069,4
16316,stay,ste,17,7,10,4,13,stay,1,3,539,5,45,24,26298,43300,14104,80702745,4
1615,battery,b@tXi,1,0,1,0,1,battery,3,5,429,8,12,5,633,5274,475,51450549,6
2996,cheat,Cit,17,16,1,13,4,cheat,1,3,318,6,51,13,901,1411,365,9904417,4
3306,cloak,klok,13,12,1,2,11,cloak,1,4,459,6,39,2,153,1190,55,1450297,5
16518,stud,st^d,12,11,1,2,10,stud,1,4,399,5,43,11,354,715,52,9482020,5
9256,item,YtM,2,2,0,2,0,item,2,4,407,5,10,7,628,9217,945,296541110,5
15555,shelf,SElf,6,3,3,3,3,shelf,1,4,426,5,22,7,355,3801,293,11287023,5
264,admiration,@dmXeS|n,1,0,1,1,0,admiration,4,8,848,11,2,1,107,1607,197,1261297,9
9989,liquor,lIkX,14,11,3,10,4,liquor,2,4,329,7,49,2,882,2352,317,4727755,5
6606,foam,fom,16,13,3,10,6,foam,1,3,388,5,46,9,179,2377,206,8921687,4
7592,hallelujah,h@lxluyx,1,0,1,1,0,hallelujah,4,8,678,6,0,0,476,265,67,527297,5
16285,staple,stepL,3,3,0,2,1,staple,2,6,497,7,9,9,57,1298,106,1893759,7
14900,roller,rolX,9,8,1,6,3,roller,2,4,401,7,93,22,293,2034,382,7835563,5
9382,joy,JO,9,8,1,4,5,joy,1,2,287,4,63,30,1456,8312,1757,16324106,3
4383,cyst,sIst,10,7,3,6,4,cyst,1,4,419,5,42,5,22,339,10,850857,5
11840,occasional,xkeZ|nL,1,0,1,0,1,occasional,4,8,778,11,1,0,199,5128,269,6424555,9
17796,trunk,tr^Gk,3,2,1,2,1,trunk,1,5,489,6,11,8,1010,3929,350,11020361,6
9414,jungle,J^GgL,3,2,1,2,1,jungle,2,6,398,7,7,6,1151,3048,406,7152235,7
11359,nail,nel,26,23,3,22,4,nail,1,3,356,5,116,28,951,3102,503,9052835,4
939,approve,xpruv,2,0,2,1,1,approve,2,5,560,8,4,2,580,2915,864,9415563,6
2134,braille,brel,14,11,3,5,9,braille,1,4,325,8,45,1,28,2674,32,1741143,5
10994,mode,mod,24,20,4,15,9,mode,1,3,469,5,76,29,263,5915,434,67328532,4
1222,atomic,xtamIk,1,0,1,0,1,atomic,3,6,698,6,3,0,249,2676,410,9959017,4
3849,contract,kantr@kt,3,1,2,0,3,contract,2,8,537,9,6,5,1650,13536,1835,66898362,9
2424,cafe,k@fe,2,1,1,0,2,cafe,2,4,559,5,10,16,258,3462,438,16443526,4
1764,beseech,bIsiC,1,1,0,0,1,beseech,2,5,564,8,1,0,79,41,2,307046,6
10586,mayor,meX,12,10,2,2,10,mayor,2,3,464,6,108,9,1595,14663,5657,15031138,4
16154,splurge,splRJ,1,0,1,1,0,splurge,1,5,547,8,2,2,19,408,59,208250,6
8598,incubator,IGkyubetX,1,0,1,0,1,incubator,4,9,585,10,0,1,51,292,52,1166449,5
15809,slid,slId,9,8,1,2,7,slid,1,4,483,5,23,12,94,3977,81,1394827,4
3338,clutch,kl^C,4,4,0,1,3,clutch,1,4,688,7,18,1,127,1413,95,4249235,5
3570,compete,kxmpit,1,0,1,0,1,compete,2,6,408,8,2,5,432,6385,1208,9246854,7
1567,barrier,b@riX,3,3,0,3,0,barrier,3,5,531,8,33,13,173,3785,504,8353617,6
16833,swoop,swup,10,9,1,6,4,swoop,1,4,385,6,18,8,78,396,53,467481,5
5661,end,End,13,3,10,10,3,end,1,3,425,4,54,27,13559,109189,29392,220830910,4
7656,hardy,hardi,5,3,2,1,4,hardy,2,5,399,6,24,11,188,2674,240,4748962,6
5959,exceed,Iksid,1,1,0,1,0,exceed,2,5,505,7,2,1,64,2126,166,13137396,6
18810,warp,worp,7,6,1,1,6,warp,1,4,387,5,28,23,280,648,44,2403782,5
8134,hunt,h^nt,10,8,2,6,4,hunt,1,4,498,5,35,25,1319,8760,1622,13754315,5
14608,report,rIport,4,4,0,3,1,report,2,6,536,7,7,7,5508,49547,14031,286243318,7
1319,auto,cto,4,2,2,2,2,auto,2,3,319,5,16,6,391,6883,1551,94703300,4
19135,wombat,wamb@t,1,1,0,1,0,wombat,2,6,629,7,3,4,15,86,0,452744,7
16189,spring,sprIG,5,4,1,2,3,spring,2,5,503,7,12,15,1597,25633,2229,64816752,6
17108,tenant,tEn|nt,3,1,2,1,2,tenant,2,6,412,7,5,2,155,1422,88,6841635,7
14979,rug,r^g,22,20,2,15,7,rug,1,3,329,4,63,34,531,1956,268,6760586,4
4122,crank,kr@Gk,8,5,3,6,2,crank,1,5,389,6,27,13,272,1104,114,2185694,6
14914,roost,rust,7,5,2,5,2,roost,1,4,484,6,30,10,45,471,45,608008,5
7744,heavy,hEvi,3,3,0,2,1,heavy,2,4,390,6,32,7,2412,23474,3040,37669171,5
9929,limb,lIm,20,17,3,11,9,limb,1,3,333,5,87,14,238,2211,237,2360178,4
11391,nasal,nezL,5,5,0,3,2,nasal,2,5,520,6,14,10,106,1727,64,2538214,6
15740,sixty,sIksti,1,0,1,0,1,sixty,2,6,566,6,6,1,277,4988,936,4851534,7
16829,switch,swIC,11,10,1,5,6,switch,1,4,475,7,21,6,1434,6924,979,45341217,5
5391,dwindle,dwIndL,1,1,0,1,0,dwindle,2,7,364,8,8,4,5,202,28,134568,8
10132,loud,lWd,12,10,2,9,3,loud,1,3,449,5,57,14,2031,8470,1154,8655110,4
18250,utility,yUtIl|ti,1,0,1,1,0,utility,4,8,553,8,4,1,114,5263,372,28301196,9
2495,camel,k@mL,8,7,1,1,7,camel,2,5,404,6,56,11,256,1167,123,11006144,6
15847,sly,slY,17,11,6,7,10,sly,1,3,599,4,41,15,136,997,89,1238712,4
16370,still,stIl,17,14,3,5,12,still,1,4,549,6,49,18,40225,195162,47989,190450277,5
4024,costume,kastum,1,0,1,0,1,costume,2,6,525,8,4,4,721,2430,309,10751871,7
2102,bourbon,bRb|n,4,3,1,4,0,bourbon,2,5,326,8,25,1,319,1084,126,1477640,6
2732,cat,k@t,35,30,5,21,14,cat,1,3,298,4,117,54,3383,10074,1207,46849873,4
7203,gleam,glim,6,4,2,1,5,gleam,1,4,539,6,15,6,50,555,16,364549,5
14751,reverse,rIvRs,3,2,1,1,2,reverse,2,5,555,8,11,9,560,5632,877,19036324,6
18591,virgin,vRJ|n,3,3,0,3,0,virgin,2,5,503,7,9,4,961,4340,436,24410758,6
6644,for,for,33,23,10,20,13,for,1,3,449,4,147,40,351650,2199819,451690,5933321709,4
232,addle,@dL,8,5,3,5,3,addle,2,4,529,6,34,6,8,24,0,21363,5
14936,rotor,rotX,6,4,2,2,4,rotor,2,4,339,6,61,3,24,510,68,2003039,5
10660,melodic,mxladIk,1,1,0,1,0,melodic,3,7,549,8,1,1,10,542,27,1549236,8
13828,protect,prxtEkt,1,0,1,0,1,protect,2,6,566,8,2,5,3583,20461,5342,37459350,7
16800,swath,swaT,7,7,0,0,7,swath,1,4,518,6,10,6,11,620,44,438339,4
2819,celery,sElXi,2,1,1,1,1,celery,3,5,569,6,17,0,95,1682,85,1256388,5
15077,sailor,selX,8,7,1,4,4,sailor,2,4,569,7,81,9,632,1297,195,4759495,5
7801,hemline,hEmlYn,1,1,0,1,0,hemline,2,6,459,8,5,2,10,66,8,70689,7
13961,punk,p^Gk,12,9,3,11,1,punk,1,4,314,5,29,21,1121,1286,186,12300718,5
11115,moody,mudi,3,2,1,1,2,moody,2,4,445,6,45,14,115,1533,235,3776452,5
4701,depart,dxpart,1,0,1,1,0,depart,2,6,399,7,2,4,109,854,77,4975122,7
7923,his,hIz,17,15,2,8,9,his,1,3,401,4,76,31,108364,1082290,162842,660184817,4
7393,grease,gris,14,12,2,2,12,grease,1,4,417,7,65,9,354,1692,120,3132383,5
4452,data,detx,2,1,1,0,2,data,2,4,316,5,18,22,1306,58285,2492,406920642,5
6695,fork,fork,13,10,3,3,10,fork,1,4,304,5,61,20,450,3993,203,7843006,5
1868,biting,bYtIG,2,2,0,2,0,biting,2,5,347,4,20,7,250,1467,184,1860757,4
1924,blink,blIGk,6,4,2,5,1,blink,1,5,429,6,24,15,258,1297,168,5265420,6
2053,boom,bum,18,15,3,12,6,boom,1,3,452,5,74,22,1112,5725,1162,7876714,4
15518,shaky,Seki,1,0,1,0,1,shaky,2,4,619,5,19,4,151,1350,195,766843,5
8320,immeasurable,ImEZXxbL,1,0,1,1,0,immeasurable,5,9,664,12,0,1,15,148,13,233029,8
7449,gross,gros,11,9,2,0,11,gross,1,4,375,6,47,23,779,5186,1317,16440798,5
14099,quiet,kwY|t,1,0,1,0,1,quiet,2,5,403,6,6,7,5978,15746,2192,16748709,6
14407,recur,rIkR,3,2,1,1,2,recur,2,4,444,6,72,0,2,255,29,378119,5
2296,bulk,b^lk,7,6,1,3,4,bulk,1,4,429,5,28,17,97,3473,352,18029501,5
15256,scoop,skup,9,7,2,6,3,scoop,1,4,405,6,24,8,289,1702,249,5272937,5
14337,receipt,rIsit,5,4,1,1,4,receipt,2,5,442,8,10,2,379,1024,151,14513169,6
7971,home,hom,20,18,2,13,7,home,1,3,372,5,92,32,39491,152652,32906,1276874048,4
1856,birdie,bRdi,7,6,1,3,4,birdie,2,4,502,7,65,6,253,796,31,775268,5
6488,flagrant,flegrxnt,1,1,0,1,0,flagrant,2,8,544,9,1,1,29,263,37,313303,9
5243,drain,dren,13,10,3,7,6,drain,1,4,539,6,51,13,440,4494,348,6412237,5
2107,boutique,butik,2,0,2,0,2,boutique,2,5,529,9,5,1,55,1017,87,6243406,6
658,ample,@mpL,3,1,2,2,1,ample,2,5,363,5,11,6,93,2127,134,3187842,4
1532,barbed,barbd,3,1,2,0,3,barbed,1,5,405,7,18,9,67,806,91,653497,6
17705,trick,trIk,13,10,3,5,8,trick,1,4,313,6,56,19,2411,5087,824,8209875,5
14770,reward,rIword,1,1,0,1,0,reward,2,6,472,7,4,11,919,4181,791,7799584,7
5276,drew,dru,13,9,4,7,6,drew,1,3,379,5,52,12,1277,12170,1745,10762071,4
15275,scrap,skr@p,4,4,0,1,3,scrap,1,5,450,6,12,7,223,1795,188,3757482,6
15378,select,sxlEkt,2,1,1,2,0,select,2,6,556,7,4,2,180,5719,539,168688154,7
1599,batch,b@C,20,20,0,10,10,batch,1,3,354,6,74,18,212,1363,117,7837389,4
3983,corpse,korps,3,1,2,0,3,corpse,1,5,394,7,15,6,515,1591,106,2667151,6
16024,soup,sup,22,16,6,16,6,soup,1,3,507,5,83,16,1285,5979,505,10543534,4
14750,reversal,rIvRsL,2,1,1,1,1,reversal,3,7,563,9,3,2,57,1381,226,2425317,8
17110,tendency,tEnd|nsi,1,0,1,1,0,tendency,3,8,687,8,2,0,138,4835,501,4490160,9
11215,move,muv,8,5,3,1,7,move,1,3,385,5,30,26,21325,52746,13243,70118763,4
11416,naturally,n@CXLi,1,0,1,0,1,naturally,3,7,582,8,3,0,1250,7025,767,10578863,7
15329,seat,sit,32,28,4,21,11,seat,1,3,439,5,122,31,4018,20400,3255,29067801,4
11867,odds,adz,4,3,1,3,1,odds,1,3,519,5,43,9,970,6567,1013,13286511,4
15403,sen,sEn,28,23,5,20,8,sen,1,3,439,4,124,52,72,11257,6574,5237060,4
14887,rocket,rak|t,5,5,0,5,0,rocket,2,5,478,7,16,12,604,3606,760,7451773,6
4476,deadlock,dEdlak,1,1,0,1,0,deadlock,2,6,519,9,4,1,4,336,112,856918,7
9915,lightning,lYtnIG,1,0,1,1,0,lightning,2,6,509,10,7,3,721,3800,605,7621331,7
8323,immemorial,ImxmoriL,1,0,1,1,0,immemorial,5,9,766,5,1,0,4,139,10,182323,4
1482,ban,b@n,30,25,5,17,13,ban,1,3,276,4,144,60,160,6348,1718,11944578,4
10210,lynch,lInC,10,7,3,9,1,lynch,1,4,446,6,38,3,257,2772,482,4920597,5
5067,dissident,dIs|d|nt,1,1,0,1,0,dissident,3,8,456,10,1,1,9,664,142,631185,8
3113,chord,kord,19,15,4,10,9,chord,1,4,403,6,91,6,93,899,148,3123447,5
233,address,@drEs,2,0,2,1,1,address,2,5,728,8,3,1,2666,24164,5214,261874562,6
1266,atypical,etIpIkL,1,0,1,1,0,atypical,4,8,612,7,1,2,19,529,28,940146,7
15756,skimp,skImp,4,1,3,2,2,skimp,1,5,451,6,9,6,13,113,7,108535,6
2974,chaser,CesX,5,4,1,1,4,chaser,2,4,454,7,17,9,66,209,48,1668181,5
18550,vigor,vIgX,4,4,0,3,1,vigor,2,4,529,6,20,10,21,968,104,977794,5
15200,scalpel,sk@lpL,1,0,1,0,1,scalpel,2,7,507,8,1,3,161,461,43,268971,8
16714,supervise,supXvYz,1,0,1,0,1,supervise,3,7,753,10,2,2,98,676,76,1799608,8
9513,kit,kIt,35,28,7,23,12,kit,1,3,272,4,100,35,900,3440,287,59970207,4
5539,elevate,Elxvet,1,0,1,0,1,elevate,3,6,460,8,2,2,43,693,101,802256,7
13429,power,pWX,9,8,1,6,3,power,2,3,394,6,53,18,7600,85290,14004,226613941,4
12252,pad,p@d,26,22,4,15,11,pad,1,3,390,4,58,37,415,3190,308,13169064,4
14944,roughage,r^fIJ,1,1,0,1,0,roughage,2,5,459,6,6,0,13,28,5,57953,5
3625,conception,kxnsEpS|n,1,0,1,0,1,conception,3,9,655,11,2,2,106,2644,176,3663294,10
2139,bran,br@n,13,9,4,2,11,bran,1,4,519,5,70,46,67,538,98,957029,5
17203,theft,TEft,4,4,0,4,0,theft,1,4,327,6,6,2,344,2749,529,12745569,5
4302,cunning,k^nIG,3,3,0,3,0,cunning,2,5,355,8,22,7,207,578,53,979573,6
2544,cannon,k@n|n,2,2,0,2,0,cannon,2,5,381,7,87,19,444,1778,231,5380528,6
15934,sock,sak,26,22,4,19,7,sock,1,3,530,5,126,28,458,951,138,3748989,4
8880,insect,InsEkt,5,3,2,2,3,insect,2,6,599,7,8,7,161,2000,83,4555341,7
9276,jade,Jed,11,9,2,8,3,jade,1,3,439,5,61,21,259,852,72,5275842,4
14995,rumor,rumX,4,3,1,2,2,rumor,2,4,342,6,50,6,531,1748,456,2459686,5
15118,sand,s@nd,13,9,4,10,3,sand,1,4,545,5,51,36,1035,9414,820,16332822,5
6300,fee,fi,31,21,10,19,12,fee,1,2,315,4,164,39,494,5914,555,50935535,3
6824,frog,frcg,4,3,1,1,3,frog,1,4,455,5,19,12,603,1588,148,8025641,5
14520,relay,rile,3,2,1,0,3,relay,2,4,529,6,18,9,152,1451,119,9275313,5
4995,discount,dIskWnt,1,1,0,1,0,discount,2,7,498,9,5,4,243,2747,479,82647676,8
2258,brusque,br^sk,2,1,1,2,0,brusque,1,5,386,8,18,0,4,150,4,62380,6
9265,ivy,Yvi,4,2,2,3,1,ivy,2,3,425,3,23,7,172,2180,216,3926107,4
2066,booze,buz,18,13,5,11,7,booze,1,3,493,6,144,11,558,851,158,1179144,4
3405,cog,kag,12,11,1,4,8,cog,1,3,417,4,42,35,27,233,17,1066034,4
16476,strident,strYdNt,1,0,1,1,0,strident,2,8,554,9,1,1,2,411,64,190059,9
9595,lad,l@d,34,27,7,21,13,lad,1,3,469,4,95,59,736,786,26,2118793,4
1062,arrival,xrYvL,1,0,1,1,0,arrival,3,5,515,8,2,1,422,5131,518,15370734,6
11989,oral,orL,8,5,3,5,3,oral,2,4,394,5,61,19,220,5904,617,41947791,5
9646,languish,l@GgwIS,2,1,1,1,1,languish,2,7,552,9,3,1,8,184,21,138503,8
13246,pollen,pal|n,1,0,1,1,0,pollen,2,5,414,7,31,13,62,1145,61,2053694,6
3835,contiguous,kxntIgyuxs,1,1,0,0,1,contiguous,4,10,778,6,1,1,3,405,27,2702054,6
3426,coincidence,koIns|d|ns,1,1,0,0,1,coincidence,4,10,656,12,0,1,948,2083,461,1860675,8
6456,fish,fIS,13,9,4,4,9,fish,1,3,407,5,50,18,4258,28281,2194,52768568,4
3508,comic,kamIk,3,2,1,3,0,comic,2,5,393,6,14,8,552,3603,656,16697874,6
1866,bit,bIt,35,30,5,25,10,bit,1,3,467,4,108,40,11987,47714,21135,82122088,4
10200,lustre,l^stX,6,2,4,4,2,lustre,2,5,472,6,27,1,7,31,1,653026,5
11425,naval,nevL,5,4,1,1,4,naval,2,5,459,5,12,10,292,3333,683,8091902,5
11368,nap,n@p,20,19,1,15,5,nap,1,3,379,4,86,32,645,1399,164,2482918,4
13062,pithy,pITi,3,2,1,0,3,pithy,2,4,366,5,13,2,20,166,39,197155,5
4361,cutting,k^tIG,2,2,0,2,0,cutting,2,5,301,8,16,8,1126,12533,2568,19780364,6
15975,solubility,salyubIl|ti,1,1,0,1,0,solubility,5,10,717,6,0,0,0,29,0,925374,5
17532,touchy,t^Ci,3,2,1,1,2,touchy,2,4,319,6,23,2,160,464,95,399578,4
4788,detail,ditel,1,1,0,1,0,detail,2,5,401,7,5,5,989,8848,1274,45494927,6
11616,nominal,namxnL,1,1,0,0,1,nominal,3,7,483,8,2,0,38,919,38,4957994,8
2065,booty,buti,7,3,4,3,4,booty,2,4,419,5,54,10,313,530,62,14220912,5
7179,give,gIv,7,7,0,4,3,give,1,3,427,5,25,18,59559,92100,31347,140703695,4
7310,got,gat,26,24,2,22,4,got,1,3,336,4,84,37,168631,185511,82650,145064428,4
2356,bursar,bRsX,6,6,0,2,4,bursar,2,4,559,5,32,0,8,25,1,285837,5
6426,finally,fYnLi,2,1,1,0,2,finally,3,6,433,6,4,0,5989,50764,10482,49005638,6
15019,rural,rUrL,1,1,0,1,0,rural,2,5,569,4,2,4,59,12512,1199,31001070,5
15524,shamble,S@mbL,3,2,1,3,0,shamble,2,6,482,8,9,2,2,13,1,19024,7
77,absent,@bs|nt,2,1,1,0,2,absent,2,6,475,7,2,1,131,3206,313,8831540,7
16203,spur,spR,11,5,6,3,8,spur,1,3,471,5,45,15,73,1368,195,2171795,4
2030,bonanza,b|n@nzx,1,0,1,0,1,bonanza,3,7,548,6,2,0,83,427,68,1264434,6
7150,gibbon,gIb|n,2,1,1,1,1,gibbon,2,5,363,7,22,4,12,121,20,481964,6
7196,gland,gl@nd,5,3,2,3,2,gland,1,5,490,6,14,13,77,807,58,2561568,6
15088,saline,selin,1,1,0,1,0,saline,2,5,517,6,22,10,175,505,49,2005218,6
16825,swipe,swYp,6,5,1,2,4,swipe,1,4,457,6,18,11,82,479,59,528509,5
7100,gently,JEntli,1,1,0,0,1,gently,2,6,443,6,6,4,459,7165,216,5465493,6
5643,enable,InebL,2,2,0,2,0,enable,3,6,609,7,7,13,75,4332,349,39743571,7
2188,bridge,brIJ,6,4,2,2,4,bridge,1,4,374,7,27,12,2331,12099,1558,35181570,5
14140,rabid,r@b|d,2,2,0,1,1,rabid,2,5,398,6,6,7,70,417,36,612965,6
8064,house,hWs,7,6,1,5,2,house,1,3,402,6,67,29,26214,139426,42318,231328347,4
9425,juror,JUrX,1,1,0,0,1,juror,2,4,599,6,10,2,131,1681,1284,837876,5
16991,tardy,tardi,2,1,1,2,0,tardy,2,5,445,5,13,8,58,166,10,303140,6
3660,condenser,kxndEnsX,1,0,1,0,1,condenser,3,8,600,9,2,2,7,98,1,1302457,8
5146,does,d^z,16,15,1,6,10,does,1,3,415,5,83,39,34002,203088,71883,314032845,4
6143,fable,febL,11,10,1,9,2,fable,2,5,484,6,31,15,20,397,34,1678751,6
397,agent,eJ|nt,1,1,0,1,0,agent,2,5,436,6,6,7,5235,13435,2725,57105050,6
15945,soggy,sagi,3,3,0,0,3,soggy,2,4,442,4,16,6,50,608,42,335302,4
9456,keen,kin,25,21,4,22,3,keen,1,3,435,5,173,28,228,2078,215,5721238,4
7945,hobby,habi,7,6,1,3,4,hobby,2,4,377,6,34,6,354,1412,134,8237250,5
10712,mercy,mRsi,2,2,0,1,1,mercy,2,4,484,5,52,7,1291,2842,409,6831349,5
13167,plug,pl^g,8,6,2,3,5,plug,1,4,319,5,16,10,531,3190,568,24430043,5
9838,lethal,liTL,1,1,0,0,1,lethal,2,5,549,7,6,1,289,2243,571,3045126,5
14765,revoke,rIvok,1,0,1,1,0,revoke,2,5,506,7,3,4,37,209,37,1266673,6
9412,juncture,J^GkCX,1,1,0,1,0,juncture,2,6,499,9,4,3,40,675,161,450947,7
12508,past,p@st,17,13,4,9,8,past,1,4,442,5,49,34,6312,83633,15281,105631069,5
10606,measly,mizLi,1,1,0,0,1,measly,2,5,530,6,21,1,63,121,8,198850,4
9939,limit,lIm|t,2,2,0,2,0,limit,2,5,369,6,4,2,664,10876,1650,38294205,6
9230,is,Iz,13,10,3,5,8,is,1,2,384,3,88,65,459663,2365648,736384,4705747796,3
15608,shoulder,SoldX,2,2,0,2,0,shoulder,2,5,495,9,19,1,1336,16622,1069,12100391,6
14143,race,res,29,22,7,17,12,race,1,3,463,5,120,41,3157,34563,9930,52301684,4
1124,aslant,xsl@nt,1,0,1,1,0,aslant,2,6,599,6,1,2,0,13,0,11066,4
17368,times,tYmz,1,0,1,0,1,times,1,4,748,6,48,26,11221,90792,21923,202959291,5
12527,pate,pet,34,27,7,23,11,pate,1,3,628,5,99,44,33,440,46,847730,4
9524,knave,nev,15,12,3,9,6,knave,1,3,484,6,43,4,19,97,1,153917,4
7144,ghost,gost,10,9,1,9,1,ghost,1,4,435,6,31,5,1866,4017,369,14501179,5
14866,river,rIvX,4,4,0,3,1,river,2,4,411,6,30,24,2829,30316,2955,78845869,5
6393,fig,fIg,16,16,0,9,7,fig,1,3,463,4,53,27,62,6718,90,19198746,4
7515,gunny,g^ni,12,10,2,6,6,gunny,2,4,378,6,46,12,32,78,37,150918,5
13168,plum,pl^m,10,7,3,3,7,plum,1,4,416,5,34,16,174,1375,118,2962013,5
1344,avarice,@vXxs,1,1,0,1,0,avarice,3,5,511,7,1,1,25,130,12,182717,4
578,aluminum,xlum|nxm,1,1,0,0,1,aluminum,4,8,507,9,3,2,115,4074,177,14078530,9
7823,herb,hRb,11,10,1,4,7,herb,1,2,367,5,49,24,254,2289,300,5931730,3
11074,monk,m^Gk,12,10,2,9,3,monk,1,4,285,5,39,28,376,1593,129,3594297,5
18812,warrant,wcrxnt,3,1,2,1,2,warrant,2,6,392,8,11,5,1060,2654,844,9167246,7
3534,commission,kxmIS|n,1,1,0,1,0,commission,3,7,515,11,6,3,703,17160,3410,78818439,8
2052,booklet,bUkl|t,1,0,1,1,0,booklet,2,6,485,8,0,3,28,613,50,4909462,6
17476,too,tu,31,22,9,18,13,too,1,2,344,4,164,49,69950,173548,37581,176109551,3
12456,parrot,p@rxt,6,4,2,4,2,parrot,2,5,359,7,24,6,167,752,95,2682859,6
15000,run,r^n,26,23,3,16,10,run,1,3,349,4,152,43,17878,67485,15633,117221037,4
1542,barge,barJ,9,8,1,3,6,barge,1,4,496,6,43,24,198,681,81,1319916,5
12187,overlap,ovXl@p,1,1,0,0,1,overlap,3,6,579,8,2,2,29,1510,76,3745046,7
9721,lawyer,lOX,7,6,1,4,3,lawyer,2,3,384,7,34,11,4055,15150,4300,30253459,4
17588,tranquil,tr@GkwL,1,0,1,0,1,tranquil,2,8,499,9,1,0,42,524,52,1231687,9
5285,driven,drIvxn,3,2,1,3,0,driven,2,6,381,6,4,7,524,10481,1553,17723989,6
15011,running,r^nIG,1,1,0,1,0,running,2,5,489,8,16,9,8054,41017,10846,72880289,6
12676,pent,pEnt,22,19,3,16,6,pent,1,4,335,5,61,36,10,329,51,388427,5
3448,college,kalIJ,3,3,0,2,1,college,2,5,516,8,17,3,4344,59669,7430,182550807,6
15777,slander,sl@ndX,1,1,0,1,0,slander,2,6,575,8,14,11,64,320,96,669482,7
13434,practical,pr@ktIkL,1,0,1,0,1,practical,3,9,533,10,2,0,577,10037,1121,29138914,9
2919,chance,C@ns,9,7,2,4,5,chance,1,4,538,7,25,11,12303,33018,9747,43463277,5
1363,avid,@vxd,1,1,0,1,0,avid,2,4,539,5,5,16,25,1182,150,3623473,5
18187,upright,^prYt,2,2,0,1,1,upright,2,5,446,8,6,2,154,2523,91,3957588,6
487,alight,xlYt,16,14,2,7,9,alight,2,4,459,5,22,6,21,183,6,264372,4
5941,evoke,Ivok,2,0,2,2,0,evoke,2,4,457,6,4,6,15,1023,51,804720,5
10461,marked,markt,5,2,3,0,5,marked,1,5,402,7,46,15,547,8144,645,17726160,5
2291,bulb,b^lb,2,2,0,0,2,bulb,1,4,355,5,8,7,200,1683,182,4880044,5
10957,missing,mIsIG,2,2,0,1,1,missing,2,5,437,6,16,8,4484,15418,4767,35818578,5
10276,magnify,m@gnxfY,1,0,1,0,1,magnify,3,7,619,8,3,0,30,240,16,798801,8
14318,reasonable,rizNxbL,1,1,0,1,0,reasonable,3,8,698,11,1,3,946,8059,1902,26526457,9
11659,nor,nor,28,22,6,18,10,nor,1,3,379,4,124,34,1835,22540,2068,39759860,4
18179,upper,^pX,5,3,2,4,1,upper,2,3,375,6,23,6,616,12945,1104,38343284,4
15592,shoddy,Sadi,5,4,1,4,1,shoddy,2,4,518,5,21,1,37,276,54,315087,4
4914,dime,dYm,20,19,1,12,8,dime,1,3,387,5,74,24,615,1594,422,1910001,4
13630,prim,prIm,10,7,3,4,6,prim,1,4,348,5,31,26,19,219,11,668388,5
3299,clinic,klInIk,1,0,1,0,1,clinic,2,6,400,7,7,2,714,6312,1122,15188681,7
14667,resigned,rIzYnd,4,2,2,1,3,resigned,2,6,622,8,9,3,142,2893,739,2246288,6
4709,deport,dIport,2,1,1,2,0,deport,2,6,484,7,2,4,40,237,97,259896,7
10598,mealtime,miltYm,1,1,0,1,0,mealtime,2,6,658,5,1,1,9,144,8,195115,4
10998,moderator,madXetX,1,0,1,0,1,moderator,4,7,808,10,3,1,8,732,198,17491124,8
18672,voiced,vOst,8,7,1,7,1,voiced,1,4,493,6,16,4,18,1526,168,1498292,4
15008,runic,runIk,1,1,0,1,0,runic,2,5,528,5,8,2,2,21,3,185207,4
7726,heap,hip,22,21,1,16,6,heap,1,3,351,5,69,16,249,1373,89,2806006,4
235,adduce,xdus,3,1,2,2,1,adduce,2,4,609,6,7,2,1,22,4,77225,4
18505,vial,vYL,10,6,4,1,9,vial,2,4,389,5,19,22,66,496,46,1014511,5
2347,burly,bRli,7,6,1,5,2,burly,2,4,345,5,104,11,17,534,22,255767,5
8750,infirm,InfRm,1,0,1,0,1,infirm,2,5,570,7,4,1,15,157,16,253244,6
5257,drawer,dror,6,5,1,1,5,drawer,1,4,356,7,21,5,663,2495,172,4830969,5
10042,lizard,lIzXd,4,3,1,4,0,lizard,2,5,483,7,13,5,247,1048,50,2238615,6
19032,wiggle,wIgL,5,4,1,4,1,wiggle,2,5,332,7,32,10,152,539,116,646578,6
495,alkali,@lkxlY,1,0,1,0,1,alkali,3,6,577,7,2,1,18,72,2,686657,7
1539,bard,bard,19,17,2,11,8,bard,1,4,364,5,72,37,41,582,34,1793654,5
16400,stodgy,staJi,2,2,0,1,1,stodgy,2,5,609,6,6,0,8,166,13,77033,5
4409,dale,del,30,27,3,23,7,dale,1,3,286,5,128,47,463,2765,589,9570230,4
15428,sentence,sEntNs,1,1,0,0,1,sentence,2,7,664,9,1,3,1047,8193,2189,14360198,8
6616,fold,fold,12,10,2,10,2,fold,1,4,539,5,52,20,440,3766,318,9481593,5
12302,pallid,p@lxd,5,5,0,3,2,pallid,2,5,403,7,15,0,8,194,3,155083,6
501,all,cl,25,12,13,19,6,all,1,2,408,4,108,44,263255,696373,220486,2022464594,3
2310,bumpkin,b^mpk|n,1,1,0,1,0,bumpkin,2,7,557,5,2,3,19,62,6,70017,5
9695,Latin,l@tN,8,6,2,7,1,latin,2,5,357,6,57,14,561,9750,921,36551294,6
13428,powder,pWdX,2,1,1,1,1,powder,2,4,379,7,16,8,818,6430,362,12628035,5
14529,relict,rElIkt,1,0,1,0,1,relict,2,6,424,6,3,2,2,33,0,103428,6
8004,hook,hUk,16,15,1,13,3,hook,1,3,309,5,57,33,1938,5103,740,11359942,4
18629,visualize,vIZuxlYz,1,0,1,0,1,visualize,3,8,751,10,2,1,88,707,80,1416743,9
12089,ours,Wrz,1,0,1,0,1,ours,2,3,569,5,50,20,1801,4047,1068,5183591,3
8271,illegal,IligL,2,0,2,1,1,illegal,3,6,485,8,6,1,1199,11984,4075,21050148,7
15864,smithy,smITi,1,0,1,0,1,smithy,2,5,507,6,10,4,63,63,1,199892,5
4584,define,dIfYn,4,3,1,2,2,define,2,5,598,7,10,11,318,6794,1190,36090823,6
19085,wipe,wYp,14,12,2,5,9,wipe,1,3,268,5,59,19,861,2483,391,2841610,4
14725,retract,rItr@kt,2,2,0,2,0,retract,2,7,519,8,1,4,74,196,48,533226,8
7907,hind,hYnd,8,7,1,7,1,hind,1,4,382,5,44,27,125,649,27,1071049,5
18660,vocal,vokL,2,2,0,2,0,vocal,2,5,482,6,11,5,151,3362,446,9083681,6
3043,chicory,CIkXi,1,1,0,1,0,chicory,3,6,507,6,0,0,8,87,2,186015,4
4566,deep,dip,18,17,1,13,5,deep,1,3,320,5,81,23,3896,35570,4073,53452250,4
7591,hall,hcl,23,20,3,19,4,hall,1,3,446,5,125,39,2649,23866,3284,61270478,4
18066,unformed,^nformd,1,1,0,1,0,unformed,2,7,573,6,2,2,4,101,6,56042,6
8922,installation,InstxleS|n,1,0,1,1,0,installation,4,10,828,13,2,1,72,2748,116,44937610,11
18365,vector,vEktX,5,5,0,5,0,vector,2,5,505,7,24,7,78,959,25,15925901,6
15290,script,skrIpt,2,0,2,1,1,script,1,6,522,7,12,4,1000,4251,955,32557214,7
4478,deaf,dEf,13,11,2,4,9,deaf,1,3,355,5,49,10,741,2187,440,5774245,4
11700,noun,nWn,8,7,1,7,1,noun,1,3,369,5,31,9,27,432,29,3837137,4
15939,sodium,sodixm,2,2,0,2,0,sodium,3,6,575,5,3,1,126,6590,129,8113964,5
11016,module,maJul,1,1,0,1,0,module,2,5,457,7,2,2,136,1445,45,44129445,6
1254,attire,xtYr,2,1,1,2,0,attire,3,4,527,7,6,2,76,838,55,1517340,4
2686,cart,kart,14,10,4,8,6,cart,1,4,324,5,82,36,461,3129,254,152159382,5
15634,shrub,Sr^b,4,3,1,3,1,shrub,1,4,467,6,12,6,14,535,23,1458217,5
9426,just,J^st,12,10,2,11,1,just,1,4,419,5,31,22,242206,453049,189841,462869224,5
18152,unto,^ntu,4,4,0,2,2,unto,2,4,385,5,12,11,389,917,145,9533187,5
4484,dean,din,24,23,1,19,5,dean,1,3,398,5,151,38,1974,7446,2313,23588713,4
8845,inner,InX,6,2,4,3,3,inner,2,3,280,6,49,16,507,9619,1187,17552078,4
13087,plague,pleg,5,4,1,0,5,plague,1,4,479,7,18,8,424,1890,178,2385288,5
7953,hog,hcg,9,8,1,6,3,hog,1,3,377,4,77,39,261,1056,102,2271973,4
4688,density,dEns|ti,1,1,0,1,0,density,3,7,417,7,2,0,73,3785,125,18347717,8
13350,pose,poz,21,16,5,12,9,pose,1,3,468,5,116,36,347,4311,649,5242620,4
16717,supervisory,supXvYzXi,1,0,1,0,1,supervisory,5,9,843,11,4,2,16,480,33,3252742,9
236,adept,xdEpt,2,2,0,2,0,adept,2,5,520,4,2,2,33,902,50,1597568,4
8138,hurl,hRl,22,19,3,15,7,hurl,1,3,476,5,102,14,69,290,24,334757,4
8632,independence,IndxpEnd|ns,1,1,0,0,1,independence,4,11,682,13,2,0,204,10118,1842,14412488,12
13589,presidential,prEzxdEnCL,1,0,1,1,0,presidential,4,11,683,13,2,1,285,16102,7371,10431378,12
13208,poetry,poxtri,1,1,0,1,0,poetry,3,6,477,5,1,1,682,6722,710,25314268,5
341,afar,xfar,4,3,1,2,2,afar,2,4,646,4,17,7,59,587,113,766928,4
1470,ballet,b@le,1,1,0,1,0,ballet,2,4,489,7,23,16,523,2932,276,5896294,5
6739,foully,fWli,6,4,2,5,1,foully,2,4,519,5,29,2,8,6,0,15515,4
2786,cause,kcz,10,7,3,4,6,cause,1,3,464,6,105,18,15812,32020,8057,65907985,4
9370,jot,Jat,22,22,0,17,5,jot,1,3,400,4,67,28,37,257,23,414410,4
8867,inquiry,InkwYri,1,0,1,0,1,inquiry,3,7,472,7,1,1,178,4756,363,15788121,6
5339,duke,duk,16,14,2,6,10,duke,1,3,312,5,88,25,1277,6455,1478,12251478,4
15675,silence,sYlxns,1,1,0,0,1,silence,2,6,640,8,5,3,1294,12473,1140,9102010,7
3864,contrast,kantr@st,1,1,0,0,1,contrast,2,8,725,9,4,9,107,13809,797,17956897,9
15657,sidle,sYdL,7,5,2,3,4,sidle,2,5,510,6,38,13,54,77,4,55534,6
5092,district,dIstrIkt,1,1,0,1,0,district,2,8,492,9,4,2,1068,25513,3507,101328632,9
1050,aroma,xromx,1,1,0,0,1,aroma,3,4,527,6,19,5,69,935,41,2018997,5
895,appellate,xpElxt,1,0,1,0,1,appellate,3,6,624,9,1,0,17,745,246,2711762,5
15541,she,Si,31,21,10,19,12,she,1,2,340,4,185,31,190377,896925,156580,339186542,3
10143,lower,loX,16,13,3,5,11,lower,2,3,529,6,74,30,1417,35269,4219,72609632,4
12886,philosopher,fxlasxfX,1,1,0,0,1,philosopher,4,8,709,12,2,1,155,1698,134,2718992,9
19185,wound,wWnd,10,10,0,10,0,wound,1,4,436,6,23,10,1353,6027,871,5820050,3
16092,speech,spiC,3,2,1,1,2,speech,1,4,539,7,16,2,1940,23288,7046,31121393,5
13333,portage,portIJ,1,1,0,1,0,portage,2,6,621,6,6,4,6,235,11,2110329,6
12303,pallor,p@lX,6,5,1,3,3,pallor,2,4,395,6,25,6,7,149,2,96801,4
3007,cheer,CIr,27,25,2,20,7,cheer,1,3,433,6,65,11,953,2030,372,3649712,4
11219,much,m^C,17,14,3,6,11,much,1,3,366,5,52,25,49636,236679,75977,242347915,4
5866,estimation,EstxmeS|n,1,1,0,1,0,estimation,4,9,768,11,1,1,25,952,114,5952184,10
3930,cope,kop,25,23,2,16,9,cope,1,3,309,5,86,34,166,3545,507,5172385,4
11566,nil,nIl,26,25,1,20,6,nil,1,3,293,4,100,34,23,272,37,5608046,4
247,adjoin,xJOn,2,1,1,1,1,adjoin,2,4,513,7,4,1,0,15,0,76889,5
5958,excavator,EkskxvetX,1,0,1,0,1,excavator,4,9,563,10,2,1,4,73,1,396338,10
10172,lull,l^l,15,15,0,9,6,lull,1,3,379,5,69,18,60,459,83,410517,4
16651,suicide,suxsYd,1,0,1,0,1,suicide,3,6,689,8,2,1,1747,9286,3201,10997710,7
4367,cycle,sYkL,6,6,0,3,3,cycle,2,5,429,6,41,2,300,8561,1047,29585616,6
5251,drank,dr@Gk,8,6,2,8,0,drank,1,5,391,5,18,10,656,3291,336,1777243,5
18619,vision,vIZ|n,2,2,0,2,0,vision,2,5,374,7,7,2,1218,20100,1776,43435348,6
19189,wrangle,r@GgL,8,7,1,7,1,wrangle,2,6,519,8,19,5,18,115,21,116673,7
18482,vest,vEst,19,16,3,14,5,vest,1,4,413,5,45,27,284,1568,208,3720750,5
521,alliance,xlY|ns,1,0,1,1,0,alliance,3,6,617,9,5,3,465,6375,893,22670388,7
9956,liner,lYnX,7,5,2,3,4,liner,2,4,348,6,78,29,62,1390,140,4486627,5
10857,mince,mIns,8,7,1,4,4,mince,1,4,404,6,44,18,27,266,45,328039,5
16734,suppress,sxprEs,1,0,1,1,0,suppress,2,6,748,9,3,0,76,1368,218,2179050,7
18962,whine,hwYn,7,5,2,3,4,whine,1,4,492,6,28,17,83,692,64,832995,5
7268,goblet,gabl|t,1,1,0,0,1,goblet,2,6,569,6,1,4,19,259,15,1987271,5
5534,element,Elxmxnt,2,2,0,2,0,element,3,7,477,8,4,3,338,7589,1258,36312384,8
7400,green,grin,13,13,0,2,11,green,1,4,393,6,67,18,3696,42163,3744,108297288,5
14513,relate,rIlet,1,0,1,0,1,relate,2,5,445,7,5,12,242,4385,828,8741324,6
1922,blind,blYnd,4,3,1,4,0,blind,1,5,420,6,9,8,2337,9391,1044,16490057,6
15811,sliding,slYdIG,1,0,1,1,0,sliding,2,6,587,5,5,3,191,2829,213,4064583,5
3251,class,kl@s,12,10,2,3,9,class,1,4,469,6,49,20,5985,52264,7136,191106038,5
413,agitator,@J|tetX,1,0,1,0,1,agitator,4,7,686,9,1,1,11,73,5,380247,7
15276,scrape,skrep,3,2,1,1,2,scrape,1,5,569,7,8,6,210,1357,92,699467,6
4983,disclaim,dIsklem,1,0,1,1,0,disclaim,2,7,597,9,4,1,5,34,1,692139,8
9995,listen,lIsN,5,4,1,3,2,listen,2,5,416,7,51,7,27784,21800,8901,43258456,6
15302,scuffle,sk^fL,2,2,0,1,1,scuffle,2,6,506,8,5,5,22,227,45,138799,7
5117,divine,dxvYn,3,3,0,0,3,divine,2,5,629,7,9,4,594,5010,283,9421666,6
1540,bare,bEr,26,21,5,18,8,bare,1,3,366,5,143,56,425,6166,368,8547495,4
13004,pillow,pIlo,5,4,1,3,2,pillow,2,4,395,7,43,5,581,2759,255,6272168,5
6184,fall,fcl,26,23,3,21,5,fall,1,3,419,5,107,28,6044,37459,5804,65510611,4
6284,feature,fiCX,2,2,0,0,2,feature,2,4,477,8,17,2,298,9943,641,64289796,5
13367,postage,postIJ,1,1,0,1,0,postage,2,6,626,6,6,5,48,576,61,16732519,6
10592,mead,mid,20,19,1,14,6,mead,1,3,461,5,99,24,53,835,71,2129480,4
15324,sear,sIr,33,26,7,25,8,sear,1,3,513,5,108,44,11,233,32,437507,4
9756,least,list,12,9,3,9,3,least,1,4,579,5,46,19,10596,82255,17696,111230637,5
8236,idealize,YdilYz,1,1,0,1,0,idealize,3,6,661,9,3,2,6,76,9,33710,7
2284,bug,b^g,26,25,1,15,11,bug,1,3,316,4,65,36,1068,2404,335,39682466,4
1408,babe,beb,13,10,3,2,11,babe,1,3,339,5,66,34,1814,1492,242,22492726,4
18539,video,vIdio,1,1,0,1,0,video,3,5,606,6,3,3,2105,28250,12055,365426877,6
5297,drop,drap,6,6,0,2,4,drop,1,4,359,5,21,6,6661,17102,2790,37438861,5
11914,olive,alIv,1,0,1,1,0,olive,2,4,422,6,9,9,375,7872,416,9299902,5
7174,girl,gRl,16,15,1,13,3,girl,1,3,490,5,76,9,28413,40552,8434,89157423,4
7178,gist,JIst,10,10,0,9,1,gist,1,4,404,4,31,23,56,313,64,687110,5
18982,whistle,hwIsL,3,3,0,0,3,whistle,2,5,429,8,38,9,788,2070,321,2599929,6
4925,diner,dYnX,7,6,1,5,2,diner,2,4,427,6,66,25,632,1465,222,2261961,5
4252,crumble,kr^mbL,3,2,1,2,1,crumble,2,7,589,8,9,8,71,692,73,477166,8
12475,participle,part|sIpL,1,0,1,0,1,participle,4,10,559,11,1,1,3,38,3,235586,10
15014,runt,r^nt,15,10,5,9,6,runt,1,4,308,5,42,22,125,98,7,206736,4
12469,partial,parSL,3,2,1,1,2,partial,2,6,549,8,9,1,247,3921,448,14642627,7
7723,heady,hEdi,4,2,2,2,2,heady,2,4,347,5,51,13,20,725,53,440593,5
14245,rascal,r@skL,2,1,1,1,1,rascal,2,6,619,7,10,3,201,220,38,1424891,7
17988,under,^ndX,4,1,3,3,1,under,2,4,459,6,17,11,13358,116258,20951,313298732,5
1048,army,armi,4,2,2,0,4,army,2,4,372,5,29,10,4370,30360,7165,44673953,5
3842,continue,kxntInyu,1,0,1,0,1,continue,3,8,539,9,2,2,2527,36309,11780,76660150,9
18461,version,vRZ|n,4,3,1,4,0,version,2,5,629,8,9,2,828,17979,2307,232449752,6
3858,contraption,kxntr@pS|n,1,1,0,0,1,contraption,3,10,630,12,2,2,75,345,32,163143,11
11058,monastery,man|stEri,1,0,1,1,0,monastery,4,9,693,9,2,0,189,1013,42,2031139,10
18237,usher,^SX,3,3,0,3,0,usher,2,3,375,6,27,14,121,849,105,4949244,4
13901,pub,p^b,15,15,0,8,7,pub,1,3,247,4,24,16,190,1351,87,23377808,4
13963,punt,p^nt,12,10,2,9,3,punt,1,4,367,5,33,26,37,727,31,1916106,5
18891,weld,wEld,16,13,3,8,8,weld,1,4,396,5,60,21,32,668,181,1883322,5
18781,waltz,wcls,3,2,1,1,2,waltz,1,5,561,6,23,13,279,511,48,1725607,6
3440,collate,kolet,1,0,1,0,1,collate,2,5,485,8,5,3,16,23,4,319919,5
10532,mat,m@t,30,27,3,21,9,mat,1,3,364,4,94,61,178,1998,137,9947887,4
12204,overt,ovRt,2,1,1,2,0,overt,2,4,466,6,15,9,14,1121,104,871540,5
4465,dawn,dcn,19,16,3,16,3,dawn,1,3,345,5,101,20,1301,6154,737,12224273,4
13097,planet,pl@n|t,1,0,1,0,1,planet,2,6,462,7,6,8,1975,11898,1459,26416491,7
5849,especial,IspESL,1,0,1,1,0,especial,3,7,513,9,2,1,7,76,4,558135,8
2329,burden,bRdN,4,3,1,2,2,burden,2,5,316,7,39,10,501,6944,1538,9722173,6
11571,nine,nYn,21,19,2,16,5,nine,1,3,409,5,77,28,3441,25698,5927,26811323,4
18745,wager,weJX,4,3,1,1,3,wager,2,4,419,6,23,34,202,414,50,1367520,5
14925,roster,rastX,1,1,0,1,0,roster,2,5,543,7,19,27,110,1894,62,7503686,6
13960,punitive,pyun|tIv,1,1,0,1,0,punitive,3,8,636,6,1,0,44,1272,262,1450376,5
15596,shook,SUk,15,15,0,13,2,shook,1,3,417,5,54,13,303,11639,384,2917661,3
12434,parity,p@rxti,3,2,1,1,2,parity,3,6,501,6,11,8,5,679,91,2651299,7
7627,handsome,h@nsxm,1,1,0,1,0,handsome,2,6,659,9,15,1,1684,4511,333,3744030,7
15538,shaven,Sevxn,2,2,0,2,0,shaven,2,5,464,6,14,7,10,318,25,411865,5
6971,game,gem,20,17,3,11,9,game,1,3,314,5,61,30,11926,62889,8574,227136152,4
16942,talk,tck,23,20,3,18,5,talk,1,3,269,5,76,20,43605,85578,44132,97864221,4
15273,scrabble,skr@bL,2,1,1,0,2,scrabble,2,7,510,5,6,2,96,326,85,1809087,5
16921,tackle,t@kL,12,10,2,5,7,tackle,2,5,394,7,25,6,219,4242,444,6445868,6
11012,modular,maJUlX,1,1,0,1,0,modular,3,6,602,7,2,1,8,487,17,6729966,6
7156,gig,gIg,12,11,1,8,4,gig,1,3,267,4,39,20,571,1289,216,6050760,4
1253,attic,@tIk,4,1,3,4,0,attic,2,4,404,6,18,4,400,1660,179,3348232,5
14878,roast,rost,12,11,1,11,1,roast,1,4,480,6,44,9,499,2497,148,3205415,5
3063,chime,CYm,8,8,0,6,2,chime,1,3,448,6,26,9,47,306,44,1115076,4
5390,dwelt,dwElt,4,1,3,2,2,dwelt,1,5,501,5,9,2,5,154,7,514029,5
15924,soccer,sakX,6,5,1,3,3,soccer,2,4,438,7,43,0,640,5542,716,28648277,5
19022,widen,wYdN,2,1,1,1,1,widen,2,5,412,6,42,16,42,788,105,1181299,6
17693,tribal,trYbL,5,3,2,2,3,tribal,2,6,404,7,9,2,95,4923,494,8463131,7
16282,stank,st@Gk,7,4,3,6,1,stank,1,5,565,6,15,19,39,179,5,105369,6
6202,familiar,fxmIlyX,1,1,0,0,1,familiar,3,7,568,9,0,1,1760,15446,2122,16390724,8
5926,ever,EvX,6,2,4,6,0,ever,2,3,365,5,32,28,36170,88129,25083,100276816,4
10355,man,m@n,26,21,5,15,11,man,1,3,323,4,135,74,94133,165414,45329,181460737,4
10794,mid,mId,26,20,6,15,11,mid,1,3,296,4,75,36,64,16522,1763,39630295,4
3123,chowder,CWdX,2,2,0,2,0,chowder,2,4,317,8,7,2,82,232,29,478500,5
5536,elementary,ElxmEntXi,1,1,0,1,0,elementary,4,9,708,10,1,0,242,8994,519,23834913,7
14711,retain,rIten,4,4,0,3,1,retain,2,5,542,7,10,12,121,3399,261,8706009,6
15899,snip,snIp,11,8,3,4,7,snip,1,4,472,5,19,10,108,311,23,1193439,5
2685,carry,k@ri,19,15,4,9,10,carry,2,4,377,6,126,31,3361,17736,3255,33056477,5
14476,regime,reZim,1,1,0,1,0,regime,2,5,748,7,4,4,118,10686,2181,10234937,6
7932,hit,hIt,33,29,4,22,11,hit,1,3,403,4,88,38,14025,42110,11295,53180493,4
11287,mush,m^S,15,15,0,6,9,mush,1,3,519,5,49,28,143,326,43,554552,4
16529,stump,st^mp,2,2,0,2,0,stump,1,5,485,6,14,13,125,1280,226,1357079,6
17267,thirst,TRst,6,4,2,6,0,thirst,1,4,509,7,23,2,190,896,66,1352279,5
9618,lame,lem,28,23,5,18,10,lame,1,3,364,5,87,41,557,1120,359,3018425,4
8003,hoof,hUf,5,5,0,3,2,hoof,1,3,332,5,52,18,88,299,13,588494,4
15570,shill,SIl,25,23,2,21,4,shill,1,3,417,6,98,16,14,78,26,167644,4
18921,wheat,hwit,9,8,1,3,6,wheat,1,3,359,6,97,6,293,4356,332,8685589,4
9629,lance,l@ns,10,7,3,5,5,lance,1,4,485,6,41,16,554,2948,617,5509957,5
15140,sappy,s@pi,4,3,1,1,3,sappy,2,4,479,5,33,4,43,108,19,218524,5
549,aloof,xluf,1,1,0,0,1,aloof,2,4,487,6,4,2,33,462,47,296583,5
17915,ulcer,^lsX,1,0,1,0,1,ulcer,2,4,393,6,11,4,131,405,20,1336605,5
5469,edition,IdIS|n,3,2,1,3,0,edition,3,6,581,8,5,2,249,8653,4227,110054045,7
8273,illegally,IligLi,1,0,1,0,1,illegally,4,7,547,8,3,0,113,2027,744,1887757,7
14561,remote,rImot,2,1,1,1,1,remote,2,5,464,7,3,3,713,7447,886,50689240,6
8042,hose,hoz,19,18,1,12,7,hose,1,3,496,5,143,46,411,1521,176,6909109,4
200,act,@kt,9,4,5,7,2,act,1,3,385,4,52,22,5565,42257,8275,141086424,4
9968,links,lIGks,3,2,1,2,1,links,1,5,408,5,29,21,141,5966,537,339944467,6
1585,basis,bes|s,1,1,0,1,0,basis,2,5,462,6,7,22,609,19218,3595,59902344,5
7085,genie,Jini,7,6,1,5,2,genie,2,4,398,6,65,4,178,369,47,1630386,5
8628,indent,IndEnt,2,2,0,2,0,indent,2,6,460,7,3,3,6,22,2,1569632,7
8875,insanity,Ins@n|ti,1,0,1,1,0,insanity,4,8,724,8,2,1,391,963,261,1924806,8
14673,resolution,rEzxluS|n,2,1,1,2,0,resolution,4,9,613,11,4,2,150,10802,3316,55431767,10
14693,rest,rEst,20,17,3,18,2,rest,1,4,416,5,56,42,10861,39764,8563,53317846,5
7267,gobbler,gablX,1,1,0,1,0,gobbler,2,5,619,8,9,7,16,366,2,101288,6
6268,faucet,fcs|t,1,1,0,1,0,faucet,2,5,529,7,6,3,73,547,53,1867270,6
15565,sherry,SEri,8,6,2,7,1,sherry,2,4,435,7,108,9,705,1526,269,2407286,5
4174,crescent,krEsNt,1,0,1,0,1,crescent,2,7,539,9,3,1,72,1184,107,4857264,8
9475,kick,kIk,28,23,5,18,10,kick,1,3,376,5,113,25,3744,7049,1273,12953188,4
9665,lard,lard,15,14,1,11,4,lard,1,4,589,5,41,25,86,277,16,423971,5
16249,stage,steJ,11,8,3,2,9,stage,1,4,517,6,21,16,2324,25716,5028,52519007,5
16050,spar,spar,12,8,4,3,9,spar,1,4,569,5,33,24,36,325,18,894464,5
2036,bondsman,bandzmxn,1,0,1,0,1,bondsman,2,8,848,6,1,0,26,57,18,143688,6
4321,curious,kyUrixs,2,1,1,1,1,curious,3,7,513,8,4,2,1337,6250,1563,8460088,8
19127,wolf,wUlf,3,1,2,0,3,wolf,1,4,382,5,10,16,1034,7581,2048,13004791,5
11005,modest,mad|st,1,0,1,1,0,modest,2,6,466,7,3,5,300,5996,649,5034633,7
12728,perforce,pXfors,1,1,0,0,1,perforce,2,6,660,7,1,0,3,69,3,570548,6
13670,pro,pro,14,10,4,8,6,pro,1,3,262,4,78,30,722,15640,3402,102596670,4
14232,rapidly,r@pxdli,1,1,0,1,0,rapidly,3,7,569,6,0,0,189,7852,809,11959135,6
8093,huge,hyuJ,2,1,1,0,2,huge,1,4,491,5,29,26,2467,27241,8026,70650187,5
10022,little,lItL,6,3,3,3,3,little,2,5,379,7,35,12,73766,178500,54969,187153377,6
11200,motto,mato,2,2,0,0,2,motto,2,4,369,6,35,11,260,1055,159,1894147,5
16419,storage,storIJ,1,1,0,1,0,storage,2,6,642,8,2,0,452,7433,410,81326166,6
5409,early,Rli,10,6,4,9,1,early,2,3,386,6,96,16,5510,80958,12985,100013871,4
13355,position,pxzIS|n,4,2,2,4,0,position,3,7,768,9,6,2,3676,38875,8646,87142870,8
8100,hum,h^m,25,24,1,15,10,hum,1,3,344,4,88,39,246,1205,83,3075078,4
17678,tremor,trEmX,1,1,0,0,1,tremor,2,5,344,7,14,2,41,351,16,645479,6
19150,woodsman,wUdzmxn,1,0,1,0,1,woodsman,2,7,479,8,1,2,23,78,5,170809,6
3056,child,CYld,4,3,1,3,1,child,1,4,418,6,18,7,8040,75235,16801,119753056,5
11431,navy,nevi,5,3,2,2,3,navy,2,4,430,5,28,11,1310,8542,2190,22021247,5
12340,panhandle,p@nh@ndL,1,1,0,1,0,panhandle,3,9,660,10,3,2,20,551,129,808323,10
16794,swarm,sworm,6,4,2,2,4,swarm,1,5,552,6,9,7,68,869,74,1158415,6
18733,wacky,w@ki,5,5,0,3,2,wacky,2,4,549,5,35,5,164,530,145,1865275,4
17523,total,totL,8,7,1,5,3,total,2,5,360,6,24,5,1920,36835,3533,222656847,6
13345,portly,portli,2,2,0,2,0,portly,2,6,444,6,6,1,8,195,9,95046,6
18766,wake,wek,26,22,4,18,8,wake,1,3,354,5,90,31,5366,10784,2244,14121621,4
5381,dutch,d^C,15,14,1,5,10,dutch,1,3,356,6,63,12,761,4651,354,19001677,4
10046,load,lod,27,24,3,16,11,load,1,3,379,5,100,18,1490,6907,548,37899135,4
14299,reading,ridIG,1,1,0,1,0,reading,2,5,403,8,25,13,3133,36057,4207,95293931,6
18834,water,wctX,3,2,1,1,2,water,2,4,323,6,24,26,11478,105096,11400,215184660,5
18762,wait,wet,27,22,5,18,9,wait,1,3,390,5,91,32,42343,30118,11036,39005783,4
19073,wine,wYn,30,26,4,21,9,wine,1,3,439,5,118,46,3078,16427,1386,58493416,4
18546,vigil,vIJL,2,2,0,0,2,vigil,2,5,463,6,6,2,44,757,221,1183443,6
13395,posy,pozi,11,8,3,6,5,posy,2,4,382,4,27,15,9,12,1,189674,4
6759,frail,frel,11,8,3,6,5,frail,1,4,579,6,47,9,81,1090,119,703525,5
2145,brass,br@s,10,8,2,4,6,brass,1,4,489,6,48,18,618,2995,208,14299336,5
6177,fair,fEr,28,22,6,20,8,fair,1,3,444,5,134,19,4832,21205,7057,49512893,4
16264,stall,stcl,10,9,1,3,7,stall,1,4,515,6,48,14,457,1524,163,2114837,5
14056,quaint,kwent,2,0,2,1,1,quaint,1,5,446,7,4,3,111,840,83,1102986,6
8066,housecoat,hWskot,1,1,0,0,1,housecoat,2,6,546,7,1,1,6,70,1,15194,5
7902,hill,hIl,33,31,2,23,10,hill,1,3,442,5,109,33,1915,23005,5740,64012203,4
6178,fairy,f@ri,14,11,3,11,3,fairy,2,4,469,6,131,10,851,2165,351,6437994,5
15108,same,sem,21,19,2,13,8,same,1,3,441,5,72,32,21276,141764,30827,234832782,4
17056,teeth,tiT,12,11,1,5,7,teeth,1,3,312,6,59,6,2440,10657,1049,9769437,3
11156,morphine,morfin,2,2,0,0,2,morphine,2,6,558,8,4,2,331,593,85,1284519,6
10564,mature,mxCUr,1,1,0,1,0,mature,2,5,579,7,2,7,419,3918,423,73898047,6
16495,strong,strcG,3,2,1,0,3,strong,1,5,592,7,12,7,4430,43155,9430,60970401,6
7743,heaven,hEvxn,4,4,0,4,0,heaven,2,5,346,7,37,10,2887,6211,1048,19975432,6
5200,dosage,dosIJ,1,1,0,1,0,dosage,2,5,517,7,2,2,102,526,48,5718176,5
87,abstain,xbsten,1,0,1,1,0,abstain,2,6,646,8,3,0,26,254,41,857265,7
6699,form,form,15,11,4,4,11,form,1,4,409,5,43,22,2180,45078,4500,201400893,5
15015,runway,r^nwe,1,0,1,0,1,runway,2,5,505,7,6,2,279,2119,489,2901827,6
10746,metallic,mxt@lIk,1,0,1,1,0,metallic,3,7,550,9,2,1,67,1303,62,6216751,8
9192,irrational,Ir@SNL,1,0,1,1,0,irrational,4,8,754,11,2,0,149,1221,247,1336826,9
13129,plead,plid,8,7,1,1,7,plead,1,4,355,6,24,8,357,1114,458,1125870,5
6750,foxed,fakst,2,1,1,1,1,foxed,1,5,596,5,9,4,3,20,0,56533,6
16210,spy,spY,15,6,9,5,10,spy,1,3,469,4,37,13,1023,2699,709,20031037,4
18788,want,wcnt,9,8,1,8,1,want,1,4,369,5,36,39,140718,206436,91546,258707826,5
18992,whither,hwIDX,3,1,2,2,1,whither,2,4,379,6,29,12,18,108,11,564313,5
7080,genetic,J|nEtIk,1,1,0,0,1,genetic,3,7,528,8,4,2,385,7993,982,16039375,8
13965,pup,p^p,21,17,4,11,10,pup,1,3,258,4,44,22,164,703,41,1569421,4
17218,theorem,TIrM,2,2,0,1,1,theorem,2,5,430,8,3,1,17,479,21,8569908,4
13832,protein,protin,1,1,0,0,1,protein,2,6,536,8,6,3,230,8480,355,53260540,7
17502,torn,torn,16,14,2,9,7,torn,1,4,347,5,54,29,553,4274,563,3571832,5
10667,member,mEmbX,1,0,1,1,0,member,2,5,453,7,8,5,1468,29745,6788,283863609,6
15065,safe,sef,11,10,1,3,8,safe,1,3,490,5,40,16,7303,22748,5916,63175739,4
11235,mug,m^g,21,19,2,11,10,mug,1,3,425,4,61,23,349,1822,153,5114862,4
2181,brew,bru,17,11,6,9,8,brew,1,3,391,5,77,17,128,861,65,2382584,4
50,abnormally,@bnormLi,1,0,1,0,1,abnormally,4,9,575,9,1,0,20,216,23,505747,9
17253,thicket,TIk|t,4,4,0,3,1,thicket,2,5,330,8,8,6,24,478,23,289971,5
3466,colonist,kalxn|st,1,0,1,0,1,colonist,3,8,551,9,1,1,3,92,4,181543,9
10983,moan,mon,27,24,3,19,8,moan,1,3,546,5,114,28,96,590,22,1030590,4
9951,lineal,lIniL,2,2,0,0,2,lineal,3,6,509,6,5,2,0,54,2,201862,6
15728,sir,sR,23,15,8,7,16,sir,1,2,519,4,141,36,49188,16252,5576,20341429,3
14702,restrain,rIstren,1,0,1,0,1,restrain,2,7,565,9,4,4,78,716,137,797613,8
12259,paean,pian,3,1,2,1,2,paean,2,4,668,6,29,3,3,109,0,80694,5
3687,confess,kxnfEs,1,0,1,0,1,confess,2,6,625,8,3,1,808,1501,377,1851099,7
7375,grating,gretIG,2,1,1,1,1,grating,2,6,377,8,14,12,16,346,13,894474,7
3291,cliff,klIf,5,5,0,0,5,cliff,1,4,422,6,31,10,1100,3549,489,5900708,5
3505,comfort,k^mfXt,2,1,1,0,2,comfort,2,6,432,8,2,2,878,8280,1010,27922133,7
15915,snuggle,sn^gL,3,2,1,1,2,snuggle,2,6,511,8,3,2,66,170,14,389398,7
516,allergy,@lXJi,1,0,1,0,1,allergy,3,5,460,7,5,0,86,1229,132,6453834,6
7767,heinous,hen|s,1,0,1,1,0,heinous,2,5,501,6,8,0,82,422,170,394183,5
15186,savor,sevX,8,6,2,3,5,savor,2,4,480,6,52,11,48,648,44,511915,5
15272,scowl,skWl,8,6,2,1,7,scowl,1,4,616,6,19,2,26,430,8,117133,5
15258,scorch,skorC,2,1,1,0,2,scorch,1,5,513,7,9,2,24,123,6,220189,6
3496,comeback,k^mb@k,1,1,0,1,0,comeback,2,6,534,9,4,1,170,1882,526,1855190,7
18457,versed,vRst,10,8,2,8,2,versed,1,4,543,6,35,4,56,346,43,553351,5
9720,lawsuit,lcsut,1,0,1,0,1,lawsuit,2,5,483,8,4,1,311,4378,1427,6381548,6
11038,moll,mal,16,14,2,10,6,moll,1,3,360,5,129,33,20,99,14,487830,4
15689,silver,sIlvX,1,1,0,1,0,silver,2,5,504,7,17,13,1619,12277,947,74079703,6
14886,rocker,rakX,4,3,1,2,2,rocker,2,4,412,7,52,21,64,819,114,2324259,5
4082,coven,k^vxn,2,1,1,1,1,coven,2,5,459,6,19,25,30,78,3,295821,6
9596,ladder,l@dX,10,7,3,4,6,ladder,2,4,466,7,44,13,472,2968,317,5508719,5
6735,foster,fcstX,2,2,0,2,0,foster,2,5,639,7,19,19,613,8722,1112,15478056,6
11542,newt,nut,26,24,2,19,7,newt,1,3,495,5,72,14,68,3194,1955,984917,4
5871,etch,EC,15,11,4,7,8,etch,1,2,315,5,66,10,10,161,22,751420,3
8427,import,Import,2,2,0,0,2,import,2,6,601,7,5,3,111,2659,318,28633666,7
11345,mystique,mIstik,2,1,1,0,2,mystique,2,6,418,6,6,0,179,541,65,742116,6
8772,informal,InformL,3,1,2,0,3,informal,3,8,562,9,2,1,86,3775,215,8143817,9
12085,otter,atX,6,4,2,6,0,otter,2,3,353,6,43,19,69,450,64,1662335,4
9625,lamp,l@mp,11,8,3,9,2,lamp,1,4,480,5,41,30,657,2745,97,14645684,5
5284,drivel,drIvL,3,3,0,1,2,drivel,2,6,449,6,5,4,36,93,10,433762,6
16747,surgeon,sRJ|n,3,2,1,3,0,surgeon,2,5,530,8,15,6,838,3862,903,5350136,6
2797,cave,kev,22,19,3,12,10,cave,1,3,470,5,75,36,713,4364,413,7669404,4
11179,mosquito,mxskito,1,0,1,0,1,mosquito,3,7,532,9,3,1,93,1231,133,2664788,8
12564,pattern,p@tXn,3,1,2,2,1,pattern,2,5,382,8,14,4,738,13055,1370,34126320,6
4281,cue,kyu,12,7,5,9,3,cue,1,3,284,4,61,36,397,1974,204,3812461,4
8538,incisor,InsYzX,3,2,1,0,3,incisor,3,6,615,8,4,1,8,37,1,90895,7
850,apathy,@pxTi,2,2,0,0,2,apathy,3,5,574,6,1,0,24,498,65,864296,5
11537,newly,nuli,3,3,0,2,1,newly,2,4,480,6,46,8,140,7680,684,21102330,5
5724,entrance,Entrxns,1,1,0,0,1,entrance,2,7,649,9,2,2,800,6296,340,12611220,8
7700,haven,hevxn,3,3,0,3,0,haven,2,5,569,6,41,23,18844,3282,709,10570189,6
15534,sharp,Sarp,5,4,1,2,3,sharp,1,4,466,6,38,17,1213,11487,987,24906789,5
4450,dash,d@S,15,14,1,12,3,dash,1,3,424,5,59,27,308,2168,177,6360580,4
7294,goose,gus,12,11,1,9,3,goose,1,3,437,6,49,18,665,1695,185,3739646,4
13014,pinch,pInC,10,6,4,7,3,pinch,1,4,422,6,29,13,312,2256,188,2082769,5
8925,instant,Instxnt,2,2,0,1,1,instant,2,7,520,8,1,0,550,7029,770,28602581,8
13799,propriety,prxprYxti,1,1,0,0,1,propriety,4,9,655,9,1,0,20,466,52,578062,9
13903,public,p^blIk,1,1,0,0,1,public,2,6,390,7,5,3,3625,112519,23770,349292858,7
14666,resignation,rEzIgneS|n,1,1,0,1,0,resignation,4,10,708,12,3,3,191,2180,626,2560942,11
16127,spiral,spYrL,2,1,1,0,2,spiral,2,6,537,7,5,3,91,2392,160,4382247,7
3099,choir,kwYX,3,3,0,1,2,choir,2,4,492,6,17,3,271,2493,444,5156448,5
220,adamant,@dxmxnt,1,1,0,1,0,adamant,3,7,609,8,0,0,50,716,160,510991,8
7917,hip,hIp,28,27,1,19,9,hip,1,3,280,4,68,30,786,7043,914,26833132,4
15550,shed,SEd,17,16,1,14,3,shed,1,3,453,5,62,23,560,4612,573,6721387,4
18824,washer,wcSX,3,2,1,0,3,washer,2,4,536,7,16,14,104,519,42,5545568,5
15101,salute,sxlut,3,3,0,2,1,salute,2,5,581,7,5,3,370,1087,215,1829803,6
315,advise,xdvYz,1,1,0,0,1,advise,2,5,627,7,4,6,622,1955,471,8325087,6
12787,person,pRsN,4,2,2,1,3,person,2,5,449,7,25,19,10857,67736,21357,146754599,6
16772,suspense,s|spEns,1,1,0,0,1,suspense,2,7,676,9,3,0,114,644,132,4181909,8
18734,wad,wad,22,17,5,17,5,wad,1,3,337,4,70,38,89,570,24,577013,4
9901,life,lYf,20,18,2,9,11,life,1,3,394,5,54,24,40629,185450,42022,306574576,4
19016,wick,wIk,26,23,3,16,10,wick,1,3,333,5,119,29,128,393,25,1224557,4
2058,boost,bust,9,8,1,8,1,boost,1,4,459,6,29,12,230,5197,714,13675504,5
15268,scour,skWr,7,5,2,1,6,scour,2,4,640,6,14,7,31,274,36,411478,5
9372,journal,JRnL,3,3,0,2,1,journal,2,5,360,8,13,2,453,22955,2136,114537279,6
11777,oat,ot,25,14,11,16,9,oat,1,2,435,4,81,41,27,373,86,769187,3
9490,kin,kIn,33,28,5,23,10,kin,1,3,286,4,170,45,218,1805,81,2338460,4
7797,hem,hEm,16,13,3,8,8,hem,1,3,543,4,85,36,42,763,30,2066207,4
14037,quad,kwad,8,5,3,4,4,quad,1,4,418,5,21,13,79,636,29,6024409,5
6226,farm,farm,6,4,2,4,2,farm,1,4,529,5,33,14,1532,14826,1721,47938031,5
1304,austere,cstIr,1,0,1,1,0,austere,2,5,551,8,4,1,11,496,27,302230,6
6222,farce,fars,6,5,1,3,3,farce,1,4,501,5,32,9,89,446,80,727546,5
8677,induce,Indus,1,0,1,1,0,induce,2,5,708,7,2,3,82,1162,92,2891148,6
15102,salvage,s@lvIJ,2,1,1,2,0,salvage,2,6,587,8,2,6,210,1110,162,2627328,6
4597,degree,dxgri,3,2,1,3,0,degree,2,5,422,7,10,5,759,23803,3413,67030979,6
438,air,Er,30,13,17,19,11,air,1,2,322,4,154,35,7090,69259,13508,160853049,3
6910,fuss,f^s,9,8,1,6,3,fuss,1,3,501,5,57,27,364,1259,187,1475689,4
13475,precept,prisEpt,1,0,1,0,1,precept,2,7,510,8,2,2,7,173,7,482252,8
9517,kite,kYt,20,19,1,19,1,kite,1,3,316,5,81,21,117,703,49,2809317,4
11943,opal,opL,5,4,1,4,1,opal,2,4,402,5,21,8,52,316,19,2488232,5
13935,pulp,p^lp,4,3,1,1,3,pulp,1,4,286,5,8,8,93,1166,46,3861448,5
18791,war,wor,29,20,9,19,10,war,1,3,379,4,121,46,8912,104024,32913,126526108,4
5262,dread,drEd,8,6,2,6,2,dread,1,4,345,6,21,10,128,1454,108,1651326,5
19092,wish,wIS,13,11,2,5,8,wish,1,3,352,5,72,26,11991,17820,4726,74054528,4
12093,out,Wt,18,8,10,15,3,out,1,2,296,4,48,36,197131,586130,167454,741609797,3
2322,bunker,b^GkX,4,3,1,2,2,bunker,2,5,442,7,18,17,239,1276,302,1914784,6
16972,tanker,t@GkX,7,4,3,5,2,tanker,2,5,432,7,22,19,100,673,204,1278916,6
12449,parole,pXol,1,0,1,1,0,parole,2,4,556,7,18,6,533,1897,755,2588422,5
11191,motion,moS|n,6,4,2,6,0,motion,2,5,571,7,25,10,967,10682,1023,43930751,6
15738,six,sIks,8,7,1,5,3,six,1,4,472,4,74,30,10176,68004,14427,71373283,5
4822,devitalize,divYtxlYz,1,1,0,1,0,devitalize,4,9,988,7,1,1,0,1,0,2264,5
5012,disillusion,dIsxluZ|n,1,1,0,0,1,disillusion,4,9,848,12,1,0,12,87,13,86391,10
660,amplifier,@mplxfYX,1,0,1,0,1,amplifier,4,8,682,10,4,3,16,238,15,6449709,9
6955,galley,g@li,13,10,3,11,2,galley,2,4,444,7,86,26,82,639,26,1031511,5
15780,slap,sl@p,17,15,2,5,12,slap,1,4,376,5,30,19,636,1801,347,2008237,5
9998,lit,lIt,37,26,11,23,14,lit,1,3,306,4,99,44,496,5763,393,7015512,4
17700,tribute,trIbyut,1,1,0,0,1,tribute,2,7,483,8,4,2,267,2768,666,8374804,8
9819,lent,lEnt,17,15,2,11,6,lent,1,4,453,5,56,38,190,1329,148,1898355,5
15715,singe,sInJ,7,5,2,4,3,singe,1,4,503,6,24,20,13,49,4,110115,5
18533,victorious,vIktorixs,1,0,1,0,1,victorious,4,9,665,8,4,0,66,792,93,950493,9
4089,cow,kW,19,15,4,10,9,cow,1,2,278,4,115,44,1301,3428,411,8270235,3
7810,hen,hEn,24,20,4,16,8,hen,1,3,320,4,144,56,163,763,56,3742337,4
8423,imply,ImplY,1,1,0,0,1,imply,2,5,639,6,3,4,137,1928,160,4491299,6
1498,bane,ben,32,28,4,23,9,bane,1,3,449,5,174,47,94,336,12,737796,4
11181,most,most,13,12,1,11,2,most,1,4,540,5,39,30,17889,280072,50339,416219900,5
7341,grammar,gr@mX,3,1,2,2,1,grammar,2,5,449,7,25,1,122,1434,97,8019520,5
19159,word,wRd,19,18,1,12,7,word,1,3,358,5,66,22,12013,45192,11243,98677453,4
5478,effect,IfEkt,3,2,1,3,0,effect,2,5,512,7,4,5,1219,38588,6412,75595104,6
16157,spoiled,spOld,3,2,1,1,2,spoiled,1,5,556,7,7,2,432,1213,174,1403276,5
973,arbitrator,arbxtretX,1,0,1,0,1,arbitrator,4,9,598,11,2,1,4,242,30,1503052,10
8360,impale,Impel,1,1,0,0,1,impale,2,5,506,7,3,3,17,40,4,55610,6
12218,owl,Wl,15,10,5,13,2,owl,1,2,343,4,61,14,286,1467,134,5013390,3
10626,mediator,midietX,1,0,1,0,1,mediator,4,7,607,9,2,1,15,806,149,1766824,8
145,accrue,xkru,2,1,1,2,0,accrue,2,4,459,7,10,2,4,323,17,934795,5
17376,tin,tIn,30,25,5,21,9,tin,1,3,345,4,109,42,441,2544,198,10703096,4
17131,tentacle,tEntIkL,1,1,0,1,0,tentacle,3,8,546,9,1,1,13,157,4,613311,9
14300,ready,rEdi,6,4,2,4,2,ready,2,4,419,6,70,18,19778,34303,9013,62670709,5
14885,rock,rak,23,20,3,19,4,rock,1,3,425,5,153,31,4394,26183,3994,95514044,4
17728,trio,trio,4,2,2,1,3,trio,2,4,439,5,16,10,66,1980,187,7204459,5
3596,composition,kampxzIS|n,1,1,0,0,1,composition,4,10,679,12,2,1,124,5593,201,15941438,11
18436,verge,vRJ,9,7,2,5,4,verge,1,3,540,6,19,12,167,1845,414,1423819,4
17477,took,tUk,18,18,0,17,1,took,1,3,326,5,46,18,17454,92405,18857,66298949,4
12400,paranoia,p@rxnOx,1,1,0,0,1,paranoia,4,7,544,9,1,2,136,846,114,1235018,7
12922,photography,fxtagrxfi,1,1,0,0,1,photography,4,9,668,11,1,2,198,4670,247,55086966,9
980,arcade,arked,1,1,0,0,1,arcade,2,5,523,7,5,3,111,520,44,15553059,6
3990,correlation,kcrxleS|n,2,2,0,2,0,correlation,4,9,788,12,2,1,29,4357,126,7923985,10
6790,freeze,friz,7,5,2,2,5,freeze,1,4,539,7,70,5,1640,4311,691,5527632,5
14482,region,riJ|n,2,1,1,1,1,region,2,5,585,7,20,2,256,26608,4141,102554469,6
1072,art,art,13,4,9,8,5,art,1,3,324,4,67,43,3611,55350,4211,214704717,4
14756,revile,rIvYl,3,3,0,0,3,revile,2,5,496,7,5,8,7,35,4,54812,6
3965,cornet,kornEt,1,1,0,0,1,cornet,2,6,311,7,6,10,11,77,8,471301,7
3826,contend,kxntEnd,1,1,0,0,1,contend,2,7,688,8,5,4,48,2244,183,1561719,8
14478,regiment,rEJ|mxnt,1,0,1,0,1,regiment,3,8,633,9,3,3,247,1085,83,3650932,9
9179,ire,Yr,21,8,13,15,6,ire,1,2,340,4,87,38,14,454,33,1799748,3
16822,swindle,swIndL,2,2,0,2,0,swindle,2,7,554,8,8,9,36,305,201,255565,8
7657,harem,h@rM,4,3,1,2,2,harem,2,5,363,5,18,7,45,300,25,435962,5
17126,tense,tEns,12,9,3,6,6,tense,1,4,399,6,35,9,522,2815,549,2320926,5
1293,aura,crx,2,2,0,1,1,aura,2,3,390,5,74,22,93,1311,108,2267302,4
13236,polite,pxlYt,3,1,2,2,1,polite,2,5,433,7,6,7,711,2574,347,2171712,6
430,ahead,xhEd,2,1,1,2,0,ahead,2,4,471,5,3,3,10115,34433,15530,28377865,3
194,acrobatics,@krxb@tIks,1,0,1,0,1,acrobatics,4,10,662,10,1,2,11,127,12,205213,10
716,angel,enJL,1,0,1,0,1,angel,2,5,476,6,3,18,3992,4613,703,25311345,6
17578,train,tren,15,12,3,9,6,train,1,4,379,6,56,19,4848,15402,2476,31819599,5
2989,chauffeur,SofX,1,1,0,1,0,chauffeur,2,4,564,10,38,2,287,408,43,821561,5
4092,cower,kWX,9,7,2,5,4,cower,2,3,370,6,62,28,16,115,13,96406,4
17365,timbre,t@mbX,4,3,1,3,1,timbre,2,5,428,6,7,1,7,270,6,284652,6
2428,cage,keJ,17,15,2,8,9,cage,1,3,414,5,65,26,1034,3380,379,6361342,4
7398,greed,grid,12,11,1,3,9,greed,1,4,439,6,54,11,245,1836,511,1997460,5
11023,moisten,mOsN,2,2,0,1,1,moisten,2,5,445,8,10,0,4,168,14,129303,6
4027,cot,kat,35,30,5,24,11,cot,1,3,389,4,134,53,102,583,30,1812593,4
2925,chandelier,S@ndxlIr,1,1,0,1,0,chandelier,3,8,728,11,2,1,72,607,43,1624310,8
7500,guise,gYz,10,8,2,6,4,guise,1,3,453,6,95,10,28,646,63,767344,4
1357,avert,xvRt,5,4,1,3,2,avert,2,4,412,6,9,13,30,658,108,767636,5
10443,margarine,marJXxn,1,1,0,0,1,margarine,3,7,579,8,1,0,32,877,23,816072,6
9818,lens,lEnz,4,3,1,2,2,lens,1,4,433,5,88,42,238,3813,296,22745130,5
15876,smug,sm^g,8,6,2,3,5,smug,1,4,412,5,9,5,122,637,49,463973,5
1933,blizzard,blIzXd,1,0,1,1,0,blizzard,2,6,599,9,2,2,99,1034,165,2061632,7
4388,dab,d@b,14,12,2,10,4,dab,1,3,404,4,58,42,57,502,49,1986261,4
1369,avocation,@vxkeS|n,1,1,0,1,0,avocation,4,8,698,6,3,3,9,89,8,64500,5
12790,personal,pRsNL,1,0,1,0,1,personal,3,7,479,9,1,3,4675,43770,7609,214674578,8
2451,calendar,k@l|ndX,1,1,0,1,0,calendar,3,7,605,9,7,1,363,2933,402,101304874,8
13013,pincer,pInCX,3,1,2,2,1,pincer,2,5,465,7,9,10,13,62,8,56963,6
15850,smart,smart,2,1,1,2,0,smart,1,5,483,6,7,8,4909,12793,3306,36653770,6
3033,chew,Cu,20,19,1,18,2,chew,1,2,404,5,135,25,462,1120,177,1948216,3
9314,jerk,JRk,11,10,1,10,1,jerk,1,3,409,5,61,13,1690,1740,306,2741561,4
1053,arouse,xrWz,4,3,1,3,1,arouse,2,3,709,7,44,11,62,383,35,430328,4
8151,hustle,h^sL,8,8,0,5,3,hustle,2,5,421,7,35,7,402,700,120,1754467,6
16516,stucco,st^ko,1,0,1,0,1,stucco,2,5,525,7,8,0,19,500,10,618601,6
7793,help,hElp,11,8,3,3,8,help,1,4,275,5,28,16,46977,115809,27922,611083850,5
6091,extant,Ekst|nt,1,0,1,1,0,extant,2,7,419,4,2,2,6,571,6,659214,7
2083,botch,baC,13,11,2,6,7,botch,1,3,395,6,81,12,16,63,16,98745,4
16051,spare,spEr,13,12,1,5,8,spare,1,4,470,6,39,22,1573,4115,481,10009727,5
16506,struggle,str^gL,1,1,0,0,1,struggle,2,7,555,9,5,3,682,12308,2289,10637741,8
15664,sign,sYn,31,24,7,24,7,sign,1,3,526,5,110,9,6797,25474,5491,242300906,4
8062,hour,Wr,11,7,4,8,3,hour,2,2,375,5,102,28,8277,42478,12710,71767668,3
8842,inmost,Inmost,1,0,1,1,0,inmost,2,6,599,5,1,1,5,29,0,95584,5
7957,hold,hold,13,11,2,10,3,hold,1,4,446,5,61,30,22273,38567,9252,63783219,5
10197,lush,l^S,16,12,4,10,6,lush,1,3,431,5,52,27,60,1835,74,2660423,4
16207,spurt,spRt,12,10,2,2,10,spurt,1,4,434,6,25,7,19,309,21,332717,5
17292,threat,TrEt,3,3,0,1,2,threat,1,4,473,7,15,6,1059,17616,4961,18546787,5
10733,mess,mEs,18,17,1,14,4,mess,1,3,509,5,93,28,3985,6870,1710,7013956,4
5512,elect,xlEkt,4,1,3,3,1,elect,2,5,597,6,9,4,72,4043,2360,5748899,6
869,apogee,@pxJi,2,2,0,0,2,apogee,3,5,524,4,3,0,4,148,1,605076,4
17510,torrent,tcrxnt,1,1,0,1,0,torrent,2,6,438,8,11,4,21,535,31,4500344,7
14310,realtor,riLtX,1,1,0,0,1,realtor,2,5,610,8,4,3,92,402,83,5962026,6
3711,confuse,kxnfyuz,1,1,0,0,1,confuse,2,7,682,8,1,2,243,990,172,1595533,8
14842,rinse,rIns,5,4,1,4,1,rinse,1,4,619,5,32,10,120,1405,50,1885846,5
18829,wassail,wasL,8,8,0,3,5,wassail,2,5,452,5,0,1,2,15,1,62349,4
15501,sextant,sEkst|nt,2,0,2,1,1,sextant,2,8,644,5,2,1,8,41,3,192186,8
19281,yourself,yXsElf,1,1,0,1,0,yourself,2,6,574,9,2,2,22151,26812,7714,51545456,4
3553,commute,kxmyut,1,0,1,0,1,commute,2,6,413,8,4,6,45,1042,140,1754751,7
2144,brash,br@S,11,9,2,5,6,brash,1,4,478,6,35,15,21,452,62,461753,5
1358,avian,evixn,1,1,0,1,0,avian,3,5,401,6,5,7,4,628,107,2877167,6
15475,service,sRvxs,2,2,0,2,0,service,2,5,569,8,12,6,4076,57394,7761,519544740,6
2115,bowman,bomxn,5,3,2,5,0,bowman,2,5,539,7,77,12,182,954,89,2396180,6
2905,chalice,C@lxs,5,5,0,5,0,chalice,2,5,478,6,19,0,32,178,7,413313,5
7643,happen,h@pxn,2,2,0,2,0,happen,2,5,394,7,33,7,12968,35296,16973,27208385,6
5508,elate,xlet,11,9,2,5,6,elate,2,4,459,6,16,16,0,7,0,22189,5
7883,hid,hId,25,23,2,15,10,hid,1,3,368,4,63,30,596,1921,255,2213796,4
1248,attention,xtEnC|n,2,1,1,2,0,attention,3,7,639,10,3,1,5032,41457,7792,44754701,8
7602,halt,hclt,8,6,2,5,3,halt,1,4,366,5,38,26,575,2938,431,2950802,5
18908,wet,wEt,29,22,7,18,11,wet,1,3,268,4,88,32,2000,9732,760,23927395,4
1889,blanch,bl@nC,3,3,0,2,1,blanch,1,5,434,7,6,8,13,225,10,201559,6
15094,saloon,sxlun,2,2,0,1,1,saloon,2,5,492,7,11,6,262,631,36,2961006,6
14191,raise,rez,30,22,8,17,13,raise,1,3,443,6,186,17,2815,18470,5590,21100669,4
123,accident,@ks|d|nt,1,1,0,0,1,accident,3,8,668,9,3,2,4146,9992,2929,18700748,9
14017,putt,p^t,29,25,4,18,11,putt,1,3,325,5,73,24,58,861,41,919086,4
18543,view,vyu,6,5,1,6,0,view,1,3,278,5,42,8,1965,46665,8859,602282940,4
19012,whose,huz,16,14,2,11,5,whose,1,3,483,5,129,7,3187,45225,4547,43635895,4
715,anew,xnu,4,2,2,3,1,anew,2,4,413,4,8,8,44,866,90,890428,5
2287,buggy,b^gi,5,4,1,3,2,buggy,2,4,328,5,43,10,127,559,54,1955438,5
3138,chronicle,kranIkL,1,0,1,0,1,chronicle,3,8,538,10,6,3,80,5496,182,6939347,9
2947,chapter,C@ptX,2,1,1,2,0,chapter,2,5,468,8,7,3,604,8897,1082,87884703,6
3264,claw,klc,9,5,4,3,6,claw,1,3,388,5,37,16,223,885,43,1889661,4
10558,matter,m@tX,16,13,3,13,3,matter,2,4,391,7,63,31,18900,51357,13525,66637256,5
7432,grit,grIt,12,9,3,1,11,grit,1,4,412,5,48,16,48,897,79,1282250,5
42,ablaze,xblez,1,0,1,1,0,ablaze,2,5,658,4,7,1,21,313,39,321927,4
7055,gem,JEm,9,8,1,6,3,gem,1,3,361,4,61,20,126,823,63,6156692,4
2259,brutal,brutL,3,1,2,1,2,brutal,2,6,343,7,8,0,375,3409,1024,5675803,7
9284,jam,J@m,16,15,1,12,4,jam,1,3,451,4,72,35,690,2827,328,12474057,4
14116,quit,kwIt,17,12,5,5,12,quit,1,4,313,5,34,16,4595,6975,1627,10325898,5
11873,odyssey,ad|si,1,1,0,0,1,odyssey,3,5,477,8,4,0,45,975,153,4493747,6
9535,knife,nYf,8,7,1,4,4,knife,1,3,390,6,36,3,2387,8136,1014,11299263,4
10127,lost,lcst,9,7,2,6,3,lost,1,4,555,4,21,32,13974,54622,13166,74759559,4
10051,loathe,loD,13,11,2,3,10,loathe,1,3,544,7,40,4,106,275,52,346325,4
14356,recite,rIsYt,3,1,2,0,3,recite,2,5,428,7,7,4,153,658,66,673052,6
12254,paddle,p@dL,10,8,2,6,4,paddle,2,5,459,7,31,8,191,1078,51,2316636,6
8090,huddle,h^dL,7,7,0,5,2,huddle,2,5,382,7,26,8,111,698,44,339922,6
16466,stretch,strEC,1,1,0,0,1,stretch,1,5,525,8,10,1,748,7455,896,11464708,6
14849,ripple,rIpL,7,4,3,4,3,ripple,2,5,312,7,38,14,77,906,122,1198877,6
6719,forth,forT,9,8,1,1,8,forth,1,4,441,6,41,18,804,12166,3359,20149609,5
17393,tiny,tYni,7,6,1,5,2,tiny,2,4,358,4,43,13,1643,17174,1788,17301787,5
4790,detective,dItEktIv,1,1,0,1,0,detective,3,8,599,10,6,2,3117,5693,1917,5353706,9
15744,skate,sket,11,10,1,5,6,skate,1,4,519,6,31,10,301,958,130,4934424,5
4721,deprivation,dEprxveS|n,2,1,1,1,1,deprivation,4,10,878,12,3,3,40,1176,125,1731701,11
15907,snore,snor,9,6,3,6,3,snore,1,4,539,5,22,10,82,207,26,294125,5
18263,vacation,vekeS|n,2,2,0,2,0,vacation,3,7,659,9,4,2,1673,6409,1676,54947049,8
2005,bogus,bog|s,1,1,0,1,0,bogus,2,5,471,6,8,9,138,699,207,1903710,6
18534,victory,vIktXi,1,0,1,0,1,victory,3,6,495,7,8,2,1094,14089,3225,16330347,7
6176,faint,fent,7,5,2,5,2,faint,1,4,412,6,26,9,473,3679,131,2567484,5
15320,seaman,simxn,4,4,0,4,0,seaman,2,5,505,7,72,10,86,409,66,988079,6
12268,pain,pen,32,29,3,22,10,pain,1,3,381,5,125,37,4995,24976,4168,42189492,4
17689,trial,trYL,10,7,3,0,10,trial,1,4,411,6,24,7,2518,21847,9036,56548156,5
5902,eureka,yUrikx,1,0,1,0,1,eureka,3,6,649,5,0,1,75,438,32,3446114,5
9165,inward,InwXd,1,0,1,0,1,inward,2,5,579,7,10,4,40,1295,76,1620214,6
1255,attitude,@t|tud,3,0,3,3,0,attitude,3,6,628,9,4,3,1330,11298,1842,12331660,7
18744,wage,weJ,17,13,4,8,9,wage,1,3,376,5,53,32,159,4863,897,12243196,4
9943,limp,lImp,10,6,4,6,4,limp,1,4,337,5,27,18,187,1542,48,2353736,5
7644,happily,h@pxli,1,0,1,1,0,happily,3,6,533,6,2,0,521,3335,419,3261766,6
3088,chive,CYv,8,8,0,6,2,chive,1,3,408,6,16,7,0,94,0,116544,4
9532,knelt,nElt,11,9,2,8,3,knelt,1,4,345,5,38,1,19,1248,29,434747,4
12718,perennial,pXEniL,1,1,0,0,1,perennial,4,7,545,10,3,1,15,1502,63,2169281,8
15277,scratch,skr@C,2,2,0,0,2,scratch,1,5,606,8,7,1,961,2826,410,7458884,6
14982,ruin,ruIn,1,0,1,0,1,ruin,2,4,519,5,38,15,1455,2437,430,2879219,5
15797,sleek,slik,12,10,2,6,6,sleek,1,4,499,6,26,8,43,1837,66,2735773,5
10879,mink,mIGk,13,11,2,11,2,mink,1,4,329,5,58,35,189,435,58,1000653,5
4039,cough,kcf,11,7,4,4,7,cough,1,3,389,6,78,14,448,1877,180,3451640,4
13070,pivot,pIvxt,4,3,1,4,0,pivot,2,5,235,6,7,3,23,647,98,1736745,6
10485,marsh,marS,10,8,2,1,9,marsh,1,4,432,6,46,18,179,1939,200,5073104,5
8091,huff,h^f,18,18,0,9,9,huff,1,3,334,5,56,16,67,586,65,1013391,4
12524,pasty,p@sti,8,5,3,4,4,pasty,2,5,481,5,11,13,31,187,13,234413,5
8968,intake,Intek,1,1,0,0,1,intake,2,5,676,5,0,0,66,2647,127,8146400,5
14796,rib,rIb,19,18,1,8,11,rib,1,3,343,4,70,28,301,1322,121,2745230,4
9807,lemming,lEmIG,1,0,1,1,0,lemming,2,5,372,8,17,8,6,83,4,209807,6
4395,dad,d@d,21,18,3,16,5,dad,1,3,338,4,73,49,25870,21958,5221,15150692,4
1106,ascertain,@sXten,1,1,0,1,0,ascertain,3,6,655,10,1,0,49,718,72,1629085,7
11455,necklace,nEklxs,2,2,0,2,0,necklace,2,6,609,9,6,1,497,2081,152,9493394,7
19175,worry,wRi,12,10,2,4,8,worry,2,3,479,6,65,10,14638,16900,4473,13244897,4
1081,article,artIkL,2,1,1,2,0,article,3,7,479,8,4,4,998,27442,2006,181971412,8
10181,lump,l^mp,13,10,3,13,0,lump,1,4,399,5,29,23,181,1767,201,2953000,5
11874,of,xv,4,1,3,1,3,of,1,2,370,3,32,32,590439,6670388,1244477,13151942776,3
19046,willing,wIlIG,5,5,0,5,0,willing,2,5,439,8,46,18,2512,19250,5986,18418901,6
7461,group,grup,11,10,1,3,8,group,1,4,450,6,43,7,3762,100117,13769,321865437,5
8906,insist,InsIst,1,1,0,0,1,insist,2,6,672,7,2,1,910,4087,885,2936535,7
9933,limbo,lImbo,1,1,0,0,1,limbo,2,5,429,5,8,5,121,599,122,852614,5
13131,pleasant,plEzNt,2,1,1,2,0,pleasant,2,7,589,9,3,3,1072,4550,409,11587800,8
4818,devil,dEvL,3,3,0,3,0,devil,2,5,376,6,21,7,2108,4137,816,12885948,6
3067,chin,CIn,21,20,1,15,6,chin,1,3,286,5,84,24,647,4723,303,3994291,4
2993,cheap,Cip,18,18,0,14,4,cheap,1,3,361,6,46,6,1848,7414,1141,97055447,4
9911,lighten,lYtN,6,5,1,3,3,lighten,2,5,386,8,49,6,301,792,105,721947,6
13088,plaid,pl@d,11,9,2,4,7,plaid,1,4,414,6,33,9,82,769,54,1679093,5
15537,shave,Sev,16,16,0,10,6,shave,1,3,563,6,43,20,702,1146,119,2580057,4
15660,siesta,siEstx,1,1,0,1,0,siesta,3,6,688,5,1,1,25,129,13,526110,5
15182,savage,s@vIJ,2,1,1,2,0,savage,2,5,532,7,4,8,365,2151,312,5207828,6
847,apartheid,xpartet,1,1,0,1,0,apartheid,3,7,547,10,2,0,19,2130,459,1300164,8
17270,this,DIs,4,4,0,4,0,this,1,3,455,5,25,11,406915,1235350,478061,3228499306,4
7474,gruff,gr^f,5,4,1,1,4,gruff,1,4,449,6,33,7,28,330,23,242037,5
17546,town,tWn,14,14,0,11,3,town,1,3,381,5,38,15,12644,45848,9653,90486897,4
15365,seemly,simli,1,0,1,0,1,seemly,2,5,629,5,9,1,7,47,6,41873,5
15491,seventy,sEvxnti,1,0,1,0,1,seventy,3,7,538,8,4,1,105,3871,873,2611424,8
7886,hide,hYd,21,19,2,15,6,hide,1,3,374,5,104,33,3554,7788,1521,27160697,4
12484,partner,partnX,1,1,0,0,1,partner,2,6,419,8,10,7,3836,14745,2021,52982041,7
1448,bait,bet,33,29,4,23,10,bait,1,3,336,5,123,27,496,2293,203,3049754,4
15522,shallow,S@lo,12,10,2,7,5,shallow,2,4,472,8,30,4,301,4158,231,4834372,5
16286,star,star,12,7,5,3,9,star,1,4,559,5,57,33,4149,31663,5712,122512005,5
18279,vain,ven,19,18,1,15,4,vain,1,3,375,5,102,26,332,1465,183,2406302,4
9920,like,lYk,26,24,2,16,10,like,1,3,469,5,99,38,203947,505063,155727,520611399,4
2101,bouquet,boke,1,0,1,1,0,bouquet,2,4,431,8,7,3,164,807,82,5143984,5
682,analyst,@nLxst,1,0,1,1,0,analyst,3,7,596,8,8,4,177,7032,2315,16918514,8
14434,referee,rEfXi,1,1,0,1,0,referee,3,5,472,8,5,1,183,769,102,2941934,6
16439,strange,strenJ,3,0,3,1,2,strange,1,6,557,8,5,6,4408,13212,2452,18324574,7
15739,sixteen,sIkstin,1,0,1,0,1,sixteen,2,7,598,8,10,1,418,3232,436,3329001,8
10244,mademoiselle,m@dxmwxzEl,1,1,0,1,0,mademoiselle,4,9,698,5,0,0,417,193,4,505561,6
12156,oval,ovL,6,6,0,4,2,oval,2,4,459,5,16,10,69,2499,628,7120184,5
4258,crust,kr^st,5,4,1,5,0,crust,1,5,470,6,21,10,166,2591,104,2267452,6
15461,serene,sXin,4,3,1,4,0,serene,2,4,646,7,22,5,63,880,70,1185930,5
11755,nurture,nRCX,1,1,0,1,0,nurture,2,4,429,8,9,3,37,1231,153,1310338,5
19246,yawl,ycl,16,15,1,14,2,yawl,1,3,448,4,66,5,12,41,0,59825,4
6641,footing,fUtIG,1,1,0,0,1,footing,2,5,511,8,7,6,52,1183,152,1112584,6
1662,become,bxk^m,1,1,0,1,0,become,2,5,482,7,23,3,5894,77632,13148,120495540,6
18441,veritable,vErxtxbL,1,1,0,1,0,veritable,4,9,465,9,0,2,50,550,27,505286,8
11970,opposition,apxzIS|n,2,1,1,2,0,opposition,4,8,591,11,3,1,155,12712,2870,12183104,9
12083,other,^DX,5,4,1,5,0,other,2,3,284,6,20,12,37505,391995,79490,978493536,4
1189,astride,xstrYd,1,0,1,1,0,astride,2,6,562,7,2,2,8,275,12,171136,5
2716,cast,k@st,13,11,2,8,5,cast,1,4,522,5,68,36,1180,13176,2191,33399422,5
5132,docket,dak|t,4,4,0,4,0,docket,2,5,489,7,9,8,61,257,72,3661940,6
14569,rend,rEnd,19,13,6,14,5,rend,1,4,384,5,50,32,16,70,6,277271,5
205,active,@ktIv,1,1,0,1,0,active,2,5,506,7,5,1,584,17997,2286,84091239,6
17084,temper,tEmpX,5,4,1,1,4,temper,2,5,343,7,15,12,582,1808,262,1717493,6
17211,then,DEn,17,16,1,15,2,then,1,3,375,5,69,30,75966,335547,81069,369942506,4
17802,try,trY,19,10,9,6,13,try,1,3,388,4,44,19,24314,63020,22091,114392006,4
5180,don,dan,19,18,1,13,6,don,1,3,347,4,135,61,321085,12771,4419,26009351,4
5562,else,Els,6,4,2,2,4,else,1,3,397,5,55,16,22907,54241,16297,96024346,4
10049,loan,lon,34,28,6,23,11,loan,1,3,412,5,143,26,1013,8144,2015,87786035,4
1982,boat,bot,32,27,5,22,10,boat,1,3,317,5,117,26,4885,15136,1895,34104237,4
10821,mild,mYld,8,7,1,6,2,mild,1,4,413,5,31,16,245,4307,428,6826082,5
16175,sport,sport,7,3,4,6,1,sport,1,5,502,6,20,11,1015,16323,1184,62692186,6
10348,mama,mamx,4,3,1,3,1,mama,2,4,529,5,36,32,5289,6722,530,5045460,5
18501,viability,vYxbIl|ti,1,1,0,1,0,viability,5,9,668,5,0,1,9,904,90,2364054,5
2239,broom,brum,10,7,3,4,6,broom,1,4,340,6,52,12,243,1164,127,1313136,5
7466,growl,grWl,6,6,0,1,5,growl,1,4,408,6,22,8,50,583,20,462100,5
14590,repay,ripe,3,1,2,1,2,repay,2,4,599,6,13,8,265,793,141,1746487,5
4160,creed,krid,11,9,2,3,8,creed,1,4,429,6,50,13,129,850,68,3399121,5
10405,manner,m@nX,10,9,1,4,6,manner,2,4,426,7,74,27,588,10573,997,28268864,5
1903,blaze,blez,11,6,5,5,6,blaze,1,4,471,6,58,15,107,1085,202,2457442,5
17197,thatch,T@C,6,6,0,6,0,thatch,1,3,499,7,26,2,38,258,2,289894,4
6596,fluster,fl^stX,4,2,2,3,1,fluster,2,6,545,8,8,5,3,24,1,18028,7
7187,gladden,gl@dN,1,0,1,0,1,gladden,2,6,405,6,7,1,2,66,1,159866,6
16223,squawk,skwck,3,2,1,0,3,squawk,1,5,520,7,3,1,87,156,16,128215,6
16683,sundae,s^nde,2,2,0,1,1,sundae,2,5,589,7,16,5,81,195,41,297154,6
16091,sped,spEd,11,8,3,3,8,sped,1,4,499,4,24,14,32,874,77,833838,4
14736,return,rItRn,1,1,0,0,1,return,2,5,496,7,12,2,4676,35685,5403,205636163,6
18033,undertaker,^ndXtekX,1,0,1,0,1,undertaker,4,8,577,10,2,3,78,135,14,499491,8
17664,treasure,trEZX,2,1,1,0,2,treasure,2,5,484,9,11,4,972,3059,402,8534047,6
7581,hairy,h@ri,14,12,2,10,4,hairy,2,4,539,5,127,9,322,1023,63,19060619,5
3560,compass,k^mpxs,2,2,0,2,0,compass,2,6,569,8,3,1,207,1391,139,4585829,6
16274,stanch,stcnC,1,1,0,1,0,stanch,1,5,512,7,13,8,1,79,2,36249,6
3474,colored,k^lXd,4,3,1,3,1,colored,2,5,392,8,15,2,377,7759,365,10189750,5
6521,flea,fli,22,12,10,13,9,flea,1,3,399,5,95,12,169,1095,71,2796494,4
13894,psychological,sYkxlaJIkL,1,1,0,1,0,psychological,5,11,778,14,0,0,343,11181,1082,10159621,10
2299,bullet,bUl|t,5,3,2,4,1,bullet,2,5,431,7,11,9,1950,4323,1084,7442894,6
18880,wedge,wEJ,12,11,1,6,6,wedge,1,3,465,6,34,11,119,1762,173,3163416,4
4831,dew,du,34,23,11,19,15,dew,1,2,326,4,182,39,109,636,40,4532686,3
15619,shrewd,Srud,7,5,2,4,3,shrewd,1,4,482,7,16,2,72,681,94,411505,5
8896,inside,InsYd,4,3,1,0,4,inside,2,5,537,7,8,3,10775,50862,10420,74036500,6
12461,parsley,parsli,2,1,1,0,2,parsley,2,6,475,6,10,7,43,2460,112,1377594,6
12440,parley,parli,6,4,2,1,5,parley,2,5,446,6,42,22,21,82,5,130409,6
15788,slaver,sl@vX,1,1,0,1,0,slaver,2,5,536,7,18,15,14,53,0,55703,6
15211,scarce,skErs,1,0,1,0,1,scarce,1,5,604,7,7,3,87,1877,125,2385219,6
15955,soldier,solJX,1,0,1,0,1,soldier,2,5,578,8,7,4,1985,6973,1751,10034915,6
6518,flaw,flc,9,7,2,3,6,flaw,1,3,449,5,33,19,155,1002,140,2288608,4
7379,grave,grev,16,12,4,4,12,grave,1,4,493,6,33,24,1340,5004,837,6930746,5
16337,step,stEp,6,6,0,0,6,step,1,4,476,5,33,16,6052,35177,7102,86156724,5
5402,each,iC,14,8,6,8,6,each,1,2,419,5,57,21,12916,157869,15531,340897028,3
2399,cabinet,k@b|n|t,1,1,0,1,0,cabinet,2,6,416,8,5,2,425,5859,1745,15990353,7
2502,camp,k@mp,12,7,5,9,3,camp,1,4,354,5,54,29,2612,17877,3006,35261166,5
9358,join,JOn,8,5,3,6,2,join,1,3,379,5,53,17,4255,15873,5094,174303626,4
425,agree,xgri,2,0,2,1,1,agree,2,4,431,6,9,4,3298,25427,13239,47501886,5
16968,tangle,t@GgL,9,8,1,8,1,tangle,2,6,365,7,18,15,53,919,43,554585,7
16398,stocky,staki,4,2,2,2,2,stocky,2,5,515,7,27,5,9,395,9,138963,5
6937,gag,g@g,19,19,0,12,7,gag,1,3,414,4,54,39,360,734,153,3570507,4
15257,scope,skop,7,5,2,3,4,scope,1,4,463,6,17,9,286,6085,467,23357027,5
18322,vantage,v@ntIJ,1,1,0,1,0,vantage,2,6,481,8,1,4,39,1040,131,1666914,7
5755,epic,EpIk,2,1,1,1,1,epic,2,4,501,5,25,5,120,2212,243,6460697,5
3112,choral,korL,12,7,5,4,8,choral,2,5,368,7,80,4,11,927,21,2068269,6
11599,nocturne,naktRn,1,0,1,0,1,nocturne,2,6,513,8,0,0,4,33,0,388346,7
15508,shack,S@k,22,20,2,16,6,shack,1,3,447,6,108,20,288,1208,90,2741096,4
1175,aster,@stX,10,6,4,10,0,aster,2,4,509,6,43,28,10,157,2,720415,5
10701,meow,miW,7,5,2,1,6,meow,2,3,619,4,41,6,150,183,31,813990,3
6594,flurry,flRi,3,1,2,1,2,flurry,2,4,507,6,21,6,24,909,119,610263,5
18227,urine,yUrxn,1,0,1,0,1,urine,2,5,539,5,8,8,332,1783,204,4903932,6
4349,customer,k^stxmX,1,0,1,0,1,customer,3,7,501,9,5,1,775,7186,945,184407639,8
16101,sperm,spRm,4,3,1,0,4,sperm,1,4,632,6,12,4,318,1918,305,5944531,5
13549,premix,primIks,1,1,0,1,0,premix,2,7,568,6,2,1,0,20,1,122657,6
1955,blown,blon,8,5,3,4,4,blown,1,4,420,5,40,9,811,3921,813,4230306,4
16276,stand,st@nd,3,1,2,2,1,stand,1,5,602,6,25,12,11536,35044,9303,46296102,6
9394,judo,Judo,1,1,0,1,0,judo,2,4,369,4,16,11,49,247,14,1116970,4
9329,jiffy,JIfi,2,1,1,1,1,jiffy,2,4,359,5,18,3,80,89,9,475865,5
8096,hulk,h^lk,5,4,1,2,3,hulk,1,4,379,5,21,11,208,407,77,2113535,5
6368,fib,fIb,12,12,0,5,7,fib,1,3,296,4,45,24,65,80,8,431128,4
5259,drawn,drcn,8,6,2,3,5,drawn,1,4,430,5,26,8,542,11457,1282,14827380,4
5956,excavate,Ekskxvet,1,0,1,0,1,excavate,3,8,677,9,1,1,10,261,15,161369,9
3330,clown,klWn,5,5,0,1,4,clown,1,4,453,6,27,6,807,1242,167,3090988,5
2969,charter,CartX,6,5,1,4,2,charter,2,5,449,8,22,10,151,3320,405,19192440,6
7423,grind,grYnd,4,2,2,3,1,grind,1,5,619,6,17,10,190,1349,167,2482513,6
8723,infant,Infxnt,1,0,1,0,1,infant,2,6,506,7,4,5,215,4224,530,12959639,7
3988,correct,kXEkt,1,1,0,1,0,correct,2,5,439,8,4,1,2292,16441,6930,44468174,6
7414,grievance,grivxns,1,0,1,0,1,grievance,2,7,490,10,1,2,46,389,79,2461503,8
979,arc,ark,11,3,8,7,4,arc,1,3,300,4,60,28,247,2417,132,12243165,4
4220,croquet,kroke,2,1,1,0,2,croquet,2,5,468,8,7,0,44,185,3,571392,5
6409,fill,fIl,40,31,9,26,14,fill,1,3,300,5,115,33,2241,12279,1723,35150152,4
2019,bolster,bolstX,2,2,0,2,0,bolster,2,6,568,8,11,8,16,1163,140,1079347,7
17845,turbine,tRb|n,4,3,1,2,2,turbine,2,5,549,8,5,3,46,1409,39,3235102,6
13156,plight,plYt,11,8,3,6,5,plight,1,4,370,4,25,5,63,1579,278,1330993,4
11871,odor,odX,8,6,2,7,1,odor,2,3,309,5,49,6,119,2150,151,3532168,4
4246,cruel,krul,11,8,3,4,7,cruel,1,4,406,6,53,6,936,2977,609,4183018,5
16100,spent,spEnt,3,1,2,2,1,spent,1,5,552,5,13,8,3574,35477,7600,29719451,5
6455,fiscal,fIskL,1,0,1,0,1,fiscal,2,6,484,7,12,1,39,5577,1102,23506386,7
393,age,eJ,16,10,6,8,8,age,1,2,395,4,66,46,4039,65798,8812,132738257,3
11326,muzzle,m^zL,6,6,0,3,3,muzzle,2,5,420,7,20,6,81,706,52,670603,6
7650,harbor,harbX,2,1,1,2,0,harbor,2,5,445,7,28,5,562,5714,827,14117965,6
62,abound,xbWnd,2,1,1,2,0,abound,2,5,549,7,5,5,18,1068,31,1494791,6
3832,contest,kantEst,1,0,1,0,1,contest,2,7,586,8,6,8,958,5600,1298,20859550,8
4947,dire,dYr,22,19,3,13,9,dire,2,3,379,5,87,29,112,1821,331,2304282,4
3922,cooper,kupX,6,5,1,3,3,cooper,2,4,442,7,47,18,887,5110,1108,12476378,5
9928,lily,lIli,5,5,0,3,2,lily,2,4,394,5,82,12,1370,3214,160,4976754,5
1974,blurb,blRb,4,3,1,0,4,blurb,1,4,438,6,8,4,13,88,17,776249,5
15093,salmon,s@mxn,7,7,0,7,0,salmon,2,5,468,7,54,14,334,5352,419,9757346,6
7611,hammer,h@mX,6,4,2,2,4,hammer,2,4,409,7,37,20,636,3448,945,7384067,5
2216,broaden,brcdN,1,0,1,0,1,broaden,2,6,579,8,14,5,50,923,148,1565925,7
4412,dam,d@m,22,18,4,17,5,dam,1,3,467,4,85,54,293,2844,306,9211089,4
8694,inefficient,InxfIS|nt,1,0,1,1,0,inefficient,4,9,539,12,0,0,21,1045,110,1494636,10
322,aerate,Eret,8,7,1,8,0,aerate,2,4,434,7,19,2,1,36,0,53640,5
3840,continual,kxntInyuL,1,0,1,0,1,continual,4,10,606,10,3,0,16,915,68,1685246,11
4207,critter,krItX,2,2,0,2,0,critter,2,5,356,8,19,7,65,214,26,711841,6
16014,sorry,sari,4,4,0,1,3,sorry,2,4,579,5,47,10,59566,21415,7475,35606156,5
13910,puck,p^k,27,23,4,17,10,puck,1,3,317,5,73,21,147,555,41,1553945,4
18900,wench,wEnC,8,6,2,4,4,wench,1,4,394,6,27,12,88,101,3,310447,5
7603,halter,hcltX,5,3,2,4,1,halter,2,5,483,7,21,22,26,313,25,1444780,6
3259,clause,klcz,4,2,2,1,3,clause,1,4,639,7,35,11,143,2642,288,13906621,5
6067,explorer,IksplorX,1,0,1,0,1,explorer,3,8,580,9,4,4,97,1821,182,23109102,9
17420,to,tu,31,22,9,18,13,to,1,2,419,3,164,59,1156570,6513027,1581706,12136980858,3
15128,sanitarium,s@n|tErixm,1,1,0,0,1,sanitarium,5,10,807,8,1,0,115,94,5,147235,6
5194,dorm,dorm,5,4,1,3,2,dorm,1,4,446,5,38,16,369,1284,331,2037885,5
8924,instance,Instxns,1,1,0,0,1,instance,2,7,564,9,2,3,856,18413,3211,26204516,8
10434,mar,mar,26,16,10,13,13,mar,1,3,569,4,137,69,205,1459,85,103217136,4
11437,near,nIr,25,23,2,19,6,near,1,3,348,5,86,25,4238,44184,5639,81655363,4
4123,cranky,kr@Gki,1,0,1,0,1,cranky,2,6,418,6,8,4,171,497,71,788346,6
2932,chant,C@nt,8,6,2,5,3,chant,1,4,490,6,33,11,116,906,104,1374428,5
15919,soar,sor,32,22,10,24,8,soar,1,3,517,5,138,24,78,769,82,1730435,4
3319,cloth,klcT,3,2,1,1,2,cloth,1,4,459,6,19,8,311,5095,171,9764604,5
3688,confessor,kxnfEsX,1,0,1,0,1,confessor,3,7,556,8,2,0,12,187,7,215121,7
12519,pastoral,p@stXL,2,1,1,0,2,pastoral,3,7,480,9,1,2,7,1587,63,2946809,8
4128,crash,kr@S,13,11,2,6,7,crash,1,4,485,6,44,9,1461,7522,2056,15314015,5
1959,blubber,bl^bX,1,0,1,1,0,blubber,2,5,403,5,3,1,43,160,16,137360,5
19196,wren,rEn,26,22,4,18,8,wren,1,3,313,5,138,17,19,944,13,1206315,4
1034,arm,arm,9,3,6,3,6,arm,1,3,383,4,44,27,3336,21897,1819,23727941,4
18410,vent,vEnt,16,14,2,12,4,vent,1,4,275,5,41,30,225,1238,126,4130520,5
2453,calf,k@f,19,17,2,8,11,calf,1,3,383,5,75,17,151,1562,82,2757974,4
16049,spank,sp@Gk,4,3,1,4,0,spank,1,5,517,6,11,15,173,184,97,5416580,6
12112,outfit,WtfIt,1,1,0,0,1,outfit,2,5,374,7,4,2,1280,2711,608,4089584,6
11963,opinion,xpInyxn,1,0,1,1,0,opinion,3,7,446,8,3,2,2142,16570,5537,56038991,8
1893,blank,bl@Gk,7,4,3,6,1,blank,1,5,350,6,18,17,495,4211,839,18151617,6
6212,fancy,f@nsi,2,1,1,1,1,fancy,2,5,599,6,17,5,1777,3893,485,8777727,6
5411,earn,Rn,15,9,6,11,4,earn,1,2,311,5,96,24,783,6099,836,20305486,3
1902,blather,bl@DX,2,1,1,1,1,blather,2,5,373,5,6,5,14,73,7,279603,4
1935,bloater,blotX,2,1,1,1,1,bloater,2,5,668,7,11,3,2,1,0,11706,5
16325,steeple,stipL,4,2,2,3,1,steeple,2,6,595,8,14,5,21,188,8,376906,7
13135,pleat,plit,15,12,3,7,8,pleat,1,4,385,6,35,8,3,36,3,266830,5
10700,menu,mEnyu,1,1,0,1,0,menu,2,5,399,5,3,11,508,5717,387,74362975,6
16981,tape,tep,16,14,2,12,4,tape,1,3,304,5,37,25,3511,11608,4569,30944306,4
9082,into,Intu,4,3,1,2,2,into,2,4,450,5,8,16,43074,411858,67611,445329524,5
9864,liar,lYX,18,13,5,5,13,liar,2,3,375,5,91,13,1792,1476,579,1820994,4
16515,stubby,st^bi,4,3,1,0,4,stubby,2,5,565,6,13,4,25,421,6,287176,5
7276,golden,gold|n,2,1,1,2,0,golden,2,6,424,7,28,21,1187,13016,1248,34419693,7
4779,destiny,dEst|ni,1,0,1,0,1,destiny,3,7,550,7,1,2,1175,2598,316,5704348,8
7201,glaze,glez,6,4,2,4,2,glaze,1,4,509,6,45,12,45,1143,98,1431525,5
407,aggrieve,xgriv,2,0,2,1,1,aggrieve,2,5,537,9,7,1,0,0,0,5273,6
11549,niche,nIC,16,14,2,10,6,niche,1,3,356,6,51,5,47,1817,145,3999964,4
18980,whisper,hwIspX,2,2,0,0,2,whisper,2,5,549,8,17,10,403,2670,136,2158715,6
14196,rally,r@li,9,8,1,8,1,rally,2,4,456,6,84,22,368,4376,1704,9156520,5
13213,point,pOnt,8,6,2,7,1,point,1,4,382,6,20,9,12063,106134,36964,175543899,5
15379,selection,sxlEkS|n,1,0,1,1,0,selection,3,8,643,10,2,2,232,9455,634,75200220,9
11428,navigate,n@vxget,1,0,1,0,1,navigate,3,7,748,9,2,2,98,1561,170,15680555,8
1425,bacon,bek|n,5,5,0,5,0,bacon,2,5,467,6,29,12,605,3771,451,5386132,6
5169,dome,dom,25,22,3,15,10,dome,1,3,386,5,79,28,100,2735,219,5484779,4
12642,penal,pinL,5,4,1,3,2,penal,2,5,334,6,16,7,66,560,49,1467202,6
12836,petition,pxtIS|n,3,2,1,3,0,petition,3,7,579,9,5,1,215,1861,330,12120487,8
12160,oven,^vxn,2,1,1,2,0,oven,2,4,499,5,11,25,453,7842,376,9926488,5
15316,scythe,sYD,11,10,1,5,6,scythe,1,3,435,6,40,1,16,159,0,241758,3
15482,set,sEt,32,24,8,22,10,set,1,3,373,4,94,45,11805,90580,14204,313477521,4
13170,plumber,pl^mX,3,2,1,0,3,plumber,2,5,443,8,14,6,229,555,130,1225144,6
9751,learn,lRn,16,14,2,13,3,learn,1,3,409,6,92,12,6047,34036,6280,179431965,4
12738,perimeter,pXImxtX,1,1,0,1,0,perimeter,4,7,496,10,3,1,461,1684,146,2657896,8
15787,slave,slev,9,6,3,3,6,slave,1,4,525,6,17,18,940,3848,430,10700310,5
15734,sister,sIstX,3,1,2,1,2,sister,2,5,539,7,23,10,9207,22963,4537,25043263,6
323,aeration,EreS|n,2,1,1,2,0,aeration,3,6,572,6,3,0,1,148,1,478947,4
2638,card,kard,15,13,2,10,5,card,1,4,529,5,73,30,4357,17668,3388,181392776,5
16758,surrender,sXEndX,1,1,0,1,0,surrender,3,6,659,10,7,1,789,2780,549,4019161,7
11178,mosque,mask,4,3,1,2,2,mosque,1,4,461,7,19,2,60,2153,695,1969984,5
3484,coma,komx,6,5,1,1,5,coma,2,4,323,5,54,36,626,1026,235,1616513,5
13034,pious,pYxs,2,1,1,1,1,pious,2,4,524,6,19,3,48,610,30,713689,5
2894,chafe,Cef,7,6,1,4,3,chafe,1,3,469,6,17,10,13,130,6,123596,4
8129,hung,h^G,18,17,1,8,10,hung,1,3,479,5,50,29,1436,8751,734,8543618,4
16992,tare,tEr,23,20,3,20,3,tare,1,3,305,4,52,37,4,112,0,232510,4
4616,delete,dxlit,2,1,1,2,0,delete,2,5,403,7,13,5,90,496,56,33775852,6
6960,gallon,g@l|n,2,1,1,1,1,gallon,2,5,421,7,51,16,116,3165,869,4998083,6
3395,coequal,koikwL,1,0,1,0,1,coequal,3,7,528,4,0,0,0,20,6,19890,4
12331,panda,p@ndx,1,1,0,0,1,panda,2,5,431,6,16,16,108,461,107,3429690,6
14354,recital,rIsYtL,1,0,1,0,1,recital,3,7,599,8,1,2,150,444,29,1487036,7
14217,random,r@ndxm,2,2,0,1,1,random,2,6,619,7,10,4,522,6290,646,44063242,7
2174,breed,brid,16,14,2,5,11,breed,1,4,489,6,57,13,323,2356,308,7716901,5
3576,compile,kxmpYl,1,1,0,0,1,compile,2,6,555,8,5,3,27,400,36,8493988,7
14853,riser,rYzX,8,7,1,5,3,riser,2,4,426,5,64,29,18,226,31,969986,4
11605,nodular,naJUlX,1,1,0,1,0,nodular,3,6,544,6,1,1,0,44,1,168576,5
16213,squad,skwad,5,4,1,1,4,squad,1,5,623,6,7,4,1096,2653,426,8748755,6
12584,peach,piC,22,18,4,13,9,peach,1,3,355,6,81,14,324,1715,94,3938068,4
10289,mailed,meld,6,4,2,3,3,mailed,1,4,504,6,42,15,106,1791,253,7370075,4
14286,raw,rc,19,14,5,12,7,raw,1,2,323,4,122,42,519,7459,833,25018120,3
2851,center,sEntX,9,5,4,5,4,center,2,5,455,7,45,17,2335,74697,10678,294324066,6
570,altitude,@lt|tud,2,1,1,2,0,altitude,3,7,622,9,3,4,198,2081,200,4582981,5
1644,beaten,bitN,6,4,2,4,2,beaten,2,5,539,6,52,8,611,4367,1002,4346610,5
15307,sculpture,sk^lpCX,1,1,0,0,1,sculpture,2,7,670,10,3,2,159,3463,170,7328010,8
9255,itch,IC,18,10,8,11,7,itch,1,2,331,5,57,15,213,599,63,993863,3
16028,south,sWT,5,4,1,2,3,south,1,3,439,6,17,7,3288,59248,11886,238591983,4
6008,exhaust,Igzcst,2,2,0,0,2,exhaust,2,6,768,8,4,1,109,1695,108,7853328,7
11412,natural,n@CXL,2,0,2,1,1,natural,2,6,592,8,3,0,2160,36535,3348,105106604,7
7687,hat,h@t,34,31,3,21,13,hat,1,3,404,4,111,60,3273,8649,1107,24396117,4
13300,poor,por,31,25,6,21,10,poor,1,3,471,5,41,20,6583,31365,4652,48053547,4
11964,opium,opixm,1,1,0,0,1,opium,3,5,416,4,2,0,114,748,103,1330299,5
2879,ceremony,sErxmoni,1,0,1,0,1,ceremony,4,8,633,8,2,0,807,5293,1056,9150049,9
10442,mare,mEr,23,21,2,18,5,mare,1,3,489,5,130,60,148,797,25,2815109,4
17423,toast,tost,11,10,1,9,2,toast,1,4,529,6,27,6,1707,2620,259,3265480,5
15531,shard,Sard,12,11,1,9,3,shard,1,4,450,6,47,19,37,166,9,288486,5
12998,pill,pIl,36,32,4,25,11,pill,1,3,325,5,114,32,603,2625,802,12755636,4
2186,bride,brYd,15,12,3,4,11,bride,1,4,332,6,40,15,1235,2756,452,8650865,5
3220,civilian,sxvIlyxn,1,1,0,1,0,civilian,3,8,600,9,3,1,479,6908,1773,6782491,9
4875,diction,dIkS|n,2,1,1,2,0,diction,2,6,619,8,10,1,25,242,10,421461,7
17167,test,tEst,18,14,4,14,4,test,1,4,419,5,52,29,4288,41727,6213,155012917,5
14465,regain,rIgen,3,3,0,2,1,regain,2,5,605,7,7,7,134,1751,291,1707596,6
16247,staff,st@f,5,5,0,0,5,staff,1,4,839,6,32,11,1632,33117,5473,151555360,5
17330,thwart,Twort,4,2,2,4,0,thwart,1,5,593,7,6,2,17,531,56,582616,6
5222,down,dWn,20,17,3,13,7,down,1,3,529,5,75,20,76004,235392,56832,224931672,4
12753,perjury,pRJXi,2,1,1,1,1,perjury,3,5,477,7,5,1,115,605,322,773202,5
14811,ride,rYd,30,24,6,18,12,ride,1,3,469,5,112,31,6904,15415,2051,26160527,4
10453,marine,mXin,7,5,2,4,3,marine,2,4,485,7,32,24,718,9545,1781,37146628,5
2522,cancer,k@nsX,6,4,2,2,4,cancer,2,5,505,7,32,8,1139,25817,6607,65083953,6
6873,fund,f^nd,8,7,1,5,3,fund,1,4,435,5,36,18,541,19710,3590,67130844,5
9161,involve,Invalv,1,0,1,1,0,involve,2,6,640,8,3,2,330,6292,771,11976840,7
17771,trough,trcf,2,2,0,0,2,trough,1,4,465,7,15,11,72,557,57,1395096,5
14812,rider,rYdX,6,4,2,3,3,rider,2,4,323,6,68,28,393,2159,137,8989575,5
4432,danger,denJX,2,2,0,2,0,danger,2,5,419,7,6,26,2227,11331,3176,13212871,6
15722,sink,sIGk,17,12,5,14,3,sink,1,4,459,5,55,36,863,5489,494,8121285,5
5047,dispute,dIspyut,2,0,2,1,1,dispute,2,7,500,8,1,3,160,5366,1240,11164678,8
15350,sector,sEktX,9,6,3,8,1,sector,2,5,608,7,32,8,360,10372,1975,48747184,6
15477,servility,sRvIl|ti,1,1,0,1,0,servility,4,8,577,7,1,0,0,29,1,34399,5
9949,line,lYn,32,28,4,20,12,line,1,3,328,5,123,59,10515,70663,14206,280022418,4
10676,memorize,mEmXYz,1,0,1,1,0,memorize,3,6,662,9,4,2,148,534,67,665262,7
182,acquire,xkwYr,2,1,1,2,0,acquire,3,5,614,8,6,4,135,3452,277,8807297,6
2750,catch,k@C,20,19,1,9,11,catch,1,3,579,6,75,9,6911,16857,2617,20403264,4
17557,trace,tres,13,11,2,4,9,trace,1,4,455,6,35,23,989,4718,511,11706634,5
5176,domination,damxneS|n,2,2,0,2,0,domination,4,9,631,9,1,1,79,1656,125,4362491,7
16771,suspend,s|spEnd,1,1,0,0,1,suspend,2,7,708,8,3,1,141,921,255,3312160,8
17102,ten,tEn,27,22,5,21,6,ten,1,3,429,4,109,46,7395,27479,3708,46917465,4
13196,poach,poC,15,14,1,8,7,poach,1,3,439,6,41,9,17,117,11,75120,4
17034,team,tim,19,17,2,12,7,team,1,3,378,5,78,22,7528,67180,9117,171698717,4
4576,defend,dxfEnd,3,2,1,2,1,defend,2,6,538,7,7,3,959,6878,2369,7362127,7
6846,fruit,frut,7,6,1,3,4,fruit,1,4,305,6,24,3,1108,10882,654,22768964,5
17051,tedious,tidixs,1,1,0,0,1,tedious,3,6,723,8,1,0,73,784,72,1512119,7
14858,risque,rIske,1,0,1,0,1,risque,2,5,417,4,9,2,7,96,25,529634,5
5553,elk,Elk,5,4,1,1,4,elk,1,3,295,4,56,25,306,2350,79,4693077,4
15803,slept,slEpt,1,1,0,1,0,slept,1,5,487,5,8,3,1810,4726,551,2370802,4
4678,denial,dInYL,2,1,1,0,2,denial,3,6,437,7,1,7,268,2835,587,6159821,7
12683,penthouse,pEnthWs,1,1,0,1,0,penthouse,2,7,521,10,0,1,231,532,98,1829897,8
5074,dissolution,dIsxluS|n,1,1,0,0,1,dissolution,4,9,664,12,1,1,5,625,57,2003049,10
5628,employ,ImplO,3,1,2,0,3,employ,2,5,465,7,6,2,171,2964,236,5836385,6
7368,grapple,gr@pL,3,2,1,0,3,grapple,2,6,554,8,10,2,12,542,81,524680,7
2940,chapel,C@pL,6,4,2,2,4,chapel,2,5,393,7,17,7,406,3162,300,9025491,6
6432,finding,fYndIG,1,1,0,1,0,finding,2,6,528,8,8,10,1935,20702,3495,37104800,7
15814,sling,slIG,16,12,4,8,8,sling,1,4,632,6,49,14,117,564,49,1688770,5
10128,lot,lat,31,26,5,26,5,lot,1,3,407,4,118,48,29066,134263,73125,106410684,4
15095,salt,sclt,11,8,3,7,4,salt,1,4,488,5,32,25,995,20309,1198,25323008,5
14192,raisin,rezN,7,5,2,5,2,raisin,2,5,489,7,8,5,83,438,37,724623,6
16237,stab,st@b,7,6,1,3,4,stab,1,4,489,5,33,21,447,958,199,1648037,5
8348,immune,Imyun,1,0,1,1,0,immune,2,5,416,7,3,2,221,3995,570,8368663,6
17886,twice,twYs,2,2,0,1,1,twice,1,4,507,5,11,5,3191,16586,2725,19946243,4
3595,composite,kxmpaz|t,1,0,1,0,1,composite,3,8,559,10,3,2,64,2455,385,9492059,9
14421,reduce,rIdus,4,3,1,3,1,reduce,2,5,501,7,5,9,219,19183,2508,39832456,6
6244,fashion,f@S|n,5,3,2,5,0,fashion,2,5,443,8,21,2,957,13476,2070,43895669,6
9871,liberally,lIbXLi,1,0,1,0,1,liberally,3,7,463,8,5,2,17,370,23,545357,7
14996,rump,r^mp,14,11,3,11,3,rump,1,4,267,5,27,20,72,348,42,390247,5
12501,passion,p@S|n,4,3,1,4,0,passion,2,5,470,8,18,4,1008,7617,1342,13374548,6
12161,over,ovX,10,7,3,6,4,over,2,3,355,5,35,27,67488,351232,100962,459238035,4
10119,lord,lord,13,11,2,10,3,lord,1,4,349,5,76,20,7046,11145,1624,47629668,5
43,able,ebL,8,1,7,8,0,able,2,4,425,5,28,26,8155,67548,22021,109389656,5
19265,yet,yEt,15,15,0,12,3,yet,1,3,395,4,51,29,17428,85871,16376,123166044,4
6888,furious,fyUrixs,1,1,0,1,0,furious,3,7,679,8,4,1,306,2575,582,2146277,8
4950,dirge,dRJ,10,9,1,7,3,dirge,1,3,519,4,28,4,9,80,9,391309,4
11053,monarch,manXk,1,0,1,0,1,monarch,2,6,487,8,3,2,42,887,113,2537793,7
18940,wherever,hwErEvX,1,1,0,1,0,wherever,3,6,450,6,2,2,1500,4593,1154,6763200,4
4188,crime,krYm,10,8,2,4,6,crime,1,4,519,6,42,13,3633,23091,8591,40363040,5
19002,whoever,huEvX,2,1,1,2,0,whoever,3,5,529,8,5,1,2203,3946,1426,3962882,6
5420,ease,iz,19,8,11,10,9,ease,1,2,457,5,173,36,974,6877,741,13977690,3
6367,fiat,fiat,2,1,1,0,2,fiat,2,4,381,5,7,10,9,694,83,3330076,3
1245,attempt,xtEmpt,1,0,1,1,0,attempt,2,6,471,8,3,2,975,16579,2544,25251906,7
2510,can,k@n,35,27,8,21,14,can,1,3,459,4,168,64,267620,561421,146853,1242330385,4
18867,weasel,wizL,3,2,1,2,1,weasel,2,5,421,7,22,12,250,434,13,883023,6
7972,homely,homli,1,0,1,0,1,homely,2,5,401,6,7,3,47,306,16,326082,5
15399,seminary,sEmxnEri,1,1,0,0,1,seminary,4,8,579,8,2,3,53,1509,108,2706256,9
6442,finish,fInIS,1,1,0,1,0,finish,2,5,555,7,6,2,5045,12259,2490,29771085,6
96,abuse,xbyuz,2,2,0,2,0,abuse,2,5,531,6,1,6,523,16706,3916,36270050,6
8095,hula,hulx,1,1,0,1,0,hula,2,4,419,4,22,21,100,209,25,921011,4
9718,lawn,lcn,19,16,3,13,6,lawn,1,3,480,5,99,16,630,5269,619,10551602,4
15264,scotch,skaC,4,4,0,0,4,scotch,1,4,545,7,15,1,752,1025,60,2104031,5
2392,cab,k@b,22,19,3,11,11,cab,1,3,349,4,81,46,1826,3485,395,9280172,4
12125,outlaw,Wtlc,1,1,0,0,1,outlaw,2,4,468,7,5,2,149,854,187,2027944,5
1918,blessed,blEst,5,2,3,4,1,blessed,1,5,500,8,8,1,704,3147,515,6405692,5
13301,pop,pap,29,23,6,19,10,pop,1,3,305,4,83,44,3441,11213,1922,54142627,4
16517,stuck,st^k,16,11,5,3,13,stuck,1,4,557,6,45,16,3399,10094,1848,9120841,5
7043,gaze,gez,20,17,3,12,8,gaze,1,3,505,5,145,28,129,6703,69,2120279,4
10291,main,men,31,27,4,21,10,main,1,3,378,5,169,44,2179,30403,4490,199627044,4
9228,irritation,IrxteS|n,2,2,0,2,0,irritation,4,8,672,11,1,2,32,1084,63,1891655,9
9706,launch,lcnC,5,4,1,4,1,launch,1,4,447,7,17,6,1018,6886,1563,23714910,5
18930,whenever,hwEnEvX,1,1,0,1,0,whenever,3,6,402,5,3,2,1790,8863,1470,14234747,4
7358,grant,gr@nt,6,3,3,2,4,grant,1,5,402,6,25,18,1660,11380,1542,47611492,6
4304,cupboard,k^bXd,1,1,0,1,0,cupboard,2,5,377,9,6,1,127,648,24,1119123,6
4736,derive,dXYv,2,1,1,2,0,derive,2,4,539,7,8,7,35,1257,61,3253144,5
10099,long,lcG,13,11,2,8,5,long,1,3,529,5,67,37,34433,180566,35209,252534359,4
1378,award,xword,5,4,1,5,0,award,2,5,413,6,10,9,657,10786,1722,59653406,6
10678,men,mEn,27,22,5,20,7,men,1,3,356,4,129,54,19011,96300,17258,174067226,4
15600,short,Sort,10,7,3,6,4,short,1,4,431,6,45,18,4367,48306,7745,106760897,5
6516,flavor,flevX,2,1,1,2,0,flavor,2,5,563,7,12,2,255,5667,618,6223085,6
7086,genital,JEn|tL,2,0,2,0,2,genital,3,7,480,8,2,2,27,633,55,2264034,8
16320,stealth,stElT,1,1,0,0,1,stealth,1,5,536,8,8,1,142,939,185,3431743,6
1785,beyond,biand,2,1,1,2,0,beyond,2,5,468,6,5,0,2200,35771,5334,47318022,3
1870,bitter,bItX,10,7,3,5,5,bitter,2,4,277,7,40,22,568,5177,1040,4997265,5
4087,covet,k^vxt,1,1,0,0,1,covet,2,5,383,6,5,12,48,207,16,223834,6
13824,prostrate,prastret,1,0,1,0,1,prostrate,2,8,579,9,1,1,21,192,17,325089,8
10426,manure,mxnUr,1,1,0,1,0,manure,2,5,578,5,1,4,106,1054,61,1702869,5
13161,plough,plW,6,6,0,2,4,plough,1,3,350,7,28,7,54,100,11,797262,4
3151,chug,C^g,13,13,0,10,3,chug,1,3,442,5,29,12,119,142,12,184716,4
17719,trill,trIl,15,13,2,8,7,trill,1,4,469,6,36,17,6,86,3,172713,5
10207,lying,lYIG,3,0,3,3,0,lying,2,4,619,3,26,10,4472,10208,2254,8260845,3
1594,bastard,b@stXd,1,1,0,1,0,bastard,2,6,417,8,8,2,3348,1588,53,2504855,7
8686,industry,Ind^stri,1,0,1,0,1,industry,3,8,490,9,5,1,596,38161,7884,160814289,9
12956,pick,pIk,34,27,7,20,14,pick,1,3,305,5,101,28,10118,24469,6179,38550279,4
16780,swaddle,swadL,2,1,1,2,0,swaddle,2,6,464,5,2,3,4,25,1,37523,5
18596,virile,vIrL,5,4,1,1,4,virile,2,5,550,6,8,0,33,124,9,103815,6
18364,veal,vil,20,17,3,18,2,veal,1,3,386,5,127,20,181,581,34,1002995,4
7116,germ,JRm,7,7,0,6,1,germ,1,3,317,5,29,17,64,610,77,1575223,4
10644,meeting,mitIG,2,2,0,2,0,meeting,2,5,420,8,19,4,6752,32229,7993,120815168,6
331,aeronaut,@rxnct,1,0,1,0,1,aeronaut,3,6,502,9,2,0,0,12,0,58911,5
18663,vocalize,vokxlYz,1,1,0,1,0,vocalize,3,7,724,7,2,1,7,45,4,43580,6
15282,screen,skrin,2,2,0,0,2,screen,1,5,688,7,10,3,1193,18341,3001,77185904,6
18769,wall,wcl,23,19,4,18,5,wall,1,3,529,5,117,41,3605,38049,7457,59434857,4
17358,till,tIl,35,28,7,26,9,till,1,3,286,5,108,29,8503,6230,1572,16385076,4
14819,rife,rYf,18,16,2,7,11,rife,1,3,333,5,64,18,26,475,46,678405,4
6825,frolic,fralIk,1,0,1,1,0,frolic,2,6,425,7,10,2,42,143,11,289348,7
3960,cork,kork,11,9,2,4,7,cork,1,4,410,5,80,24,146,802,53,5504784,5
14129,quote,kwot,8,5,3,1,7,quote,1,4,316,6,11,4,488,7438,5178,139243057,5
12376,par,par,27,18,9,14,13,par,1,3,399,4,111,52,253,3108,201,16653162,4
16241,stabilize,stebxlYz,1,0,1,0,1,stabilize,3,8,801,10,3,4,76,1401,323,1193707,9
2071,born,born,14,11,3,10,4,born,1,4,447,5,69,36,4268,26161,4839,52455025,5
15593,shoe,Su,25,22,3,19,6,shoe,1,2,470,5,157,19,1550,4357,799,16344743,3
5388,dwell,dwEl,6,2,4,4,2,dwell,1,4,488,6,20,13,142,987,142,2014710,5
6753,fraction,fr@kS|n,3,2,1,3,0,fraction,2,7,629,9,5,4,104,3170,361,7201835,8
15150,sassy,s@si,3,3,0,1,2,sassy,2,4,568,6,50,6,164,372,44,1659608,5
6363,few,fyu,12,6,6,7,5,few,1,3,521,4,53,28,15393,123736,21412,135137447,4
15109,sample,s@mpL,2,1,1,2,0,sample,2,6,529,7,14,10,744,17358,565,68958024,7
15806,slice,slYs,8,5,3,3,5,slice,1,4,530,6,23,15,435,4111,298,4630221,5
527,allocation,@lxkeS|n,1,1,0,1,0,allocation,4,8,621,11,5,1,10,1645,75,11756662,9
7576,hail,hel,30,26,4,25,5,hail,1,3,378,5,143,35,613,1374,257,2796792,4
2074,borrow,baro,9,8,1,3,6,borrow,2,4,325,7,85,10,1495,2592,636,4137645,5
5625,empire,EmpYr,1,1,0,1,0,empire,3,5,455,7,5,4,646,6748,882,21114766,6
14985,rule,rul,23,18,5,14,9,rule,1,3,431,5,127,30,2455,19681,3592,57915711,4
7234,glow,glo,13,7,6,8,5,glow,1,3,308,5,50,17,293,3916,139,5332631,4
2119,boy,bO,13,11,2,5,8,boy,1,2,329,4,87,46,27021,38579,8028,58670588,3
4577,defense,dxfEns,2,1,1,1,1,defense,2,6,592,8,1,3,1665,36649,12893,37819960,7
15606,shot,Sat,23,23,0,20,3,shot,1,3,370,5,96,22,11599,32589,8559,41618912,4
10511,mass,m@s,26,20,6,16,10,mass,1,3,441,5,108,55,880,22769,3003,40377172,4
11127,morale,mX@l,2,2,0,1,1,morale,2,4,520,7,13,6,210,1594,388,1709786,5
2548,cannot,k@nat,1,0,1,0,1,cannot,2,5,436,6,4,1,6465,84,44,97806,5
18984,white,hwYt,11,7,4,3,8,white,1,3,286,6,104,25,8744,120488,26610,209878931,4
9800,legitimate,lIJItxmxt,1,0,1,1,0,legitimate,4,9,472,11,0,0,384,6037,1811,6928802,10
1370,avoid,xvOd,3,1,2,3,0,avoid,2,4,487,6,5,5,1239,19865,2682,36508741,5
5810,era,Irx,4,2,2,2,2,era,2,3,553,4,90,46,291,15338,1872,16943185,4
14235,rapist,rep|st,1,1,0,1,0,rapist,2,6,563,7,3,2,162,622,292,536157,7
10076,locust,lok|st,1,0,1,0,1,locust,2,6,507,7,5,2,44,273,17,1302839,7
13862,provision,prxvIZ|n,1,1,0,1,0,provision,3,8,462,10,1,1,40,4491,613,27093298,9
1282,auditor,cd|tX,1,0,1,0,1,auditor,3,5,678,8,6,2,24,633,65,5328788,6
16729,support,sxport,2,0,2,2,0,support,2,6,614,8,6,1,2587,77557,15542,373521243,7
2039,boner,bonX,4,3,1,2,2,boner,2,4,285,5,71,34,119,37,2,302012,5
13077,place,ples,7,4,3,2,5,place,1,4,387,6,25,16,30736,121329,23007,220988917,5
9291,jar,Jar,16,14,2,11,5,jar,1,3,409,4,84,36,424,2498,171,6551592,4
6667,foreman,formxn,2,2,0,2,0,foreman,2,6,475,7,49,7,283,1717,567,1845679,7
7505,gullet,g^l|t,2,2,0,2,0,gullet,2,5,400,7,8,8,24,68,2,145201,5
18652,vivify,vIvxfY,2,1,1,1,1,vivify,3,6,644,5,0,1,0,15,0,15176,5
5126,dizzy,dIzi,5,5,0,2,3,dizzy,2,4,439,6,33,4,430,1105,112,1426439,5
2959,charger,CarJX,2,1,1,0,2,charger,2,5,482,8,8,9,62,422,19,13863803,6
5228,downy,dWni,4,3,1,0,4,downy,2,4,400,5,31,9,21,134,2,289136,5
5423,Easter,istX,6,4,2,4,2,easter,2,4,599,7,22,23,382,2418,445,8899820,5
14220,range,renJ,8,3,5,4,4,range,1,4,538,6,40,23,1161,31115,2605,128317120,5
17343,tidal,tYdL,6,4,2,3,3,tidal,2,5,334,4,20,3,53,1144,123,2268649,4
1387,awhile,xhwYl,2,1,1,1,1,awhile,2,4,472,3,6,2,483,1444,372,2787752,4
4446,darling,darlIG,1,0,1,1,0,darling,2,6,527,8,12,15,6613,2515,371,3654099,7
9654,lap,l@p,30,25,5,18,12,lap,1,3,360,4,97,48,687,4668,474,6344143,4
9778,legal,ligL,6,3,3,4,2,legal,2,5,400,6,44,7,1821,28844,7089,142053548,6
5403,eager,igX,7,6,1,5,2,eager,2,3,359,6,35,31,350,5884,700,4175668,4
12623,peer,pIr,33,29,4,23,10,peer,1,3,419,5,99,28,78,7459,308,17755290,4
6420,fin,fIn,30,26,4,20,10,fin,1,3,372,4,119,40,174,977,60,5934857,4
15377,seldom,sEldxm,1,1,0,1,0,seldom,2,6,529,6,5,1,167,2916,199,2790565,6
15243,science,sY|ns,1,0,1,0,1,science,2,5,589,8,4,2,1900,41013,5454,174247315,6
19118,wizard,wIzXd,4,4,0,3,1,wizard,2,5,450,7,14,4,542,1478,168,12160971,6
8364,impartial,ImparSL,1,0,1,0,1,impartial,3,8,688,10,1,0,51,553,131,1676218,9
5721,entomology,EntxmalxJi,1,0,1,1,0,entomology,5,10,693,10,1,0,12,177,14,997894,10
3119,chorus,kor|s,4,2,2,1,3,chorus,2,5,479,7,41,3,310,2663,343,6994693,6
6327,fence,fEns,10,8,2,7,3,fence,1,4,489,6,30,8,819,5998,814,6796605,5
10974,mitigation,mIt|geS|n,1,1,0,1,0,mitigation,4,9,650,9,0,1,3,1004,62,4282830,5
9326,jewel,JuL,6,5,1,2,4,jewel,1,3,619,6,70,5,369,1380,162,5603871,4
6941,gain,gen,25,23,2,17,8,gain,1,3,406,5,140,39,700,12656,1760,31983184,4
11218,mow,mW,20,17,3,10,10,mow,1,2,366,4,151,40,117,384,58,518340,3
16728,supply,sxplY,1,0,1,1,0,supply,2,5,669,7,6,1,952,13683,1931,73221816,6
14915,root,rut,30,26,4,21,9,root,1,3,271,5,123,28,534,6744,816,41844352,4
17660,tread,trEd,12,9,3,5,7,tread,1,4,309,6,25,10,116,775,89,1673940,5
4090,coward,kWXd,1,0,1,0,1,coward,2,4,476,7,17,10,734,692,110,1656677,5
6525,fleece,flis,4,2,2,1,3,fleece,1,4,484,7,26,4,59,638,44,5951007,5
14943,rough,r^f,20,17,3,11,9,rough,1,3,376,6,72,20,1907,8215,1342,11557409,4
2902,chaise,Sez,14,14,0,8,6,chaise,1,3,465,6,121,2,15,232,0,599684,3
5424,eastern,istXn,1,0,1,0,1,eastern,2,5,464,8,11,1,414,17012,4043,38507397,6
15203,scan,sk@n,7,5,2,2,5,scan,1,4,522,5,31,17,480,2742,300,18174748,5
8109,humble,h^mbL,6,5,1,6,0,humble,2,6,380,7,20,14,500,2474,323,3693501,7
10698,mention,mEnC|n,4,4,0,4,0,mention,2,6,431,8,11,2,3033,11651,2371,18291476,7
5960,excel,IksEl,1,0,1,0,1,excel,2,5,473,6,6,5,37,1180,65,14138932,6
8019,hormonal,hormonL,1,0,1,0,1,hormonal,3,8,494,7,0,0,43,614,61,1261979,7
370,aflame,xflem,2,1,1,2,0,aflame,2,5,699,5,3,1,17,112,13,118170,4
10354,mammoth,m@mxT,1,1,0,0,1,mammoth,2,5,442,8,6,1,40,1065,70,2207478,6
15579,shiny,SYni,3,2,1,1,2,shiny,2,4,509,6,23,7,398,3014,184,3192674,4
2696,carve,karv,4,3,1,0,4,carve,1,4,469,6,45,20,158,1148,157,952422,5
7321,gout,gWt,17,16,1,15,2,gout,1,3,240,5,39,17,71,160,7,744794,4
17515,tort,tort,15,13,2,7,8,tort,1,4,294,5,59,29,9,702,91,2184133,5
9973,lint,lInt,16,11,5,8,8,lint,1,4,555,5,59,34,68,272,29,1057015,5
11739,number,n^mbX,3,2,1,3,0,number,2,5,472,7,7,7,12288,95701,23772,383795244,6
3757,conscious,kanC|s,2,1,1,0,2,conscious,2,6,512,10,2,0,347,6015,741,6037028,7
7317,gourd,gord,16,14,2,10,6,gourd,1,4,389,6,51,3,24,355,7,502106,5
16195,sprout,sprWt,3,2,1,0,3,sprout,1,5,596,7,12,8,46,541,11,623058,6
1953,blow,blo,15,7,8,9,6,blow,1,3,579,5,86,26,4976,8516,1958,31347668,4
14032,python,pYTan,1,1,0,1,0,python,2,5,479,7,3,0,79,447,87,17612967,6
9170,iodine,Y|dYn,1,1,0,0,1,iodine,3,5,631,5,3,9,64,432,68,1351488,5
19072,windy,wIndi,3,2,1,1,2,windy,2,5,397,5,24,14,134,1090,157,2163179,5
15807,slick,slIk,15,11,4,5,10,slick,1,4,508,6,44,20,350,2191,275,2377343,5
6180,fake,fek,22,19,3,13,9,fake,1,3,394,5,71,33,1853,3989,950,10090550,4
11365,name,nem,16,14,2,12,4,name,1,3,483,5,57,20,32735,67418,14891,464548432,4
9400,juice,Jus,13,11,2,8,5,juice,1,3,475,6,60,8,1371,9628,696,10977879,4
17286,though,Do,20,18,2,14,6,though,1,2,348,7,105,6,9279,103600,20689,91910181,3
6391,fifth,fIfT,1,1,0,0,1,fifth,1,4,529,6,6,5,979,11104,1485,16255792,5
9649,lanky,l@Gki,4,2,2,2,2,lanky,2,5,475,5,17,9,22,480,8,148174,5
6225,farina,fxrinx,1,0,1,1,0,farina,3,5,479,7,8,8,1,99,4,333581,6
13160,plot,plat,12,10,2,6,6,plot,1,4,389,5,37,17,591,5877,1293,18685607,5
18498,vex,vEks,3,2,1,3,0,vex,1,4,507,4,44,19,10,62,2,294112,5
12697,per,pR,19,12,7,8,11,per,1,2,236,4,126,42,1141,45236,3166,218953180,3
6138,eyestrain,Ystren,1,0,1,1,0,eyestrain,2,6,610,6,1,0,2,21,0,87027,4
17109,tend,tEnd,16,11,5,11,5,tend,1,4,358,5,39,19,626,14823,2397,13845810,5
14117,quite,kwYt,10,7,3,3,7,quite,1,4,332,5,20,11,10332,43248,14429,58778450,4
778,answer,@nsX,3,1,2,2,1,answer,2,4,401,7,22,1,8986,38425,12425,64651553,5
2133,braid,bred,18,15,3,5,13,braid,1,4,379,6,47,6,48,669,26,981945,5
11968,oppose,xpoz,3,1,2,2,1,oppose,2,4,637,7,7,2,110,3213,1036,3653137,5
9598,laden,ledN,4,3,1,1,3,laden,2,5,376,6,55,21,83,4667,1936,5964926,6
10985,mob,mab,15,14,1,10,5,mob,1,3,349,4,69,33,660,2437,859,3601851,4
16657,suite,swit,9,7,2,4,5,suite,1,4,491,6,25,12,849,4001,218,44830655,5
7430,gristle,grIsL,3,3,0,1,2,gristle,2,6,413,6,11,1,11,59,0,93861,6
5269,dreary,drIri,1,0,1,0,1,dreary,2,5,337,6,5,3,92,550,51,554686,4
15490,seventeen,sEvxntin,1,0,1,0,1,seventeen,3,8,738,10,5,1,296,2415,383,2169264,9
8527,incest,InsEst,7,5,2,3,4,incest,2,6,551,7,8,4,44,686,239,51394714,6
19149,woods,wUdz,3,1,2,0,3,woods,1,4,360,6,17,12,1482,11540,1596,14647985,5
17893,twinge,twInJ,2,0,2,1,1,twinge,1,5,589,5,6,4,26,357,18,97077,6
11662,normal,normL,3,1,2,1,2,normal,2,6,418,7,12,3,3589,20598,4401,56446291,7
4338,curve,kRv,13,12,1,6,7,curve,1,3,468,6,52,10,235,3929,424,11071742,4
18139,unruly,^nruli,1,1,0,1,0,unruly,3,6,553,5,1,1,36,670,55,495055,5
13219,poke,pok,27,22,5,18,9,poke,1,3,409,5,89,25,298,1055,166,1491296,4
34,ability,xbIl|ti,1,1,0,1,0,ability,4,7,537,7,3,1,980,30299,3860,52004640,8
16468,strewn,strun,2,1,1,0,2,strewn,1,5,559,6,13,2,19,1145,70,458488,5
15523,sham,S@m,15,13,2,10,5,sham,1,3,448,5,76,39,77,633,134,1600848,4
6853,fudge,f^J,6,6,0,3,3,fudge,1,3,527,6,18,8,185,567,82,1969555,4
4025,costumer,kastumX,2,0,2,0,2,costumer,3,7,748,9,5,6,8,21,4,142351,8
2916,champ,C@mp,9,8,1,8,1,champ,1,4,385,6,24,14,771,1171,134,2872397,5
698,anchor,@GkX,7,2,5,4,3,anchor,2,4,519,7,19,3,378,6008,3399,8633656,5
12233,ozone,ozon,1,0,1,1,0,ozone,2,4,486,4,3,1,109,2472,228,5871147,4
4080,cousin,k^zN,1,1,0,1,0,cousin,2,5,415,7,14,3,2491,5245,668,4263607,6
7410,grid,grId,9,7,2,1,8,grid,1,4,463,5,29,12,282,2753,199,19390119,5
4354,cute,kyut,6,3,3,4,2,cute,1,4,429,5,38,21,4475,4219,1435,17923044,5
4473,dead,dEd,24,22,2,15,9,dead,1,3,359,5,74,22,22898,38019,7974,48400230,4
7333,gradient,gredixnt,1,0,1,1,0,gradient,3,8,579,9,2,1,9,448,4,3607728,9
16042,spade,sped,9,7,2,3,6,spade,1,4,496,6,24,12,118,495,49,1569700,5
3282,cleric,klErIk,1,0,1,0,1,cleric,2,6,559,7,6,2,68,621,179,969331,7
4044,counter,kWntX,3,2,1,1,2,counter,2,5,421,8,11,7,709,10227,1342,35350659,6
14769,revulsion,rIv^lS|n,1,1,0,1,0,revulsion,3,8,679,5,1,0,12,361,27,200216,5
18809,warn,worn,15,13,2,9,6,warn,1,4,426,5,51,30,1293,2777,625,4160789,5
15195,scale,skel,10,8,2,4,6,scale,1,4,649,6,34,17,485,25406,1790,46310390,5
7717,head,hEd,25,22,3,17,8,head,1,3,352,5,92,27,18947,95333,12269,113328496,4
13109,plaster,pl@stX,5,2,3,2,3,plaster,2,6,503,8,12,9,134,1247,58,1811197,7
10960,misspell,mIspEl,1,1,0,1,0,misspell,2,6,556,9,6,3,3,15,4,58626,7
15954,solder,sadX,7,6,1,4,3,solder,2,4,420,7,31,20,2,122,6,1709674,5
16961,tandem,t@ndxm,1,1,0,1,0,tandem,2,6,400,7,4,0,18,871,50,2423295,7
7909,Hindi,hIndi,3,3,0,2,1,hindi,2,5,469,5,21,4,16,279,27,4089536,5
8827,inject,InJEkt,4,3,1,3,1,inject,2,6,531,7,6,3,123,822,231,1187647,7
14489,regret,rIgrEt,1,1,0,0,1,regret,2,6,567,7,1,2,1384,3638,923,3717633,6
14911,rookie,rUki,2,1,1,1,1,rookie,2,4,387,7,18,4,252,3316,138,3870767,5
16650,suicidal,suxsYdL,1,0,1,0,1,suicidal,4,8,808,7,0,0,148,1435,267,1344372,7
13353,posh,paS,11,9,2,3,8,posh,1,3,366,5,48,26,65,512,89,998148,4
4200,crisp,krIsp,2,2,0,0,2,crisp,1,5,389,6,20,10,161,3739,139,3880661,6
16678,summer,s^mX,7,5,2,2,5,summer,2,4,430,7,39,13,4012,37940,5449,67112108,5
14538,rely,rIlY,3,1,2,1,2,rely,2,4,433,5,20,14,366,6201,878,9132959,5
13016,pine,pYn,30,26,4,22,8,pine,1,3,407,5,80,38,316,5258,211,13844240,4
15781,slash,sl@S,15,12,3,7,8,slash,1,4,581,6,22,10,122,1224,175,2935736,5
2061,booths,buDz,2,1,1,1,1,booths,1,4,466,6,11,4,57,839,73,1584453,4
13360,possession,pxzES|n,1,1,0,1,0,possession,3,7,607,11,3,1,680,3882,489,9088454,8
17865,turtle,tRtL,8,8,0,8,0,turtle,2,5,308,7,31,4,869,1709,133,5301024,6
8286,illusive,IlusIv,1,1,0,1,0,illusive,3,6,611,7,1,1,6,42,7,112481,7
17401,tire,tYr,26,22,4,16,10,tire,2,3,314,5,88,31,631,3489,492,9193048,4
3618,concede,kxnsid,3,3,0,0,3,concede,2,6,637,8,6,2,53,1241,391,731182,7
18754,wail,wel,32,28,4,24,8,wail,1,3,367,5,141,32,44,611,21,326062,4
10288,mail,mel,35,31,4,24,11,mail,1,3,348,5,156,36,1879,21685,4679,310349656,4
2247,brown,brWn,10,8,2,3,7,brown,1,4,438,6,44,15,3066,37344,6568,64118556,5
12906,phonology,fxnalxJi,1,1,0,1,0,phonology,4,8,588,9,0,0,0,70,0,488127,6
566,alternation,cltXneS|n,2,1,1,1,1,alternation,4,9,703,10,1,2,2,126,5,294977,7
7008,garner,garnX,1,1,0,0,1,garner,2,5,496,7,30,29,61,854,122,2725663,6
17154,terrain,tXen,4,4,0,3,1,terrain,2,4,629,8,12,1,115,4040,304,5793822,5
17264,think,TIGk,13,10,3,11,2,think,1,4,365,6,45,11,137261,365740,238692,217882847,5
11217,movie,muvi,3,2,1,0,3,movie,2,4,508,6,17,5,6271,28264,9712,158431735,5
18557,villa,vIlx,3,1,2,0,3,villa,2,4,441,6,32,18,224,1499,112,17590237,5
2811,cede,sid,27,22,5,15,12,cede,1,3,456,5,143,13,6,232,31,207651,4
11305,mustard,m^stXd,2,1,1,1,1,mustard,2,6,426,8,7,3,329,2605,207,2820945,7
16766,survey,sRve,3,2,1,1,2,survey,2,4,509,7,24,7,227,20475,1420,62995429,5
9449,karma,karmx,2,0,2,0,2,karma,2,5,361,6,25,10,176,419,64,6863875,6
16114,spike,spYk,10,8,2,1,9,spike,1,4,537,6,31,12,625,1971,377,4839802,5
10602,meaning,minIG,1,1,0,1,0,meaning,2,5,414,8,9,6,1904,19142,2167,28821231,6
16330,stellar,stElX,2,1,1,1,1,stellar,2,5,589,8,42,3,41,1597,70,3063048,6
4610,delay,dxle,3,2,1,2,1,delay,2,4,457,6,19,14,562,6705,1749,21916362,5
6220,far,far,18,14,4,14,4,far,1,3,439,4,101,46,11259,87622,20403,93068747,4
4686,denounce,dInWns,1,1,0,1,0,denounce,2,6,540,9,2,3,44,539,155,489112,7
1151,asset,@sEt,1,0,1,1,0,asset,2,4,479,6,10,6,193,3047,469,18181917,5
15500,sex,sEks,6,5,1,4,2,sex,1,4,489,4,72,30,7761,33017,7536,320113308,5
16762,surround,sXWnd,1,0,1,1,0,surround,2,5,636,9,3,1,156,1636,246,6660071,6
4889,differential,dIfXEnCL,1,1,0,1,0,differential,4,9,598,13,3,2,44,1925,77,8617983,10
5207,double,d^bL,7,5,2,5,2,double,2,5,349,7,22,6,3198,19311,2879,77291432,6
17013,tattoo,t@tu,3,2,1,0,3,tattoo,2,4,520,7,9,1,610,1590,339,6840612,5
3343,coal,kol,35,32,3,23,12,coal,1,3,517,5,182,21,335,5822,850,11627311,4
9885,lice,lYs,26,22,4,15,11,lice,1,3,475,5,95,34,109,336,24,1006104,4
10057,lobar,lobX,5,3,2,3,2,lobar,2,5,489,5,5,9,1,2,0,46379,5
6309,fell,fEl,30,25,5,21,9,fell,1,3,509,5,115,31,3723,20641,3030,15084606,4
7305,gory,gori,10,8,2,4,6,gory,2,4,479,4,100,24,37,240,43,489190,5
16312,statute,st@Cut,1,0,1,0,1,statute,2,6,551,8,5,3,97,2733,699,9035618,7
15554,sheet,Sit,23,21,2,16,7,sheet,1,3,465,6,90,9,592,7948,491,44296091,4
14491,regularity,rEgyUl@rxti,1,0,1,1,0,regularity,5,11,625,8,1,0,16,497,35,843301,7
3669,condone,kxndon,2,2,0,0,2,condone,2,6,728,8,2,4,59,427,182,513678,7
15962,solemnly,salxmli,1,1,0,0,1,solemnly,3,7,594,7,0,0,89,597,84,547833,4
1978,boa,box,8,7,1,0,8,boa,2,3,340,4,79,42,66,198,15,1694806,4
11114,mood,mud,17,15,2,11,6,mood,1,3,433,5,61,20,1736,8366,1333,11871925,4
14035,quack,kw@k,8,8,0,5,3,quack,1,4,389,6,21,4,236,159,25,484886,5
4645,demeanor,dIminX,1,0,1,0,1,demeanor,3,6,490,9,6,1,54,1192,203,513271,7
12500,passing,p@sIG,4,4,0,2,2,passing,2,5,491,7,20,10,1325,11825,1506,15467766,5
18808,warmth,wormT,1,0,1,0,1,warmth,1,5,511,5,7,3,227,3288,165,3107429,5
13547,premise,prEmxs,1,1,0,0,1,premise,2,6,448,8,2,5,61,2219,505,3131689,6
12525,pat,p@t,39,30,9,24,15,pat,1,3,446,4,91,56,933,10057,4337,15093689,4
1447,bairn,bErn,6,5,1,3,3,bairn,1,4,355,6,19,6,12,18,0,35569,4
13127,plaza,pl@zx,2,1,1,1,1,plaza,2,5,361,6,5,6,301,3210,473,14276293,6
10860,mine,mYn,28,24,4,18,10,mine,1,3,376,5,109,49,12800,15688,3651,28819520,4
13519,preface,prEfxs,1,1,0,0,1,preface,2,6,523,8,2,2,28,570,51,2461709,7
11022,moist,mOst,9,9,0,8,1,moist,1,4,482,6,18,9,92,1938,92,2140516,4
11465,needs,nidz,3,2,1,0,3,needs,1,4,450,5,54,12,8198,49082,9804,123598938,4
19324,zone,zon,17,13,4,15,2,zone,1,3,609,5,71,23,1026,10083,1796,46907731,4
4518,decent,disNt,2,2,0,2,0,decent,2,6,559,7,2,7,1433,4280,926,8075752,7
9997,lists,lIsts,1,0,1,0,1,lists,1,5,609,5,17,10,198,5460,429,58253142,5
6751,foyer,fOX,1,1,0,1,0,foyer,2,3,439,5,33,14,45,965,25,1042532,4
2382,button,b^tN,6,5,1,4,2,button,2,5,322,7,51,14,1441,6291,825,66812726,6
2267,buckle,b^kL,6,5,1,3,3,buckle,2,5,372,7,32,13,257,1101,122,2898037,6
324,aerial,@riL,4,2,2,2,2,aerial,3,5,460,7,10,2,129,1694,261,6531386,6
1090,artist,art|st,1,1,0,0,1,artist,2,6,443,7,4,2,1460,17654,1665,67425534,7
7075,generic,J|nErIk,1,1,0,0,1,generic,3,7,701,8,2,2,78,2200,255,25472959,8
15944,soften,scfxn,4,3,1,4,0,soften,2,5,532,7,6,5,76,1236,132,782865,5
16946,tally,t@li,13,12,1,7,6,tally,2,4,406,6,75,23,178,983,216,1812605,5
2417,cadet,k|dEt,1,1,0,1,0,cadet,2,5,437,6,8,3,176,550,103,1717624,6
6383,field,fild,9,6,3,6,3,field,1,4,511,6,48,11,3580,47647,4638,135293038,5
13082,placid,pl@s|d,1,1,0,1,0,placid,2,6,608,7,4,6,29,605,42,1009328,5
546,along,xlcG,2,0,2,2,0,along,2,4,485,6,4,9,9330,73012,12373,83450291,5
3149,chuck,C^k,20,17,3,14,6,chuck,1,3,381,6,55,9,1096,4081,1506,9576652,4
5234,drab,dr@b,6,5,1,3,3,drab,1,4,422,5,17,15,41,562,26,431176,5
19309,zinc,zIGk,11,9,2,10,1,zinc,1,4,559,5,40,9,43,973,40,5675340,4
14899,role,rol,34,30,4,21,13,role,1,3,324,5,179,42,929,50196,8122,73689562,4
9758,leave,liv,26,21,5,11,15,leave,1,3,399,6,98,18,28596,45947,11722,70962325,4
8524,inception,InsEpS|n,1,1,0,1,0,inception,3,8,623,5,2,0,21,955,70,2394773,6
170,acidity,xsId|ti,1,1,0,1,0,acidity,4,7,540,6,0,1,10,399,11,762749,6
1966,blues,bluz,6,3,3,3,3,blues,1,4,639,6,45,12,523,4838,663,23393181,5
17007,tasty,testi,2,1,1,1,1,tasty,2,5,409,5,12,7,322,1279,111,3565981,6
4817,device,dxvYs,3,3,0,0,3,device,2,5,495,7,6,6,926,8601,1009,50826692,6
18890,welcome,wElkxm,1,1,0,0,1,welcome,2,6,418,8,3,3,9140,20097,12042,114043671,7
14469,regard,rIgard,1,1,0,1,0,regard,2,6,580,7,3,7,375,10156,2024,18645277,7
6215,fang,f@G,11,11,0,7,4,fang,1,3,477,5,50,31,98,549,17,1045476,4
13785,prophet,prafxt,1,1,0,0,1,prophet,2,6,412,8,5,1,272,1737,294,5328893,7
12897,phone,fon,28,24,4,22,6,phone,1,3,448,6,95,11,13756,42230,11766,256648017,4
15651,sickle,sIkL,13,11,2,8,5,sickle,2,5,443,7,61,13,28,532,92,997530,6
8979,intelligent,IntEl|J|nt,1,1,0,0,1,intelligent,4,10,663,12,1,0,689,4454,915,14136953,10
16257,stain,sten,17,14,3,5,12,stain,1,4,539,6,49,19,316,1430,144,3512824,5
1810,big,bIg,20,19,1,13,7,big,1,3,319,4,75,35,34824,118668,37227,216698774,4
1733,bend,bEnd,18,15,3,15,3,bend,1,4,389,5,61,32,768,4652,388,9344830,5
16381,stink,stIGk,6,3,3,4,2,stink,1,5,523,6,21,14,673,877,99,872742,6
16163,sponge,sp^nJ,1,0,1,0,1,sponge,1,5,594,7,3,5,342,1063,94,2262717,6
12545,patio,p@tio,1,0,1,0,1,patio,3,5,539,6,8,5,133,1678,68,7627859,6
16056,sparse,spars,3,1,2,1,2,sparse,1,5,524,7,12,4,11,910,38,1745258,6
15438,separation,sEpXeS|n,1,1,0,1,0,separation,4,8,659,11,2,2,248,4528,636,9895531,9
9477,kid,kId,24,21,3,16,8,kid,1,3,319,4,68,28,17299,20408,5460,22023401,4
14575,renew,rInu,1,1,0,0,1,renew,2,4,420,6,13,3,111,1121,183,6563804,5
7559,hack,h@k,30,27,3,17,13,hack,1,3,412,5,129,34,436,928,91,6547946,4
17576,tragic,tr@JIk,1,1,0,0,1,tragic,2,6,532,7,1,0,624,3820,1228,3266929,7
3314,close,klos,6,6,0,0,6,close,1,4,464,6,57,19,11191,58749,13298,107859307,5
10266,magnet,m@gn|t,2,1,1,0,2,magnet,2,6,522,7,11,5,140,1557,175,6698803,7
11927,oneness,w^n|s,1,0,1,0,1,oneness,2,5,546,4,2,0,21,169,13,900974,5
14210,ran,r@n,28,23,5,15,13,ran,1,3,412,4,143,74,4296,24422,4247,16295566,4
5468,edit,Ed|t,1,1,0,1,0,edit,2,4,355,5,5,9,77,950,151,94172644,5
3975,coronary,kcrxnEri,1,1,0,0,1,coronary,4,8,682,8,3,0,101,1034,84,3878267,9
17580,traitor,tretX,3,2,1,1,2,traitor,2,5,360,8,30,3,540,566,127,698922,6
2226,broke,brok,9,8,1,2,7,broke,1,4,287,6,48,13,5355,14172,3344,10461287,5
3483,columnist,kalxmn|st,1,0,1,0,1,columnist,3,9,545,10,1,1,51,3912,1965,3300471,10
5422,east,ist,8,2,6,7,1,east,1,3,484,5,29,28,2527,40017,8347,135047057,4
10984,moat,mot,31,23,8,20,11,moat,1,3,559,5,77,22,60,287,25,590890,4
16679,summit,s^mxt,1,1,0,0,1,summit,2,5,463,7,8,3,170,6678,2534,15682693,6
18784,wand,wand,9,6,3,6,3,wand,1,4,374,5,38,29,157,582,74,1888212,5
7949,hockey,haki,6,5,1,3,3,hockey,2,4,449,7,48,12,588,3619,368,22253215,5
10872,minion,mInyxn,1,1,0,1,0,minion,2,6,401,7,13,7,47,73,5,437530,7
571,alto,@lto,1,0,1,0,1,alto,2,4,519,5,6,19,69,1476,100,6381409,5
3083,chit,CIt,22,21,1,16,6,chit,1,3,290,5,50,17,14,114,9,1852791,4
17717,trigger,trIgX,2,0,2,1,1,trigger,2,5,382,8,18,3,861,4662,915,8631876,6
8012,hooves,hUvz,2,2,0,2,0,hooves,1,4,416,6,13,3,66,617,12,237645,4
15617,shred,SrEd,8,6,2,6,2,shred,1,4,449,6,28,7,150,669,133,851931,5
443,aisle,Yl,23,11,12,19,4,aisle,1,2,393,6,124,5,379,2990,663,1917319,3
17148,termination,tRmxneS|n,1,1,0,1,0,termination,4,9,616,12,2,2,68,944,84,10274046,10
14528,relic,rElIk,3,2,1,1,2,relic,2,5,338,6,23,6,68,720,35,947777,6
13174,plump,pl^mp,6,3,3,4,2,plump,1,5,367,6,18,10,75,1073,32,3386553,6
6732,forum,forM,8,7,1,0,8,forum,2,5,399,6,22,9,104,4663,696,254492828,6
2411,cad,k@d,30,26,4,18,12,cad,1,3,409,4,89,51,53,886,16,11439016,4
14309,realm,rElm,2,1,1,2,0,realm,1,4,391,6,15,6,238,3818,294,6123350,5
15266,Scottish,skatIS,1,1,0,1,0,scottish,2,6,737,7,1,0,138,1510,124,15566669,5
9831,less,lEs,24,19,5,14,10,less,1,3,441,5,101,36,5666,95390,13166,145437505,4
3943,copy,kapi,8,7,1,3,5,copy,2,4,377,5,44,15,2666,7396,969,79624352,5
14289,razor,rezX,3,2,1,1,2,razor,2,4,519,6,64,6,351,1744,188,3465609,5
6782,free,fri,17,11,6,11,6,free,1,3,353,5,95,27,9054,68509,10631,1014165416,4
9187,iron,Yrn,3,2,1,1,2,iron,2,3,569,5,44,24,915,10702,695,32559173,4
15253,scoff,skaf,6,5,1,0,6,scoff,1,4,590,6,15,8,21,199,13,180363,5
3011,chef,SEf,8,6,2,4,4,chef,1,3,441,5,57,17,606,6096,1229,9722545,4
8349,immunity,Imyun|ti,1,0,1,1,0,immunity,4,8,569,8,1,1,216,1650,412,3620894,7
15684,silk,sIlk,10,7,3,4,6,silk,1,4,391,5,35,18,499,4549,241,13106363,5
18299,valor,v@lX,4,4,0,2,2,valor,2,4,462,6,25,4,64,401,57,1193133,5
7765,height,hYt,26,22,4,19,7,height,1,3,393,7,114,8,476,7176,592,30745629,4
3681,confection,kxnfEkS|n,1,1,0,1,0,confection,3,9,686,11,5,3,9,161,7,148960,10
10162,lucky,l^ki,3,1,2,2,1,lucky,2,4,390,6,51,13,7316,9931,2350,14060796,5
18341,varied,vErid,3,2,1,1,2,varied,2,5,511,6,15,1,41,4422,131,7013799,5
16541,sturdy,stRdi,2,2,0,2,0,sturdy,2,5,560,6,6,1,86,1822,60,2621713,6
12888,philosophy,fxlasxfi,1,1,0,0,1,philosophy,4,8,550,10,2,0,422,8677,1127,28960884,9
11729,nudist,nud|st,1,1,0,1,0,nudist,2,6,484,7,1,1,33,42,10,6796558,7
15209,scar,skar,10,8,2,3,7,scar,1,4,502,5,37,21,432,1615,168,2045269,5
7105,genus,Jin|s,2,2,0,2,0,genus,2,5,453,5,17,7,15,701,12,4275567,5
11766,nylon,nYlan,1,1,0,1,0,nylon,2,5,568,6,4,6,69,1370,43,10410948,6
64,above,xb^v,1,1,0,0,1,above,2,4,565,6,6,3,2493,44493,3454,141896477,5
11897,ogre,ogX,7,7,0,6,1,ogre,2,3,386,5,34,4,71,176,5,834248,3
7683,hassle,h@sL,10,9,1,7,3,hassle,2,5,534,7,56,5,133,671,100,3665939,6
51,aboard,xbord,5,3,2,4,1,aboard,2,5,504,4,14,1,1358,4190,663,4084762,5
5256,draw,drc,6,3,3,1,5,draw,1,3,368,5,30,13,2061,12733,2105,22706359,4
5515,elective,xlEktIv,1,0,1,1,0,elective,3,7,599,9,4,2,52,722,111,4186685,8
10446,margin,marJ|n,3,2,1,0,3,margin,2,6,514,7,20,14,100,3457,942,10100139,7
12270,paint,pent,12,9,3,9,3,paint,1,4,353,6,38,13,1877,11877,1200,21928120,5
3177,cinnamon,sInxmxn,1,0,1,0,1,cinnamon,3,7,509,9,5,2,152,2380,80,3130642,8
4437,dapper,d@pX,4,4,0,2,2,dapper,2,4,431,5,19,8,28,416,22,266901,4
10004,literate,lItX|t,1,0,1,1,0,literate,3,6,519,8,4,2,17,874,70,1184935,6
7017,garter,gartX,5,5,0,4,1,garter,2,5,483,7,22,21,67,146,20,1004872,6
19041,wile,wYl,29,24,5,18,11,wile,1,3,389,5,123,43,21,76,19,223900,4
10559,matting,m@tIG,4,4,0,4,0,matting,2,5,373,8,17,7,1,80,1,573938,6
11480,neighbor,nebX,5,5,0,3,2,neighbor,2,4,456,9,40,1,864,6300,1311,5753134,5
10996,moderate,madXet,1,0,1,0,1,moderate,3,6,429,9,2,3,63,7679,1449,11976847,7
13772,proof,pruf,4,3,1,1,3,proof,1,4,348,6,22,6,1754,7423,1946,26305307,5
16899,tab,t@b,17,15,2,9,8,tab,1,3,406,4,59,38,294,1508,268,18990893,4
1071,arson,arsN,1,0,1,1,0,arson,2,5,452,6,28,19,153,622,235,989351,6
1466,ballad,b@lxd,3,3,0,3,0,ballad,2,5,409,7,14,6,72,725,57,1689145,6
12246,pack,p@k,30,27,3,19,11,pack,1,3,327,5,110,35,2235,10052,1045,52565298,4
17897,twit,twIt,11,7,4,4,7,twit,1,4,238,5,24,7,71,66,18,228177,5
6841,froze,froz,7,4,3,2,5,froze,1,4,458,6,62,3,216,1447,104,599030,5
17673,trek,trEk,6,5,1,1,5,trek,1,4,376,5,32,9,229,2245,267,10691823,5
4332,cursory,kRsXi,1,1,0,1,0,cursory,3,5,475,7,6,1,15,382,27,344525,5
15351,secular,sEkyUlX,2,2,0,2,0,secular,3,7,639,8,3,0,25,4366,417,3463905,8
5650,encipher,InsYfX,2,2,0,0,2,encipher,3,6,613,5,0,1,0,0,0,17970,4
9746,lean,lin,33,30,3,19,14,lean,1,3,370,5,175,41,529,5159,428,6431983,4
4679,denier,dInYX,3,1,2,0,3,denier,3,5,469,6,5,9,0,90,10,522095,5
6470,fixed,fIkst,3,1,2,1,2,fixed,1,5,421,5,13,10,1647,8507,1011,49221217,5
4203,critic,krItIk,2,0,2,0,2,critic,2,6,388,7,7,2,192,4515,1041,4442069,7
2091,bought,bct,25,23,2,21,4,bought,1,3,362,7,90,9,4362,17408,2991,31501377,4
2900,chain,Cen,19,18,1,16,3,chain,1,3,334,6,108,18,1082,9888,1099,35938524,4
5187,donor,donX,5,4,1,3,2,donor,2,4,469,6,49,5,208,2286,464,7098950,5
2190,brig,brIg,10,8,2,4,6,brig,1,4,301,5,32,15,155,501,166,805525,5
14958,rover,rovX,6,3,3,3,3,rover,2,4,400,6,38,28,170,1454,187,8538281,5
17640,trap,tr@p,13,8,5,4,9,trap,1,4,380,5,34,17,1216,3687,440,7571926,5
10958,mission,mIS|n,2,2,0,2,0,mission,2,5,423,8,27,4,2400,19633,4447,52726536,6
17891,twin,twIn,9,6,3,2,7,twin,1,4,390,5,32,12,532,5111,664,20152862,5
1891,bland,bl@nd,8,6,2,7,1,bland,1,5,386,6,19,21,55,1107,72,1607626,6
4752,desert,d|zRt,1,1,0,1,0,desert,2,5,449,7,10,7,1427,9984,1717,15732964,6
5779,epoch,Epxk,1,1,0,0,1,epoch,2,4,372,6,6,4,7,528,3,1680235,5
1429,badge,b@J,13,12,1,2,11,badge,1,3,413,6,42,8,778,1369,260,6145470,4
6259,fateful,fetfL,1,0,1,0,1,fateful,2,6,514,5,4,1,51,626,134,447598,4
1337,autumn,ctM,4,3,1,2,2,autumn,2,4,559,7,12,0,193,3039,252,9649779,5
6328,fend,fEnd,20,15,5,16,4,fend,1,4,511,5,46,25,47,697,107,482421,5
16826,swirl,swRl,5,5,0,2,3,swirl,1,4,486,6,16,5,46,870,57,1251090,5
9215,irresolution,IrEzxluS|n,1,0,1,1,0,irresolution,5,10,743,8,1,0,0,27,2,16585,4
19063,winding,wYndIG,1,1,0,1,0,winding,2,6,688,6,10,11,100,1897,216,2642869,6
18911,whale,hwel,7,4,3,3,4,whale,1,4,469,6,20,16,574,2671,306,5928815,5
10760,meteor,mitiX,1,0,1,0,1,meteor,3,5,446,7,7,2,180,706,30,1321961,6
10782,mica,mYkx,3,2,1,1,2,mica,2,4,442,5,25,19,6,172,9,1101089,5
2363,bushel,bUSL,1,0,1,0,1,bushel,2,5,402,7,5,6,32,212,26,369571,6
8978,intelligence,IntEl|J|ns,1,1,0,0,1,intelligence,4,10,742,11,1,0,983,16073,5323,31536198,10
18168,upgrade,^pgred,1,1,0,1,0,upgrade,2,6,520,8,4,6,110,1872,156,38786223,7
4458,daughter,dctX,1,1,0,1,0,daughter,2,4,353,9,27,3,8739,31767,8892,27936967,5
13598,presume,prIzum,1,0,1,1,0,presume,2,6,572,8,4,8,415,914,296,1277622,7
15110,sanatorium,s@n|torixm,1,1,0,0,1,sanatorium,5,10,710,5,1,0,27,62,6,107511,6
1616,batting,b@tIG,4,4,0,4,0,batting,2,5,321,7,23,13,164,1522,129,2646319,5
365,afghan,@fg@n,1,0,1,0,1,afghan,2,5,566,7,1,2,29,4238,1516,3571609,6
3048,chiding,CYdIG,3,3,0,3,0,chiding,2,5,499,5,8,1,1,80,3,43057,5
13913,puddle,p^dL,10,10,0,8,2,puddle,2,5,336,7,16,8,99,687,38,798026,6
3327,clove,klov,8,6,2,1,7,clove,1,4,482,6,23,14,26,846,16,699197,5
18026,undersized,^ndXsYzd,1,0,1,0,1,undersized,3,8,693,8,1,0,4,162,2,141467,7
1937,bloc,blak,9,7,2,4,5,bloc,1,4,352,5,50,13,48,1321,185,2216058,5
6358,feud,fyud,7,4,3,1,6,feud,1,4,451,5,23,9,66,646,203,688736,5
11120,moose,mus,19,18,1,14,5,moose,1,3,649,6,68,19,282,1604,183,3590020,4
14883,robot,robat,1,1,0,0,1,robot,2,5,408,6,4,4,621,2843,246,12662105,6
3325,cloud,klWd,7,6,1,3,4,cloud,1,4,447,6,26,8,599,6279,665,11340427,5
8132,hunk,h^Gk,14,12,2,10,4,hunk,1,4,389,5,38,28,263,470,69,2559594,5
234,addressee,@drEsi,1,0,1,0,1,addressee,3,6,567,9,2,3,6,164,1,513417,6
8292,image,ImIJ,4,3,1,1,3,image,2,4,405,6,7,2,1154,27874,2858,197884704,5
8728,infection,InfEkS|n,1,0,1,1,0,infection,3,8,589,10,4,3,446,6290,681,15209694,9
10438,marble,marbL,3,3,0,1,2,marble,2,6,410,7,22,9,266,2892,121,6746066,7
16509,strung,str^G,7,6,1,2,5,strung,1,5,579,6,14,7,114,1035,80,828473,6
4004,cortex,kortEks,1,1,0,1,0,cortex,2,7,554,6,3,6,57,684,55,2531867,7
888,apparent,xp@rxnt,1,0,1,1,0,apparent,3,7,567,9,3,0,215,8191,864,9650402,8
6883,funk,f^Gk,9,8,1,9,0,funk,1,4,482,5,33,21,161,909,107,6702720,5
643,amok,xm^k,2,1,1,1,1,amok,2,4,442,4,7,5,26,248,56,463652,4
3367,cock,kak,30,24,6,18,12,cock,1,3,419,5,161,23,580,722,34,37575461,4
18896,welt,wElt,21,17,4,10,11,welt,1,4,438,5,49,24,9,172,5,1003072,5
5550,elite,xlit,13,10,3,7,6,elite,2,4,452,6,16,8,151,6621,687,12688404,5
13036,pipe,pYp,18,17,1,11,7,pipe,1,3,260,5,44,18,989,4822,455,16180632,4
12762,permission,pXmIS|n,2,2,0,2,0,permission,3,7,459,11,2,1,1587,5207,863,40032805,8
4481,dealer,dilX,5,4,1,3,2,dealer,2,4,499,7,65,19,831,3460,606,27299846,5
13612,pretty,prIti,4,3,1,1,3,pretty,2,5,293,7,14,2,20003,41388,17672,51628164,6
14585,repair,rIpEr,2,1,1,1,1,repair,2,5,559,7,3,3,450,5286,693,49514665,6
2720,castigate,k@st|get,1,0,1,0,1,castigate,3,8,688,10,2,3,1,53,11,37332,9
9954,lineman,lYnmxn,1,0,1,0,1,lineman,2,6,391,6,18,8,10,669,27,446265,4
11017,mogul,mogL,4,3,1,1,3,mogul,2,5,499,6,30,4,47,891,159,753098,6
3131,Christmas,krIsmxs,1,1,0,0,1,christmas,2,7,540,10,3,2,6244,16480,4364,68660209,8
2313,bunch,b^nC,8,6,2,6,2,bunch,1,4,353,6,28,13,3003,7631,2625,10355431,5
6855,fuel,fyul,9,6,3,4,5,fuel,1,4,449,5,22,15,876,16237,2656,39148291,5
11916,omen,omxn,6,2,4,6,0,omen,2,4,313,5,70,21,87,335,37,811060,5
2777,caucus,kck|s,1,1,0,1,0,caucus,2,5,659,7,15,2,15,1899,895,1831830,5
4400,dagger,d@gX,1,1,0,0,1,dagger,2,4,390,7,24,6,251,826,38,1421836,5
8373,impatient,ImpeS|nt,2,2,0,1,1,impatient,3,8,678,10,3,2,206,1485,165,902793,9
10417,mantel,m@ntL,5,5,0,2,3,mantel,2,6,519,7,23,17,38,624,55,630116,7
11123,mope,mop,17,15,2,10,7,mope,1,3,316,5,49,25,34,52,4,62808,4
2929,channel,C@nL,6,5,1,1,5,channel,2,5,442,8,23,5,1245,8967,1355,67360048,6
11693,notion,noS|n,5,4,1,5,0,notion,2,5,539,7,10,5,336,10980,1740,7378935,6
5416,earth,RT,12,5,7,7,5,earth,1,2,346,6,53,12,5074,32890,3632,61066829,3
11417,nature,neCX,3,3,0,1,2,nature,2,4,567,7,17,4,2303,37242,3468,80660766,5
9789,legged,lEgd,4,2,2,0,4,legged,1,4,335,6,20,7,7,1316,80,1351011,4
1010,area,@rix,4,2,2,1,3,area,3,4,468,5,33,25,3821,66987,11907,259879222,5
6761,frame,frem,7,5,2,2,5,frame,1,4,471,6,41,13,719,11925,927,46089909,5
5144,dodo,dodo,1,1,0,1,0,dodo,2,4,429,5,12,12,51,71,9,346253,5
15161,satin,s@tN,8,7,1,6,2,satin,2,5,543,6,44,15,133,1086,52,6631071,6
6376,fiddle,fIdL,6,6,0,4,2,fiddle,2,5,338,7,33,13,185,654,116,1794725,6
7110,geology,JialxJi,1,1,0,1,0,geology,4,7,589,7,1,0,47,840,51,6100630,7
12818,pesky,pEski,1,1,0,1,0,pesky,2,5,548,5,6,3,52,369,60,625873,5
5672,enema,Enxmx,1,1,0,0,1,enema,3,5,431,6,2,5,72,79,9,1329511,6
18785,wander,wandX,6,5,1,5,1,wander,2,5,451,7,27,29,299,1732,134,1996154,6
15953,sold,sold,15,12,3,10,5,sold,1,4,579,5,53,25,2655,18763,3095,42980371,5
6833,frost,frcst,1,0,1,0,1,frost,1,5,458,6,9,11,245,2513,269,5943971,6
10597,meal,mil,28,26,2,22,6,meal,1,3,338,5,157,28,1472,8183,920,12937690,4
5184,done,d^n,30,29,1,20,10,done,1,3,358,5,134,47,24737,80191,29967,102821052,4
2606,captivate,k@pt|vet,1,0,1,0,1,captivate,3,8,541,10,1,2,9,69,5,304394,9
12591,peasant,pEzNt,4,2,2,4,0,peasant,2,6,488,8,8,3,205,1508,61,1392268,7
12063,oscillation,asxleS|n,1,1,0,1,0,oscillation,4,8,683,12,2,1,5,239,7,1002305,9
14314,reap,rip,27,25,2,16,11,reap,1,3,442,5,112,22,132,834,83,1793273,4
2073,borough,bRo,11,9,2,3,8,borough,2,3,379,8,101,3,60,546,42,6757768,4
222,adapt,xd@pt,2,2,0,2,0,adapt,2,5,498,6,5,3,134,2618,277,4679868,6
1605,baths,b@Dz,2,2,0,1,1,baths,1,4,466,6,14,12,161,802,58,5707960,4
1906,bleach,bliC,7,5,2,3,4,bleach,1,4,439,7,21,5,118,574,123,1545195,5
7691,hate,het,24,21,3,19,5,hate,1,3,346,5,109,43,10944,11292,3707,21290617,4
3813,contact,kant@kt,1,0,1,0,1,contact,2,7,568,8,4,6,3305,20254,2675,645837580,8
17453,tomb,tum,22,19,3,13,9,tomb,1,3,508,5,60,10,287,1761,191,3894685,4
5212,doubt,dWt,20,17,3,13,7,doubt,1,3,415,6,50,4,3205,17740,4915,20312011,4
9934,lime,lYm,23,19,4,12,11,lime,1,3,503,5,65,31,168,3335,125,5169437,4
12526,patch,p@C,21,21,0,12,9,patch,1,3,489,6,57,15,888,4098,395,40004849,4
14591,repeal,rIpil,3,3,0,1,2,repeal,2,5,463,7,6,7,8,1441,525,2200528,6
6778,fray,fre,18,10,8,10,8,fray,1,3,392,5,65,21,48,834,130,911045,4
16404,stoke,stok,19,13,6,4,15,stoke,1,4,441,6,40,16,60,205,24,2552684,5
9916,lights,lYts,5,3,2,1,4,lights,1,4,460,7,73,11,2877,13553,1515,25305991,5
13687,procession,prxsES|n,1,1,0,1,0,procession,3,8,708,11,3,3,65,1230,167,1146478,9
14155,radial,rediL,1,1,0,0,1,radial,3,6,420,7,7,5,25,440,15,2817226,7
15130,sanitation,s@n|teS|n,1,0,1,1,0,sanitation,4,9,821,7,2,0,60,1109,153,3230169,6
3572,competition,kampxtIS|n,1,1,0,0,1,competition,4,10,719,12,3,1,1066,16961,2210,38886967,11
1586,bask,b@sk,10,7,3,5,5,bask,1,4,469,5,36,26,29,214,17,320641,5
17094,tempo,tEmpo,3,3,0,0,3,tempo,2,5,401,6,7,6,86,939,90,3373848,6
15942,soft,scft,5,3,2,3,2,soft,1,4,569,5,9,10,1633,17070,1275,39446858,5
4419,damned,d@md,3,1,2,0,3,damned,1,4,399,5,19,4,898,2545,215,2567421,4
2835,cemetery,sEmxtEri,1,1,0,0,1,cemetery,4,8,753,8,3,0,443,2880,435,10799517,9
16484,strip,strIp,6,5,1,2,4,strip,1,5,445,6,22,6,800,6175,1088,18714501,6
17157,terrible,tErxbL,1,1,0,1,0,terrible,3,7,478,8,7,2,4795,11455,4543,8610277,6
18390,venal,vinL,6,4,2,4,2,venal,2,5,329,6,10,6,15,80,13,71231,5
14009,put,pUt,14,14,0,11,3,put,1,3,281,4,32,31,42251,117433,39649,115212746,4
18574,vintage,vIntIJ,1,1,0,1,0,vintage,2,6,528,8,2,5,149,3334,265,31841881,7
4217,croon,krun,11,8,3,3,8,croon,1,4,471,6,63,10,12,74,3,67142,5
8340,immoral,ImcrL,2,1,1,2,0,immoral,3,6,429,8,6,1,133,993,283,1062885,5
15308,scum,sk^m,9,6,3,5,4,scum,1,4,574,5,22,10,505,399,60,961366,5
7274,gold,gold,15,12,3,11,4,gold,1,4,486,5,48,30,4026,20940,2324,107505207,5
11618,nomination,namxneS|n,2,2,0,2,0,nomination,4,9,800,11,2,2,122,5010,2705,5784301,10
18906,west,wEst,19,17,2,14,5,west,1,4,451,5,54,34,3088,48401,8756,173357267,5
15764,skit,skIt,14,12,2,4,10,skit,1,4,479,5,33,15,42,217,74,629356,5
6044,expel,IkspEl,1,0,1,0,1,expel,2,6,698,6,2,5,70,407,90,472576,7
2473,calm,kam,17,15,2,8,9,calm,1,4,373,5,40,25,4541,8252,1588,7869271,5
18336,variance,vErixns,2,1,1,0,2,variance,3,7,564,9,4,1,19,3962,28,5714455,8
14817,riding,rYdIG,7,7,0,7,0,riding,2,5,459,7,25,13,1632,7563,928,15211997,6
14384,recourse,rikors,1,1,0,1,0,recourse,2,6,564,6,2,0,38,695,98,1273910,6
17624,transom,tr@nsxm,1,0,1,1,0,transom,2,7,514,8,6,4,6,340,22,423077,8
12821,pest,pEst,19,16,3,14,5,pest,1,4,609,5,51,32,146,1114,54,6639404,5
5247,dramatic,drxm@tIk,2,2,0,2,0,dramatic,3,8,540,9,5,2,499,10145,2193,8613441,9
16141,splash,spl@S,2,0,2,2,0,splash,1,5,568,7,4,2,215,1767,173,4049978,6
10486,marshal,marSL,4,3,1,1,3,marshal,2,6,472,8,26,7,900,1158,236,1909071,7
16331,stem,stEm,4,4,0,0,4,stem,1,4,439,5,28,14,114,5983,922,10780682,5
4487,death,dET,10,9,1,1,9,death,1,3,359,6,41,8,11051,53623,14059,83226647,4
6611,foe,fo,26,17,9,15,11,foe,1,2,369,4,139,37,94,761,93,1557258,3
10603,meant,mEnt,18,15,3,12,6,meant,1,4,320,6,57,6,5316,22296,3264,17833533,5
1621,bay,be,35,22,13,17,18,bay,1,2,262,4,168,46,1236,19167,2111,78975506,3
13076,placate,pleket,1,1,0,0,1,placate,2,6,442,7,1,0,19,228,34,140227,7
4860,diary,dYri,6,4,2,5,1,diary,3,4,485,5,10,4,458,2632,356,14926124,5
18977,whisk,hwIsk,4,2,2,0,4,whisk,1,4,311,6,38,4,29,2445,70,591308,5
12165,overalls,ovXclz,1,0,1,0,1,overalls,3,6,534,8,2,2,52,479,11,616138,6
16664,sullen,s^lxn,2,2,0,2,0,sullen,2,5,457,7,26,8,29,559,21,256348,6
17896,twist,twIst,3,2,1,2,1,twist,1,5,529,6,9,5,643,4017,659,7244706,6
7651,hard,hard,18,16,2,10,8,hard,1,4,458,5,61,40,15700,81753,20615,130070107,5
1941,blonde,bland,5,4,1,5,0,blonde,1,5,464,7,11,6,710,2164,308,24234829,6
12271,pair,pEr,26,22,4,20,6,pair,1,3,381,5,119,22,1900,12997,938,26038054,4
15551,sheen,Sin,21,20,1,14,7,sheen,1,3,619,6,117,15,48,1118,291,1124463,4
16069,spear,spIr,15,13,2,7,8,spear,1,4,482,6,30,16,232,1183,95,2945997,5
14989,rumble,r^mbL,12,8,4,9,3,rumble,2,6,469,7,22,18,139,834,69,1877484,7
15805,slew,slu,15,10,5,7,8,slew,1,3,562,4,45,15,67,739,87,1336497,4
2603,captain,k@pt|n,1,1,0,0,1,captain,2,6,599,8,20,3,10622,11199,1696,17375515,7
6199,fame,fem,24,19,5,14,10,fame,1,3,380,5,63,28,441,5747,1183,10968010,4
6887,furbish,fRbIS,1,1,0,1,0,furbish,2,5,549,8,4,2,0,4,0,21596,6
3993,corridor,kcrxdX,1,1,0,0,1,corridor,3,6,490,9,5,2,284,3631,181,4571967,7
1637,bean,bin,25,23,2,17,8,bean,1,3,429,5,136,41,349,3841,245,8842603,4
3490,combination,kamb|neS|n,1,1,0,1,0,combination,4,10,588,12,1,1,611,10509,1260,28248459,11
15957,solely,soli,11,10,1,7,4,solely,3,5,514,5,8,4,89,3477,301,10091700,4
2175,breeze,briz,9,9,0,1,8,breeze,1,4,556,7,91,6,410,3484,135,4524445,5
5272,drench,drEnC,3,2,1,3,0,drench,1,5,445,7,7,6,11,45,4,204881,6
12855,phallus,f@lxs,5,5,0,5,0,phallus,2,5,586,6,23,0,5,90,6,133392,6
7612,hammock,h@mxk,4,4,0,4,0,hammock,2,5,448,8,20,3,71,534,79,1267376,6
19215,wrought,rct,23,19,4,20,3,wrought,1,3,321,4,79,3,44,1100,48,2345069,3
9632,land,l@nd,14,9,5,11,3,land,1,4,404,5,62,42,4494,43139,5045,103146177,5
4385,czar,zar,9,8,1,9,0,czar,1,3,533,5,73,7,35,879,324,554053,4
5089,distribute,dIstrIbyut,1,0,1,0,1,distribute,3,10,623,11,1,2,76,1672,249,8679272,11
13397,potable,potxbL,2,1,1,2,0,potable,3,7,491,5,2,2,6,195,15,842826,5
10381,mango,m@Ggo,2,2,0,1,1,mango,2,5,508,6,9,19,84,1060,60,2175569,6
17263,thing,TIG,11,10,1,8,3,thing,1,3,445,6,40,15,55522,118041,52393,97462380,4
16742,sure,SUr,9,8,1,7,2,sure,1,3,418,5,52,23,56091,83472,29970,110540101,4
8076,how,hW,18,16,2,9,9,how,1,2,404,4,117,44,155867,351693,113754,571863383,3
11924,once,w^ns,4,2,2,2,2,once,1,4,393,4,17,11,17589,99383,17510,111894502,5
6646,foray,fcre,1,0,1,1,0,foray,2,4,491,6,42,10,22,454,33,507948,5
13032,pinup,pIn^p,1,1,0,1,0,pinup,2,5,419,4,4,0,28,89,17,323824,5
14843,riot,rYxt,2,1,1,1,1,riot,2,4,423,5,29,10,331,1656,493,2668747,5
10131,lottery,latXi,1,1,0,1,0,lottery,3,5,497,7,6,2,344,1828,334,11776450,6
19005,whom,hum,17,16,1,12,5,whom,1,3,374,5,68,11,1795,23359,2991,28679274,4
15498,sewing,soIG,5,4,1,5,0,sewing,2,4,457,4,24,11,198,1245,82,6301885,4
3061,chill,CIl,22,21,1,16,6,chill,1,3,441,6,67,13,828,4094,215,4495239,4
8956,insulin,InsLxn,1,0,1,0,1,insulin,3,7,818,6,3,0,107,1501,135,6039475,8
6573,flour,flWr,5,4,1,1,4,flour,2,4,445,6,24,10,161,5999,241,5162842,5
17361,tilt,tIlt,15,11,4,10,5,tilt,1,4,322,5,30,17,113,1429,146,4925167,5
9349,jockey,Jaki,5,5,0,3,2,jockey,2,4,433,7,36,6,247,752,154,2544228,5
18621,visit,vIz|t,1,0,1,0,1,visit,2,5,449,6,4,3,2993,25292,4079,187070159,6
15018,rupture,r^pCX,1,1,0,1,0,rupture,2,5,419,8,3,3,66,568,53,1145976,6
2508,campus,k@mpxs,1,1,0,1,0,campus,2,6,506,7,12,5,546,11028,1945,47829844,7
16239,stability,stxbIl|ti,1,0,1,1,0,stability,4,9,705,8,1,1,90,7490,1040,14459291,6
3917,cool,kul,22,18,4,17,5,cool,1,3,359,5,138,20,9990,20803,3155,56494542,4
3148,chubby,C^bi,2,1,1,0,2,chubby,2,4,376,6,9,3,213,516,66,6930695,4
1996,bode,bod,27,22,5,17,10,bode,1,3,321,5,121,35,24,470,127,708009,4
12649,pencil,pEnsL,2,1,1,1,1,pencil,2,6,411,7,14,3,503,2880,205,5527529,7
18848,wavy,wevi,4,3,1,2,2,wavy,2,4,449,4,27,9,28,537,17,630746,4
4854,diaper,dYpX,4,4,0,3,1,diaper,2,4,383,7,19,4,218,885,111,3933145,5
11203,mountain,mWntN,2,1,1,1,1,mountain,2,6,507,9,7,2,1805,19965,1722,54172908,7
17130,tent,tEnt,19,17,2,13,6,tent,1,4,334,5,51,34,892,4956,572,6544902,5
14239,rapture,r@pCX,2,2,0,2,0,rapture,2,5,505,8,7,3,44,399,50,1051948,6
5311,drum,dr^m,10,8,2,5,5,drum,1,4,333,5,34,18,432,2549,378,14016572,5
19117,wives,wYvz,5,3,2,3,2,wives,1,4,436,6,38,19,787,4554,849,6031432,3
14931,rotation,roteS|n,3,3,0,3,0,rotation,3,7,637,9,2,2,149,2681,134,7042005,8
17251,thick,TIk,13,12,1,10,3,thick,1,3,259,6,47,6,713,13761,625,14030785,4
9555,Koran,kX@n,5,4,1,2,3,koran,2,5,512,6,18,23,17,768,203,923696,5
15296,scruff,skr^f,1,1,0,0,1,scruff,1,5,538,7,3,3,12,64,4,153549,6
12518,pastor,p@stX,13,6,7,8,5,pastor,2,5,471,7,25,8,219,4587,1151,5915067,6
16813,swell,swEl,10,8,2,6,4,swell,1,4,530,6,31,15,1061,1346,125,2214467,5
9867,liberal,lIbXL,3,1,2,2,1,liberal,2,6,427,8,6,3,203,12469,3405,17294888,7
4640,demand,dxm@nd,1,1,0,1,0,demand,2,6,540,7,4,5,873,16017,2368,44859061,7
1972,blunt,bl^nt,2,1,1,2,0,blunt,1,5,429,6,14,9,250,2124,457,4130075,6
12365,papaya,pxpYx,1,1,0,1,0,papaya,3,5,639,7,1,2,56,321,19,678666,6
15472,serum,sIrM,3,2,1,1,2,serum,2,5,562,4,12,6,191,1280,38,5854942,5
8778,informed,Informd,3,2,1,1,2,informed,2,7,582,8,4,3,633,7984,1011,38215335,7
5936,evil,ivL,6,4,2,4,2,evil,2,4,404,5,14,8,3731,8983,1808,25718442,5
13929,pull,pUl,16,15,1,12,4,pull,1,3,288,5,55,22,7469,17128,3784,19062074,4
4279,cuddle,k^dL,10,9,1,7,3,cuddle,2,5,275,7,28,7,110,234,23,531391,6
14211,ranch,r@nC,5,3,2,2,3,ranch,1,4,485,6,23,10,895,5387,679,10539650,5
15465,series,sIriz,1,1,0,0,1,series,2,5,532,7,19,5,1028,35146,5406,161521807,5
5265,dreamer,drimX,3,1,2,1,2,dreamer,2,5,529,8,20,6,155,425,34,1395641,6
6809,fright,frYt,13,9,4,7,6,fright,1,4,459,7,30,7,141,539,77,819010,5
1778,better,bEtX,8,7,1,6,2,better,2,4,330,7,75,32,40494,105370,23844,157088065,5
2009,bold,bold,18,14,4,11,7,bold,1,4,499,5,70,27,385,4302,699,18244843,5
15474,serve,sRv,14,10,4,7,7,serve,1,3,607,6,44,15,1935,23965,2931,36697856,4
9188,ironic,YranIk,3,2,1,3,0,ironic,3,6,546,7,4,3,312,2459,444,1760165,7
16756,surplus,sRpl^s,1,1,0,0,1,surplus,2,6,587,8,0,0,104,2174,538,7300282,7
18456,verse,vRs,15,12,3,10,5,verse,1,3,461,6,44,15,238,1818,173,7470005,4
17650,traumatic,trxm@tIk,2,2,0,2,0,traumatic,3,8,530,9,0,0,138,2615,557,2450877,5
1499,bang,b@G,19,18,1,8,11,bang,1,3,448,5,68,38,1019,2963,592,17605934,4
3461,collusion,kxluZ|n,1,1,0,1,0,collusion,3,7,562,8,4,1,15,358,51,558087,5
4921,dimple,dImpL,3,3,0,3,0,dimple,2,6,539,7,9,6,19,192,23,200542,7
7977,homicide,hamxsYd,1,0,1,0,1,homicide,3,7,611,9,1,1,782,2546,1041,1746492,8
8504,inborn,Inborn,1,1,0,0,1,inborn,2,6,698,5,2,2,4,146,9,211104,6
758,annoy,xnO,2,2,0,1,1,annoy,2,3,429,6,13,4,128,311,58,1497815,4
16944,tall,tcl,27,22,5,22,5,tall,1,3,318,5,94,33,1649,13194,1011,14325877,4
12141,outright,WtrYt,2,1,1,2,0,outright,2,5,427,7,5,2,63,2001,316,1852605,5
15779,slant,sl@nt,4,2,2,3,1,slant,1,5,465,6,15,12,58,458,32,1313083,6
17412,title,tYtL,10,8,2,5,5,title,2,5,311,6,23,6,947,14579,1630,196685478,6
18671,voice,vOs,7,6,1,4,3,voice,1,3,549,6,31,7,4394,76422,35523,64616737,4
2823,cellar,sElX,10,6,4,3,7,cellar,2,4,422,7,113,6,478,1152,44,3002258,5
4500,debt,dEt,28,24,4,17,11,debt,1,3,250,5,87,12,725,14398,4802,51349877,4
4528,deck,dEk,20,19,1,11,9,deck,1,3,309,5,103,32,1212,6451,516,16091750,4
17805,tuba,tubx,4,3,1,0,4,tuba,2,4,459,5,23,22,61,171,44,868026,5
15831,slot,slat,17,15,2,9,8,slot,1,4,554,5,37,27,280,2276,241,21605592,5
11446,nebulous,nEbyUlxs,1,0,1,0,1,nebulous,3,8,545,6,1,0,3,219,16,197647,8
17830,tumor,tumX,4,3,1,1,3,tumor,2,4,429,6,26,7,263,2659,406,7430725,5
11771,oak,ok,25,12,13,13,12,oak,1,2,300,4,111,27,286,5688,228,20581030,3
8082,howsoever,hWsoEvX,1,1,0,1,0,howsoever,4,7,738,6,1,0,3,6,0,140798,4
17322,thumb,T^m,15,13,2,12,3,thumb,1,3,432,6,50,6,603,3839,334,7284938,4
9549,known,non,26,22,4,18,8,known,1,3,432,6,107,4,6300,57261,9600,86396724,4
19075,wing,wIG,18,15,3,8,10,wing,1,3,479,5,90,40,1032,8370,2064,17354423,4
11462,needle,nidL,6,5,1,3,3,needle,2,5,293,7,21,5,608,2635,389,5708341,6
3221,civility,sxvIl|ti,1,1,0,1,0,civility,4,8,642,7,2,0,28,769,185,440289,6
2281,buffer,b^fX,4,3,1,2,2,buffer,2,4,397,7,29,10,85,1218,94,15904074,5
3452,collie,kali,12,10,2,6,6,collie,2,4,441,7,143,19,53,236,16,1191722,5
4333,curt,kRt,26,21,5,17,9,curt,1,3,303,5,99,19,136,1162,120,1581069,4
14147,racial,reSL,2,2,0,1,1,racial,2,5,462,7,13,4,159,10753,1997,7549723,6
3481,column,kalM,2,2,0,0,2,column,2,5,380,7,28,1,559,7464,1245,35987108,6
9293,jargon,Jarg|n,1,1,0,1,0,jargon,2,6,579,4,8,2,31,638,62,1804602,4
10061,local,lokL,2,2,0,2,0,local,2,5,437,6,16,8,2128,61949,8211,270753545,6
15024,Russian,r^S|n,1,1,0,1,0,russian,2,5,406,8,15,5,1501,15633,3667,45324696,6
6804,friction,frIkS|n,2,1,1,2,0,friction,2,7,538,9,3,3,63,1601,148,3001167,8
2602,capsule,k@psL,3,1,2,2,1,capsule,2,6,495,8,13,1,130,1201,191,3315216,7
2159,bread,brEd,15,12,3,7,8,bread,1,4,327,6,45,18,1445,10191,846,13576239,5
15414,sensation,sEnseS|n,1,0,1,1,0,sensation,3,8,758,10,2,1,249,3131,303,3346679,9
9317,jersey,JRzi,1,1,0,0,1,jersey,2,4,668,7,11,3,923,10792,3419,48661242,5
12266,paid,ped,22,18,4,13,9,paid,1,3,529,4,82,19,4369,25590,5940,60295896,4
14862,rival,rYvL,5,3,2,3,2,rival,2,5,475,6,19,4,193,4212,634,4298220,6
6282,feat,fit,24,19,5,17,7,feat,1,3,346,5,67,20,78,1263,105,5369388,4
669,an,@n,22,11,11,14,8,an,1,2,393,3,109,75,95071,827024,153847,1518266684,3
8764,inflict,InflIkt,1,1,0,0,1,inflict,2,7,708,8,2,2,69,646,133,647531,8
9364,jolly,Jali,8,8,0,6,2,jolly,2,4,589,6,65,18,382,669,97,2522302,5
14118,quits,kwIts,3,1,2,0,3,quits,1,5,468,5,21,11,121,421,145,968433,5
10600,mean,min,23,21,2,17,6,mean,1,3,539,5,126,26,63443,113771,68669,80317535,4
2976,chassis,C@si,4,3,1,2,2,chassis,2,4,506,6,29,1,33,565,19,5955012,4
12692,pep,pEp,15,14,1,9,6,pep,1,3,255,4,67,27,178,596,95,3019755,4
12438,parlance,parlxns,1,0,1,0,1,parlance,2,7,567,6,0,1,15,295,18,199873,6
7239,glue,glu,11,7,4,8,3,glue,1,3,389,5,38,12,300,2071,140,4435595,4
11665,normally,normLi,1,0,1,0,1,normally,2,6,529,7,7,2,818,7905,1911,19884097,5
14714,retard,rItard,1,1,0,1,0,retard,2,6,459,7,3,10,201,237,23,643417,7
10082,lofty,lcfti,1,0,1,0,1,lofty,2,5,428,5,7,5,40,928,68,1018661,6
9127,invention,InvEnC|n,2,2,0,2,0,invention,3,8,584,10,1,2,310,2477,236,8227022,9
12217,ovum,ovM,3,3,0,1,2,ovum,2,4,503,4,6,3,7,34,1,305631,4
4823,devoid,dxvOd,2,1,1,1,1,devoid,2,5,549,6,3,0,36,911,37,946561,4
1356,aversion,xvRZ|n,1,0,1,1,0,aversion,3,6,533,9,2,2,68,599,29,828197,7
10582,maybe,mebi,2,2,0,1,1,maybe,2,4,668,6,32,10,47249,68412,23224,51905745,4
1341,avail,xvel,2,1,1,2,0,avail,2,4,481,6,10,3,43,640,73,3902711,5
10083,log,lcg,13,12,1,8,5,log,1,3,401,4,46,42,610,4672,509,111172980,4
1246,attend,xtEnd,5,4,1,5,0,attend,2,5,515,7,11,1,715,8415,924,20639654,6
18820,wary,w@ri,11,10,1,9,2,wary,2,4,539,4,99,35,38,2227,207,1303191,5
11674,nose,noz,18,15,3,9,9,nose,1,3,474,5,132,31,3557,12167,1296,10507658,4
4594,defy,dIfY,4,2,2,0,4,defy,2,4,617,5,12,6,158,922,163,800149,5
10395,manifesto,m@nxfEsto,1,0,1,0,1,manifesto,4,9,854,9,3,2,37,601,60,2008582,9
5541,elevator,ElxvetX,1,0,1,0,1,elevator,4,7,448,9,3,1,1245,3511,432,4174699,8
3010,cheese,Ciz,13,12,1,9,4,cheese,1,3,574,7,130,6,1991,12453,1067,16705545,4
1900,blast,bl@st,3,1,2,3,0,blast,1,5,456,6,15,15,825,3701,686,9388686,6
17194,thank,T@Gk,11,10,1,11,0,thank,1,4,449,6,33,12,56877,58298,45397,63239921,5
14658,reside,rIzYd,3,1,2,1,2,reside,2,5,582,7,6,8,56,1094,57,2799223,6
3296,climb,klYm,5,4,1,3,2,climb,1,4,394,6,39,3,1007,6010,612,5699767,5
16427,stout,stWt,6,5,1,4,2,stout,1,4,424,6,12,12,53,1100,69,1939719,5
4249,cruiser,kruzX,1,0,1,0,1,cruiser,2,5,414,8,18,5,162,1204,65,3735652,6
15802,slender,slEndX,3,2,1,3,0,slender,2,6,489,5,13,8,38,1924,49,1614730,5
9310,jelly,JEli,5,4,1,3,2,jelly,2,4,381,6,88,10,363,1635,176,3699680,5
17384,tinker,tIGkX,4,3,1,1,3,tinker,2,5,549,7,15,15,113,576,71,983290,6
10060,lobster,labstX,1,1,0,1,0,lobster,2,6,532,8,3,2,374,1401,144,2997879,7
3280,clench,klEnC,4,4,0,3,1,clench,1,5,529,7,11,2,20,183,6,97203,6
4763,desk,dEsk,3,2,1,2,1,desk,1,4,394,5,24,12,2239,12637,1258,32311856,5
4635,delusion,dxluZ|n,1,1,0,1,0,delusion,3,7,520,9,4,2,138,476,34,677674,8
58,aboriginal,@bXIJ|nL,1,1,0,0,1,aboriginal,5,9,618,9,0,0,9,1486,73,7046324,8
15214,scare,skEr,11,8,3,5,6,scare,1,4,504,6,31,19,1712,2598,783,2974150,5
7207,glen,glEn,2,2,0,0,2,glen,1,4,461,5,16,14,366,2034,238,9310381,5
17775,trout,trWt,8,6,2,3,5,trout,1,4,366,6,28,15,205,3079,67,5371003,5
3068,china,CYnx,1,1,0,1,0,china,2,4,376,6,12,12,1268,33457,5907,124480409,5
15895,snide,snYd,3,2,1,2,1,snide,1,4,618,6,17,5,28,136,11,240578,5
2358,burst,bRst,15,14,1,12,3,burst,1,4,432,6,57,15,435,5127,438,5148007,5
6094,extend,IkstEnd,1,1,0,1,0,extend,2,7,578,7,3,3,327,6057,924,15097418,8
17688,triad,trY@d,1,0,1,0,1,triad,2,5,471,6,3,6,175,486,16,1520756,6
361,afford,xford,4,3,1,4,0,afford,2,5,551,7,9,9,2266,10414,2779,10348210,6
915,applied,xplYd,3,1,2,1,2,applied,2,5,567,7,8,1,314,12092,978,44960208,5
11281,muscle,m^sL,11,10,1,5,6,muscle,2,5,408,7,30,3,694,7220,607,20753198,6
3275,cleave,kliv,6,5,1,2,4,cleave,1,4,455,7,27,6,10,101,7,413105,5
12480,partition,pXtIS|n,3,3,0,3,0,partition,3,8,660,10,2,1,25,964,88,6700858,9
10296,maize,mez,19,16,3,9,10,maize,1,3,359,6,168,7,9,789,21,2224269,4
18106,unknown,^non,1,0,1,1,0,unknown,2,5,588,8,0,1,774,7435,958,48332261,5
12627,peg,pEg,10,10,0,5,5,peg,1,3,307,4,53,23,1857,907,77,3808952,4
16307,statue,st@Cu,2,1,1,0,2,statue,2,5,593,7,4,7,540,2959,398,4753368,6
12567,paunch,pcnC,5,4,1,4,1,paunch,1,4,419,7,10,4,1,132,5,38730,5
7600,halo,helo,5,4,1,4,1,halo,2,4,507,5,25,21,82,840,49,6198204,5
15362,seduce,sIdus,3,2,1,3,0,seduce,2,5,649,7,4,6,176,415,61,586830,6
5279,drift,drIft,5,3,2,5,0,drift,1,5,413,6,11,5,327,2435,178,3894170,6
4359,cutter,k^tX,12,9,3,9,3,cutter,2,4,350,7,51,19,239,1975,122,4273722,5
13966,pupa,pyupx,2,2,0,0,2,pupa,2,5,409,5,2,14,14,60,0,253862,6
10745,metal,mEtL,11,9,2,9,2,metal,2,5,293,6,40,8,992,12972,805,56196995,6
18296,validity,vxlId|ti,1,1,0,1,0,validity,4,8,679,6,2,0,30,4794,143,6132692,6
5255,draughts,dr@fts,2,1,1,0,2,draughts,1,6,518,8,12,3,5,31,1,159789,7
15552,sheep,Sip,20,19,1,13,7,sheep,1,3,330,6,88,13,685,3726,348,8964154,4
14374,reconnaissance,rIkan|z|ns,1,0,1,1,0,reconnaissance,4,10,818,7,0,0,88,650,127,1304699,6
826,antique,@ntik,2,1,1,0,2,antique,2,5,425,8,9,1,309,2637,92,18431642,6
5709,entail,Intel,2,2,0,1,1,entail,2,5,524,7,1,2,29,732,52,1041373,5
6737,foul,fWl,17,14,3,16,1,foul,1,3,655,5,57,14,738,2438,419,5268620,4
9666,larder,lardX,2,0,2,1,1,larder,2,5,504,6,12,15,8,93,2,337331,5
6190,fallow,f@lo,12,10,2,11,1,fallow,2,4,506,7,38,14,41,269,8,411349,5
2262,bubble,b^bL,10,10,0,8,2,bubble,2,5,402,7,24,10,408,3183,559,8808334,6
15224,scene,sin,29,27,2,18,11,scene,1,3,529,6,150,5,3807,25272,6387,29373796,4
15574,shine,SYn,21,17,4,17,4,shine,1,3,503,6,85,26,1053,2573,296,5890894,4
11323,mutton,m^tN,4,3,1,2,2,mutton,2,5,579,5,24,10,40,157,4,389582,5
10954,missal,mIsL,5,4,1,2,3,missal,2,5,380,5,46,1,4,95,0,117461,6
14403,rectory,rEktXi,1,0,1,0,1,rectory,3,6,529,7,1,1,27,146,19,365174,6
14257,ratify,r@t|fY,1,0,1,1,0,ratify,3,6,572,7,4,2,6,330,85,670714,7
12267,pail,pel,34,32,2,25,9,pail,1,3,237,5,135,34,48,342,30,542968,4
11864,ocular,akyUlX,1,0,1,1,0,ocular,3,6,477,5,1,1,21,183,2,973769,5
6943,gait,get,28,24,4,19,9,gait,1,3,304,5,84,20,16,1088,15,822923,4
7696,haunch,hcnC,4,4,0,3,1,haunch,1,4,519,5,11,5,4,68,0,33851,5
6493,flake,flek,11,8,3,3,8,flake,1,4,537,6,24,12,89,451,70,849585,5
15849,small,smcl,5,4,1,2,3,small,1,4,537,6,19,10,6373,102490,12092,208378995,5
12206,overthrow,ovXTro,1,1,0,0,1,overthrow,3,6,600,10,3,3,69,1067,313,931526,7
13627,pride,prYd,12,9,3,4,8,pride,1,4,466,6,30,11,1411,7442,966,14445194,5
4436,dank,d@Gk,12,10,2,12,0,dank,1,4,367,5,39,31,28,345,7,355502,5
18290,valet,v@l|t,3,3,0,3,0,valet,2,4,414,5,15,6,263,505,20,2052690,4
6619,folio,folio,2,1,1,2,0,folio,3,5,569,5,8,6,4,164,3,1842202,5
14069,quarrel,kwcrL,2,1,1,1,1,quarrel,2,6,427,8,9,2,286,630,125,590286,7
12349,pant,p@nt,17,12,5,10,7,pant,1,4,367,5,50,32,49,419,44,3138558,5
13656,prism,prIzM,2,2,0,1,1,prism,2,6,331,6,4,11,41,525,73,2657902,7
17536,tourist,tUr|st,1,1,0,1,0,tourist,2,6,479,8,5,4,237,3671,532,15046652,7
12164,overall,ovXcl,3,0,3,0,3,overall,3,5,547,8,3,2,164,20299,2377,78994026,6
1679,beer,bIr,29,26,3,21,8,beer,1,3,454,5,114,39,3850,10884,1341,20488618,4
7365,graphic,gr@fIk,1,1,0,1,0,graphic,2,6,467,8,6,1,119,4093,1146,32781798,7
4213,crone,kron,14,9,5,6,8,crone,1,4,439,6,69,27,22,124,16,229759,5
600,amber,@mbX,5,3,2,4,1,amber,2,4,497,6,18,14,473,2604,238,11066821,5
2521,cancellation,k@nsxleS|n,1,1,0,1,0,cancellation,4,10,664,13,2,1,65,466,60,8183513,11
8141,hurry,hRi,13,11,2,5,8,hurry,2,3,389,6,84,12,8856,3688,567,3538466,4
1614,batter,b@tX,19,15,4,12,7,batter,2,4,288,7,51,26,203,2072,125,1677096,5
618,amend,xmEnd,8,5,3,7,1,amend,2,5,675,6,10,8,38,597,114,7806844,6
14879,rob,rab,17,16,1,14,3,rob,1,3,452,4,85,42,1188,4730,1441,17021598,4
63,about,xbWt,4,3,1,1,3,about,2,4,464,6,9,6,185206,693701,249031,1226763335,5
7250,gnaw,nc,19,16,3,11,8,gnaw,1,2,391,5,79,6,19,123,5,97994,3
13940,pulse,p^ls,2,1,1,0,2,pulse,1,4,499,6,17,5,1200,3509,339,18900029,5
2385,buy,bY,29,23,6,17,12,buy,1,2,362,4,133,28,9814,33392,8842,410791202,3
15776,slam,sl@m,13,12,1,3,10,slam,1,4,504,5,36,35,296,2051,335,3855126,5
1094,artless,artlxs,1,0,1,1,0,artless,2,6,459,6,3,1,3,55,4,90304,5
14847,ripen,rYpxn,1,1,0,1,0,ripen,2,5,411,6,15,5,14,246,12,192231,6
9907,lift,lIft,11,10,1,6,5,lift,1,4,458,5,31,17,1741,8648,1242,15299610,5
10459,mark,mark,20,14,6,7,13,mark,1,4,408,5,86,36,4183,31538,9399,95624252,5
10622,medial,midiL,1,1,0,1,0,medial,2,6,403,6,2,8,21,356,10,931159,4
7924,hiss,hIs,14,14,0,5,9,hiss,1,3,437,5,70,19,47,885,29,497852,4
6734,fossil,fasL,4,4,0,4,0,fossil,2,5,459,7,18,2,79,2789,263,5293638,6
4107,crabby,kr@bi,3,1,2,1,2,crabby,2,5,469,6,16,4,47,89,14,214907,6
13393,posture,pasCX,1,1,0,1,0,posture,2,5,589,8,3,2,88,2403,275,2045913,6
14020,putty,p^ti,9,8,1,5,4,putty,2,4,303,5,33,7,93,254,26,1071931,5
3156,chunk,C^Gk,10,9,1,9,1,chunk,1,4,415,6,28,13,211,1787,262,2371231,5
2914,chamois,S@mi,5,4,1,2,3,chamois,2,4,584,6,23,0,11,139,3,356783,4
14508,reject,rIJEkt,1,0,1,1,0,reject,2,6,529,7,5,6,216,2856,554,6378272,7
14244,rarity,r@rxti,1,1,0,1,0,rarity,3,6,507,6,4,4,20,587,39,847526,5
18497,veto,vito,2,2,0,0,2,veto,2,4,365,5,29,16,46,2512,1135,1621850,5
15750,ski,ski,9,3,6,4,5,ski,1,3,593,4,76,24,413,8483,362,28672058,4
18398,veneer,vxnIr,1,1,0,1,0,veneer,2,5,521,7,2,5,45,424,36,1313843,6
15632,shroud,SrWd,4,4,0,2,2,shroud,1,4,577,7,9,3,52,437,35,724966,5
15841,slump,sl^mp,5,3,2,4,1,slump,1,5,377,6,16,12,61,1054,118,878659,6
16636,suffer,s^fX,7,6,1,3,4,suffer,2,4,501,7,44,13,1148,6609,1232,8734050,5
17711,trident,trYdNt,1,0,1,1,0,trident,2,7,395,6,1,1,24,121,10,1078613,5
12322,pan,p@n,31,25,6,19,12,pan,1,3,405,4,106,57,627,11476,986,21823461,4
2376,butte,byut,5,3,2,4,1,butte,1,4,489,6,23,9,27,578,23,2505600,5
11936,onto,cntu,2,2,0,2,0,onto,2,4,448,5,4,12,1871,26374,2178,26411994,5
16197,sprung,spr^G,3,3,0,1,2,sprung,1,5,482,7,6,6,131,832,90,1081658,6
1141,assail,xsel,2,1,1,2,0,assail,2,4,486,7,8,2,5,52,5,141995,5
7173,girdle,gRdL,6,5,1,2,4,girdle,2,5,362,7,7,3,79,170,17,596431,6
9458,keg,kEg,8,8,0,4,4,keg,1,3,359,4,42,18,175,275,51,637688,4
2294,Bulgarian,b^lg@rixn,1,1,0,1,0,bulgarian,4,9,664,10,3,2,14,254,22,7056806,10
15823,sliver,slIvX,6,5,1,3,3,sliver,2,5,649,7,12,18,23,592,67,405379,6
3844,continuous,kxntInyuxs,1,1,0,0,1,continuous,4,10,712,11,4,1,98,5178,223,21878180,11
8895,inshore,InSor,2,2,0,1,1,inshore,2,5,668,4,4,2,5,400,1,468908,4
9525,knavery,nevXi,1,0,1,0,1,knavery,3,6,649,6,0,0,1,6,0,19031,5
6331,fennel,fEnL,8,7,1,3,5,fennel,2,5,470,7,26,8,39,1060,39,534724,6
17266,third,TRd,7,7,0,6,1,third,1,3,413,6,34,3,3801,51534,7356,95490673,4
2489,cam,k@m,27,22,5,15,12,cam,1,3,376,4,118,51,193,1254,178,24003561,4
1693,begin,bxgIn,1,1,0,0,1,begin,2,5,382,6,16,12,2906,34646,13324,45437405,6
13117,platinum,pl@tNM,1,0,1,0,1,platinum,2,7,486,9,2,0,123,1138,144,15501355,8
9401,juicy,Jusi,1,0,1,0,1,juicy,2,4,413,5,26,1,219,1192,150,3780327,5
13417,pouch,pWC,10,10,0,8,2,pouch,1,3,364,6,34,13,87,940,64,4023912,4
16926,tactile,t@ktL,4,1,3,2,2,tactile,2,6,555,6,1,0,18,789,27,863413,5
6024,exist,IgzIst,1,1,0,0,1,exist,2,6,530,6,2,6,1477,12500,1965,25349517,7
9536,knight,nYt,24,22,2,19,5,knight,1,3,363,7,76,3,1365,3008,341,12571023,4
5305,drowse,drWz,7,4,3,4,3,drowse,1,4,477,7,26,6,3,13,1,15193,5
13038,piping,pYpIG,1,1,0,1,0,piping,2,5,540,5,7,4,36,647,33,2612878,4
1912,bled,blEd,12,9,3,6,6,bled,1,4,509,5,25,15,201,534,58,620251,5
9738,leaf,lif,25,24,1,11,14,leaf,1,3,439,5,90,16,265,4982,268,13162390,4
8317,immanent,ImxnEnt,1,1,0,0,1,immanent,3,7,450,8,3,1,0,204,0,130985,8
7735,heartless,hartlxs,1,0,1,1,0,heartless,2,7,559,7,4,1,179,302,61,446382,7
8008,hoop,hup,17,15,2,12,5,hoop,1,3,344,5,80,23,137,816,59,2310001,4
17781,truck,tr^k,9,5,4,2,7,truck,1,4,372,6,28,13,3716,12906,2120,32136793,5
8075,hover,h^vX,2,2,0,1,1,hover,2,4,312,6,17,23,59,599,39,1553261,5
15233,schism,sIzM,3,2,1,1,2,schism,2,6,481,7,1,5,3,242,18,333428,7
18570,vine,vYn,21,19,2,14,7,vine,1,3,589,5,78,35,107,1364,55,3646886,4
13974,puree,pyUre,1,0,1,0,1,puree,2,5,444,5,3,8,9,889,28,438733,5
17572,traffic,tr@fIk,2,2,0,1,1,traffic,2,6,447,8,5,0,1454,13174,1945,57242495,7
15993,sonnet,san|t,3,3,0,3,0,sonnet,2,5,412,7,12,8,39,211,7,1081841,6
5510,elder,EldX,2,2,0,1,1,elder,2,4,472,6,27,22,359,2693,217,7299470,5
8313,imitate,Imxtet,2,2,0,1,1,imitate,3,6,363,8,3,2,92,776,86,714445,7
17209,theme,Tim,8,8,0,6,2,theme,1,3,337,6,45,11,710,9977,2251,37221872,4
10639,medium,midixm,2,2,0,1,1,medium,3,6,450,7,6,2,362,16640,642,51332199,7
17274,thong,TcG,9,7,2,7,2,thong,1,3,371,5,33,8,107,304,46,7748002,3
10789,micron,mYkran,1,1,0,1,0,micron,2,6,495,7,2,6,3,291,9,1995772,7
3423,coil,kOl,18,16,2,15,3,coil,1,3,380,5,82,19,82,676,30,5001819,4
9567,lab,l@b,20,18,2,10,10,lab,1,3,488,4,77,47,2020,8495,1247,35532276,4
18380,veined,vend,2,1,1,1,1,veined,1,4,538,5,23,2,0,155,0,178060,4
9367,josh,JaS,7,7,0,2,5,josh,1,3,481,5,29,16,1039,4341,973,9172255,4
7074,generator,JEnXetX,1,0,1,0,1,generator,4,7,597,10,4,1,290,1511,125,13043202,8
8092,hug,h^g,21,21,0,12,9,hug,1,3,258,4,65,38,986,2857,650,2946687,4
5792,equator,IkwetX,1,0,1,0,1,equator,3,6,523,8,3,1,31,600,43,1014051,7
13765,prone,pron,12,9,3,6,6,prone,1,4,355,5,39,17,92,2783,238,3001079,5
12586,peak,pik,31,25,6,20,11,peak,1,3,350,5,117,22,303,7313,573,25381726,4
18178,upon,xpcn,3,2,1,2,1,upon,2,4,472,3,9,3,3199,35602,3963,103923032,5
5458,eddy,Edi,5,2,3,5,0,eddy,2,3,275,4,72,14,184,845,47,2589078,4
12535,pathetic,pxTEtIk,2,1,1,2,0,pathetic,3,7,522,9,1,1,1234,1329,234,1892242,8
17770,trouble,tr^bL,5,4,1,3,2,trouble,2,6,365,8,17,4,11401,22552,6621,24522535,7
3205,circus,sRk|s,1,1,0,0,1,circus,2,5,631,7,9,1,870,2220,510,5381242,6
19147,woodman,wUdmxn,3,1,2,2,1,woodman,2,6,419,8,20,4,18,80,1,481919,7
17698,tribune,trIbyun,1,1,0,0,1,tribune,2,7,623,8,2,1,103,2194,503,8797383,8
13227,pole,pol,33,29,4,24,9,pole,1,3,394,5,137,43,642,4339,486,9378054,4
3438,collapse,kxl@ps,1,0,1,1,0,collapse,2,6,659,9,2,2,283,6218,1177,8393295,7
16730,suppose,sxpoz,2,0,2,1,1,suppose,2,5,626,8,5,2,6416,7894,1907,11981451,6
14872,road,rod,29,26,3,17,12,road,1,3,385,5,141,27,5709,42126,6729,131806092,4
8153,hutch,h^C,16,15,1,6,10,hutch,1,3,549,6,51,11,184,289,19,1373960,4
3962,corn,korn,20,14,6,11,9,corn,1,4,410,5,93,38,725,9077,780,10726347,5
14204,ramp,r@mp,14,10,4,10,4,ramp,1,4,365,5,40,29,147,1831,210,4374407,5
6407,filing,fYlIG,3,2,1,3,0,filing,2,5,423,7,21,14,232,2639,572,15480489,6
17042,technical,tEknIkL,1,0,1,0,1,technical,3,8,480,10,4,1,420,11629,1259,102794976,9
6465,fit,fIt,28,25,3,20,8,fit,1,3,235,4,79,32,2937,19475,2436,42360098,4
7030,gather,g@DX,4,4,0,2,2,gather,2,4,509,7,12,11,799,6044,1272,7692892,5
5280,drill,drIl,12,10,2,7,5,drill,1,4,285,6,23,11,701,3456,690,8248787,5
7859,hers,hRz,13,12,1,6,7,hers,1,3,408,5,103,45,802,4760,431,2075721,4
18500,via,vYx,7,5,2,1,6,via,2,3,549,4,64,35,180,9893,607,97175775,4
13193,ply,plY,12,8,4,6,6,ply,1,3,345,4,41,14,16,340,20,1826809,4
8079,however,hWEvX,1,1,0,1,0,however,3,5,478,5,3,0,2299,89234,5585,163966665,3
13250,pollster,polstX,3,2,1,3,0,pollster,2,6,471,9,8,3,0,739,324,199553,7
10679,menace,mEn|s,2,2,0,2,0,menace,2,5,649,7,16,6,190,906,176,1724011,6
9409,jump,J^mp,8,8,0,8,0,jump,1,4,373,5,18,11,3561,10080,2445,44142166,5
9042,internal,IntRnL,5,2,3,2,3,internal,3,7,474,9,4,3,502,14226,1344,52519712,8
18929,whence,hwEns,2,0,2,1,1,whence,1,4,479,5,32,2,53,270,13,1196735,5
11263,mumble,m^mbL,6,5,1,6,0,mumble,2,6,373,7,12,10,40,230,15,205590,7
18018,underplay,^ndXple,1,0,1,0,1,underplay,3,7,508,10,3,2,1,20,2,17041,8
16625,suck,s^k,25,20,5,15,10,suck,1,3,406,5,80,28,1779,1616,213,22523935,4
13185,plus,pl^s,6,5,1,1,5,plus,1,4,418,5,33,14,2399,22795,5076,94737923,5
7538,Gypsy,JIpsi,1,1,0,1,0,gypsy,2,5,439,5,3,0,338,803,97,2202190,6
9321,jet,JEt,20,17,3,14,6,jet,1,3,350,4,74,30,721,5757,1077,16680047,4
1398,axis,@ks|s,1,1,0,0,1,axis,2,5,452,4,8,9,81,2131,162,12408450,5
5091,distributor,dIstrIbyutX,1,0,1,0,1,distributor,4,11,567,12,2,1,78,757,87,11002174,12
4071,courier,kRiX,2,1,1,1,1,courier,3,4,458,8,28,6,168,704,78,8405086,5
12106,outdoor,Wtdor,1,0,1,0,1,outdoor,2,5,561,8,2,1,93,5517,297,53464306,6
12891,phlegm,flEm,7,6,1,0,7,phlegm,1,4,390,7,28,0,34,95,3,155866,5
18706,vote,vot,15,13,2,12,3,vote,1,3,458,5,44,18,1751,28504,15292,58390459,4
16623,such,s^C,12,11,1,6,6,such,1,3,460,5,39,17,14852,206546,16825,380733306,4
13830,protector,prxtEktX,1,0,1,0,1,protector,3,8,529,10,5,2,149,660,83,4130107,9
15033,rut,r^t,28,25,3,18,10,rut,1,3,317,4,90,36,78,710,37,557418,4
5872,eternal,ItRnL,2,1,1,2,0,eternal,3,6,471,8,3,1,547,2514,211,7052882,7
3218,civic,sIvIk,1,1,0,1,0,civic,2,5,640,6,9,3,110,4321,274,10286751,6
12830,pet,pEt,30,25,5,20,10,pet,1,3,259,4,99,46,1029,4668,778,45452913,4
4244,crude,krud,11,9,2,4,7,crude,1,4,429,6,44,11,155,3293,643,5119510,5
18994,whiting,hwYtIG,1,1,0,0,1,whiting,2,5,336,8,26,10,31,398,7,1044301,6
7373,gratification,gr@t|fxkeS|n,1,0,1,1,0,gratification,5,12,848,8,1,1,42,632,74,607049,7
7018,gas,g@s,19,15,4,11,8,gas,1,3,410,4,80,59,3457,25476,5006,71524611,4
276,ado,xdu,4,1,3,2,2,ado,2,3,347,4,18,29,77,253,60,1581917,4
6153,facial,feSL,3,3,0,1,2,facial,2,5,614,7,8,2,293,2509,208,12721452,6
16414,stooge,stuJ,4,3,1,0,4,stooge,1,4,589,7,18,2,56,60,7,111159,5
7964,holly,hali,11,11,0,6,5,holly,2,4,372,6,90,22,548,2508,454,6835563,5
5642,emulsion,Im^lS|n,1,0,1,1,0,emulsion,3,7,678,7,1,0,8,174,7,856056,5
16021,sought,sct,24,19,5,18,6,sought,1,3,456,4,64,7,240,10896,813,12399522,4
5944,ewe,yu,30,20,10,24,6,ewe,1,2,519,4,186,22,16,258,6,455654,3
17648,trash,tr@S,7,6,1,4,3,trash,1,4,466,6,26,8,1146,4581,809,7097772,5
11173,mortify,mort|fY,1,1,0,1,0,mortify,3,7,631,7,1,1,7,10,1,33359,6
6562,flop,flap,9,7,2,5,4,flop,1,4,354,5,18,18,118,836,240,2648219,5
13318,porch,porC,7,5,2,2,5,porch,1,4,470,6,25,16,491,5514,271,3420626,5
15595,shone,Son,23,20,3,17,6,shone,1,3,393,6,102,22,30,1252,18,709347,4
1235,attach,xt@C,1,1,0,0,1,attach,2,4,518,7,4,2,126,1935,230,9444154,5
8833,ink,IGk,14,2,12,12,2,ink,1,3,356,4,45,31,382,2854,268,25445645,4
15040,sable,sebL,10,8,2,9,1,sable,2,5,504,6,33,18,42,408,24,1501339,6
9249,issue,ISu,3,0,3,3,0,issue,2,3,411,6,24,7,1741,58808,22744,128432795,4
3853,contractor,kantr@ktX,1,0,1,0,1,contractor,3,9,689,11,5,1,160,2037,376,21783415,10
16216,squall,skwcl,4,3,1,1,3,squall,1,5,543,7,5,1,20,189,14,342920,6
17550,towpath,top@T,1,1,0,0,1,towpath,2,5,529,4,2,0,1,49,0,92094,5
3611,computer,kxmpyutX,1,0,1,0,1,computer,3,8,450,9,6,6,3011,32318,4138,224190650,9
12339,pang,p@G,17,17,0,8,9,pang,1,3,395,5,53,30,81,450,8,665803,4
13201,pod,pad,23,17,6,14,9,pod,1,3,389,4,62,31,408,998,64,5209484,4
2032,bond,band,13,11,2,10,3,bond,1,4,475,5,44,29,1595,9158,2047,23449140,5
7427,gripe,grYp,7,6,1,2,5,gripe,1,4,325,6,23,17,40,246,53,552076,5
17291,thread,TrEd,6,5,1,5,1,thread,1,4,478,7,17,3,263,2783,232,167520390,5
352,affiliate,xfIliet,1,1,0,1,0,affiliate,4,7,650,10,2,4,15,1162,426,37877419,8
5245,dram,dr@m,10,7,3,6,4,dram,1,4,506,5,33,23,10,124,1,1679051,5
651,amount,xmWnt,2,1,1,2,0,amount,2,5,546,7,4,2,1262,26422,6056,92039679,6
4789,detain,dIten,2,2,0,2,0,detain,2,5,545,7,9,7,93,281,80,492176,6
16259,stake,stek,17,14,3,4,13,stake,1,4,466,6,43,18,847,5734,1344,5061965,5
7315,gouge,gWJ,3,3,0,1,2,gouge,1,3,469,6,14,9,35,147,19,240551,4
14823,rig,rIg,26,21,5,13,13,rig,1,3,367,4,83,35,440,1704,236,2826013,4
2111,bowel,bWL,7,6,1,4,3,bowel,2,4,383,6,18,15,183,738,46,2666510,5
11327,my,mY,32,24,8,17,15,my,1,2,364,3,129,39,344899,577200,129097,1059793441,3
9135,invest,InvEst,4,4,0,3,1,invest,2,6,569,7,6,6,241,5044,1194,9987889,7
5322,dubious,dubixs,1,1,0,1,0,dubious,3,6,535,5,1,0,73,1396,153,1259096,5
5364,duo,duo,10,8,2,0,10,duo,2,3,374,4,50,24,77,1282,120,6901878,4
4522,decide,dIsYd,1,1,0,1,0,decide,2,5,549,7,7,7,2571,14811,5168,20951974,6
14531,relieve,rIliv,3,3,0,1,2,relieve,2,5,633,8,7,6,284,1689,247,3018810,6
6531,flex,flEks,4,3,1,3,1,flex,1,5,540,5,14,10,50,1143,84,5827672,6
1486,band,b@nd,19,13,6,14,5,band,1,4,424,5,49,32,2724,16316,2359,68585119,5
9708,laureate,lcrixt,2,1,1,2,0,laureate,3,6,424,9,6,2,7,534,105,801795,7
6149,face,fes,21,18,3,12,9,face,1,3,525,5,72,29,14747,87751,12447,82818242,4
3934,copper,kapX,9,8,1,3,6,copper,2,4,469,7,69,22,336,3384,130,14543941,5
3866,contribute,kxntrIbyut,1,0,1,0,1,contribute,3,10,507,11,1,2,194,7411,822,22258902,11
898,append,xpEnd,7,6,1,7,0,append,2,5,468,7,7,0,0,45,1,2139296,6
13404,potent,potNt,1,1,0,1,0,potent,2,6,490,7,2,5,76,2056,199,2419930,7
1633,beak,bik,28,23,5,19,9,beak,1,3,364,5,136,27,107,613,25,561383,4
5909,evade,Ived,1,0,1,1,0,evade,2,4,454,6,3,8,45,512,86,610569,5
11947,open,opxn,4,3,1,1,3,open,2,4,436,5,26,15,16341,74657,10430,239675664,5
16256,staid,sted,13,12,1,2,11,staid,1,4,557,5,37,7,3,254,20,196599,5
6650,force,fors,16,14,2,7,9,force,1,4,478,6,62,13,3604,45496,10829,79207090,5
8839,inlay,Inle,2,1,1,0,2,inlay,2,4,421,5,9,4,13,86,1,965778,5
12471,partially,parSLi,1,0,1,0,1,partially,3,7,568,8,4,0,109,3673,405,7231835,7
2274,Buddhist,bud|st,1,1,0,1,0,buddhist,2,6,542,9,2,2,121,1458,164,3874346,7
11978,optics,aptIks,2,1,1,0,2,optics,2,6,566,6,4,2,36,1098,64,7617094,6
13946,pumpkin,p^mpk|n,1,1,0,1,0,pumpkin,2,6,450,8,2,4,553,2166,230,3459153,5
17402,tired,tYrd,3,0,3,0,3,tired,2,4,417,6,12,14,5745,11085,2098,11159797,5
4520,deception,dIsEpS|n,1,1,0,1,0,deception,3,8,533,10,3,3,160,1262,241,2454433,9
3178,cipher,sYfX,3,3,0,2,1,cipher,2,4,510,7,53,4,76,137,8,1178025,5
16892,systematic,sIstxm@tIk,1,1,0,1,0,systematic,4,10,838,11,1,1,30,3628,168,6527542,11
16836,swore,swor,11,5,6,6,5,swore,1,4,569,5,25,12,446,1208,135,668969,5
18616,viscous,vIsk|s,1,1,0,0,1,viscous,2,6,549,7,3,0,13,235,12,690820,5
11987,oracle,crxkL,2,1,1,2,0,oracle,3,6,434,7,6,2,114,849,83,17217539,7
14760,revival,rIvYvL,1,0,1,0,1,revival,3,7,818,8,1,1,60,2576,219,3568249,6
10885,mint,mInt,12,10,2,7,5,mint,1,4,319,5,61,36,277,2280,206,12709532,5
7565,haddock,h@dxk,4,4,0,4,0,haddock,2,5,427,6,29,7,11,139,11,438655,5
8147,husky,h^ski,1,0,1,0,1,husky,2,5,454,6,19,12,81,471,18,1606901,6
15513,shadow,S@do,3,2,1,0,3,shadow,2,4,503,7,15,2,1080,8207,611,15234207,5
2240,broth,brcT,8,7,1,3,5,broth,1,4,529,6,25,12,45,3039,61,1297117,5
12276,palace,p@lxs,7,7,0,5,2,palace,2,5,523,7,33,6,979,5168,836,14592777,6
9558,kosher,koSX,1,1,0,0,1,kosher,2,4,454,7,38,9,137,1440,82,2212803,5
4285,cull,k^l,24,21,3,16,8,cull,1,3,320,5,138,24,4,135,9,451434,4
9808,lemon,lEmxn,3,3,0,3,0,lemon,2,5,349,6,81,16,613,7227,471,9071126,6
17657,tray,tre,19,11,8,9,10,tray,1,3,479,5,48,23,410,2620,108,7753730,4
17888,twig,twIg,8,7,1,4,4,twig,1,4,333,5,19,10,69,412,10,606887,5
14229,rape,rep,26,21,5,15,11,rape,1,3,294,5,89,34,816,6091,2592,51479037,4
7402,greet,grit,12,12,0,1,11,greet,1,4,366,6,48,9,268,1636,203,1784219,5
5545,elicit,xlIs|t,3,1,2,3,0,elicit,3,6,501,7,2,1,25,917,54,824563,7
14857,risk,rIsk,9,5,4,5,4,risk,1,4,386,5,49,26,2501,43624,6650,91491902,5
13896,psychology,sYkalxJi,1,1,0,1,0,psychology,4,8,804,10,2,0,279,9573,494,23936637,8
8874,insane,Insen,2,1,1,1,1,insane,2,5,518,7,1,1,1973,2085,541,4130477,6
17887,twiddle,twIdL,1,1,0,1,0,twiddle,2,6,357,7,6,2,15,17,3,75361,5
16465,stress,strEs,2,1,1,1,1,stress,1,5,484,7,19,3,796,17435,2259,25900161,6
1443,bail,bel,33,30,3,24,9,bail,1,3,284,5,163,40,885,2183,905,3739601,4
9538,knives,nYvz,3,3,0,3,0,knives,1,4,552,6,29,2,353,1558,192,7737510,4
15516,shake,Sek,24,22,2,17,7,shake,1,3,408,6,75,20,2021,6081,1107,6841547,4
5940,evocation,IvokeS|n,2,0,2,2,0,evocation,4,8,612,10,2,4,4,258,7,170851,9
11685,notch,naC,7,7,0,3,4,notch,1,3,559,6,45,4,170,1359,131,3302495,4
7493,guide,gYd,18,16,2,15,3,guide,1,3,344,6,78,13,910,14535,1086,213384707,4
16376,stimulation,stImyUleS|n,2,1,1,2,0,stimulation,4,11,894,10,2,2,70,1394,96,4225487,9
6544,flint,flInt,5,3,2,3,2,flint,1,5,411,6,17,14,222,922,115,3231075,6
15640,shun,S^n,19,18,1,15,4,shun,1,3,426,5,106,21,26,447,39,733434,4
955,Aquarius,xkw@rixs,1,1,0,0,1,aquarius,4,8,748,8,1,2,58,265,3,1574237,8
2362,bush,bUS,6,5,1,3,3,bush,1,3,317,5,27,30,720,59007,35233,71300864,4
2100,bounty,bWnti,1,1,0,1,0,bounty,2,5,609,6,4,5,366,1057,169,2151873,6
11110,month,m^nT,2,2,0,0,2,month,1,4,418,6,15,9,4854,46495,10366,123031117,5
10300,major,meJX,4,2,2,2,2,major,2,4,502,6,32,5,5343,61820,12480,122596391,5
14357,reckless,rEklxs,3,3,0,2,1,reckless,2,6,639,9,1,1,251,1326,306,1392393,7
11741,numerable,numXxbL,1,0,1,1,0,numerable,4,8,575,7,1,0,0,5,1,8553,6
5484,ego,igo,4,3,1,2,2,ego,2,3,354,4,27,22,382,3371,390,3682266,4
5203,dot,dat,26,24,2,19,7,dot,1,3,295,4,90,40,338,2996,443,26595890,4
19017,wicked,wIk|d,2,2,0,1,1,wicked,2,5,283,7,8,12,678,1587,143,6497108,6
16676,summary,s^mXi,1,0,1,0,1,summary,3,5,490,7,14,1,85,5537,1572,80528425,6
17467,tongue,t^G,16,15,1,10,6,tongue,1,3,335,7,41,4,1589,6661,422,10002790,4
12693,pepper,pEpX,5,3,2,3,2,pepper,2,4,459,7,34,10,449,13086,576,9725494,5
14255,rather,r@DX,3,3,0,2,1,rather,2,4,435,7,19,20,5825,63623,10326,73665419,5
4685,denote,dInot,1,0,1,0,1,denote,2,5,408,7,11,5,4,440,5,3369529,6
10741,met,mEt,26,23,3,19,7,met,1,3,593,4,93,46,9758,33185,7994,42236918,4
12202,oversight,ovXsYt,1,1,0,0,1,oversight,3,6,563,7,4,1,74,2653,633,4971139,6
13631,primacy,prYmxsi,1,1,0,1,0,primacy,3,7,480,7,2,3,0,668,21,460541,7
14533,religious,rIlIJ|s,2,1,1,1,1,religious,3,7,680,10,2,1,707,29828,3535,36046200,8
17450,toll,tol,33,29,4,24,9,toll,1,3,405,5,127,34,171,4038,1091,28852512,4
18203,upturn,^ptRn,1,1,0,0,1,upturn,2,5,531,7,4,1,0,113,34,221168,6
3231,clammy,kl@mi,3,2,1,0,3,clammy,2,5,437,6,17,2,30,275,8,113729,5
12219,owlet,Wl|t,1,1,0,1,0,owlet,2,4,466,4,12,0,1,9,0,44917,4
16920,tack,t@k,37,27,10,23,14,tack,1,3,377,5,115,32,108,912,90,2548232,4
4033,cotton,katN,7,5,2,5,2,cotton,2,5,435,7,43,11,723,6778,350,23279717,6
9460,kelp,kElp,3,3,0,2,1,kelp,1,4,316,5,32,13,63,276,8,628330,5
4673,demonstrator,dEmxnstretX,1,0,1,0,1,demonstrator,4,11,713,13,3,1,8,128,40,382929,12
10823,mile,mYl,28,24,4,20,8,mile,1,3,387,5,109,45,1071,13035,1657,22186849,4
1588,bass,b@s,23,18,5,10,13,bass,1,3,448,5,101,52,385,6084,487,26256986,4
17840,tunnel,t^nL,7,6,1,4,3,tunnel,2,5,311,7,19,5,912,4106,545,8698257,6
5736,enunciate,In^nsiet,1,1,0,1,0,enunciate,4,8,679,10,2,3,7,65,15,45004,9
210,actually,@kCuLi,1,0,1,0,1,actually,2,5,496,7,5,1,16439,72504,38266,69447573,4
16185,spread,sprEd,1,0,1,0,1,spread,1,5,492,7,6,1,1596,17863,2264,24520864,6
1746,bent,bEnt,17,16,1,12,5,bent,1,4,342,5,71,44,368,6166,278,5074045,5
19287,yucca,y^kx,2,2,0,2,0,yucca,2,4,435,4,5,1,14,461,135,812282,5
18527,victim,vIktxm,1,1,0,1,0,victim,2,6,398,7,4,2,2434,10457,3804,11845078,7
4274,cubicle,kyubIkL,2,1,1,1,1,cubicle,3,8,523,8,3,3,131,556,47,679227,9
4403,daily,deli,9,8,1,7,2,daily,2,4,442,5,86,12,797,24139,2921,105841570,5
18881,wedlock,wEdlak,1,1,0,1,0,wedlock,2,6,493,4,3,2,54,441,95,273600,4
15486,settle,sEtL,10,9,1,6,4,settle,2,5,439,7,28,12,2143,5826,1035,6326394,6
15376,seizure,siZX,3,3,0,1,2,seizure,2,4,502,8,25,1,190,929,233,2353392,5
19231,yacht,yat,16,16,0,15,1,yacht,1,3,312,6,57,2,419,1251,180,5932756,4
4351,cut,k^t,25,23,2,17,8,cut,1,3,315,4,105,27,11718,56677,11630,61343865,4
9610,lair,lEr,30,25,5,22,8,lair,1,3,427,5,140,25,123,358,9,1211294,4
18117,unnatural,^n@CXL,1,0,1,1,0,unnatural,4,8,600,10,1,0,140,957,91,951764,9
7630,handy,h@ndi,6,5,1,4,2,handy,2,5,476,6,46,26,623,2229,166,7938926,6
15729,sire,sYr,20,17,3,14,6,sire,2,3,539,5,115,37,671,341,6,1607933,4
16574,submerse,sxbmRs,1,1,0,0,1,submerse,2,6,698,9,2,2,1,2,0,10197,7
2371,busy,bIzi,2,2,0,1,1,busy,2,4,459,4,38,19,5433,11017,2200,17377502,5
9153,inviting,InvYtIG,1,1,0,1,0,inviting,3,7,554,6,4,1,367,2445,434,2822014,7
18315,vandal,v@ndL,4,4,0,4,0,vandal,2,6,499,7,25,6,15,53,6,362245,7
11786,obey,obe,6,5,1,3,3,obey,2,3,431,5,26,13,456,1516,367,2820117,4
9861,liability,lYxbIl|ti,1,1,0,1,0,liability,5,9,634,9,1,2,158,3561,530,26837967,10
5219,dowdy,dWdi,5,5,0,2,3,dowdy,2,4,388,5,32,12,12,154,13,161797,4
8907,insole,Insol,1,0,1,1,0,insole,2,5,498,7,3,0,2,70,3,511475,4
840,any,Eni,9,4,5,5,4,any,2,3,459,4,105,29,56068,219278,61618,710755610,4
5288,driving,drYvIG,3,2,1,3,0,driving,2,6,469,8,6,3,3780,17165,3855,40034225,7
12966,pickup,pIk^p,2,2,0,2,0,pickup,2,5,381,7,13,2,389,3386,353,9355456,6
6132,exude,Igzud,1,1,0,0,1,exude,2,5,480,6,1,4,11,159,9,142969,6
6446,fire,fYr,22,18,4,15,7,fire,2,3,482,5,100,34,10990,39024,9686,83858423,4
1855,bird,bRd,22,18,4,12,10,bird,1,3,307,5,110,17,2318,11125,1383,29443460,4
4094,cowl,kWl,18,15,3,15,3,cowl,1,3,383,5,89,15,5,111,4,368295,4
13892,psychic,sYkIk,1,0,1,0,1,psychic,2,5,489,8,4,1,605,1442,228,4353686,6
9539,knob,nab,21,18,3,15,6,knob,1,3,366,5,63,10,125,922,28,3275535,4
6704,formalize,formxlYz,1,1,0,1,0,formalize,3,8,779,10,2,3,6,76,7,272084,9
13559,prepare,prIpEr,1,0,1,1,0,prepare,2,6,512,8,3,4,1711,9289,1234,21088422,7
349,afferent,@fXxnt,1,1,0,1,0,afferent,3,6,449,5,2,1,0,62,0,247551,4
2710,casket,k@sk|t,2,2,0,2,0,casket,2,6,562,7,7,4,162,698,143,731278,7
16039,space,spes,6,4,2,2,4,space,1,4,537,6,20,15,3369,45608,5263,121524893,5
10235,mad,m@d,28,23,5,17,11,mad,1,3,462,4,81,54,5784,7648,1858,16478992,4
14136,rabbi,r@bY,1,1,0,0,1,rabbi,2,4,469,6,4,5,342,2280,599,3488914,5
10115,loot,lut,26,24,2,18,8,loot,1,3,305,5,106,20,181,382,54,1066250,4
851,ape,ep,17,10,7,9,8,ape,1,2,346,4,59,34,493,996,50,2441446,3
6523,fled,flEd,10,8,2,5,5,fled,1,4,566,5,33,16,224,3820,675,2246067,5
15832,sloth,slcT,3,2,1,1,2,sloth,1,4,529,6,15,8,74,290,52,519816,4
12361,papa,papx,4,3,1,0,4,papa,2,4,338,5,25,17,2172,2732,120,4175779,5
7613,hamper,h@mpX,3,2,1,2,1,hamper,2,5,360,7,24,17,72,494,50,1203919,6
1286,aught,ct,23,10,13,15,8,aught,1,2,304,5,71,9,18,50,6,209706,3
494,alive,xlYv,4,4,0,0,4,alive,2,4,610,4,14,12,7878,15207,4343,16076446,4
3897,convert,kxnvRt,2,2,0,0,2,convert,2,6,421,8,9,9,159,2483,281,16927734,7
17404,tissue,tISu,2,1,1,2,0,tissue,2,5,434,7,1,3,547,6051,660,15448920,6
1676,beef,bif,15,13,2,8,7,beef,1,3,352,5,73,16,1005,5258,656,11444465,4
8006,hookup,hUk^p,1,1,0,1,0,hookup,2,5,433,7,4,2,40,216,36,680912,6
3836,continence,kantN|ns,2,2,0,1,1,continence,3,9,570,9,4,0,0,68,6,287761,9
2505,camphor,k@mfX,1,1,0,0,1,camphor,2,6,474,5,0,0,6,88,1,210728,5
11664,normalize,normxlYz,1,1,0,1,0,normalize,3,8,654,10,2,3,4,266,75,621377,9
10627,medic,mEdIk,1,0,1,0,1,medic,2,5,386,6,20,14,291,421,95,1125925,6
15889,snatch,sn@C,4,4,0,0,4,snatch,1,4,567,7,9,2,199,603,67,2257630,5
9667,large,larJ,7,6,1,3,4,large,1,4,457,6,22,14,2114,76170,7808,165867706,5
3273,cleat,klit,11,10,1,6,5,cleat,1,4,367,6,39,8,22,190,2,371970,5
10030,livelihood,lYvlihUd,1,1,0,1,0,livelihood,3,8,670,11,2,2,76,836,149,1226471,9
4482,dealing,dilIG,1,1,0,1,0,dealing,2,5,424,8,30,10,1440,12093,4372,17303748,6
14924,rosin,razN,5,5,0,4,1,rosin,2,5,412,6,18,23,10,77,3,262173,5
2160,breadth,brEdT,2,0,2,0,2,breadth,1,5,373,6,6,1,22,1146,77,2207395,5
11172,mortification,mort|fxkeS|n,1,1,0,1,0,mortification,5,12,802,8,1,1,4,86,2,203588,7
890,appeal,xpil,6,5,1,2,4,appeal,2,4,459,7,14,5,663,10624,2472,27829781,5
254,adjure,xJUr,4,4,0,3,1,adjure,2,5,473,5,0,0,1,4,0,22956,3
4975,disc,dIsk,4,4,0,4,0,disc,1,4,310,5,32,13,131,2447,172,34143312,5
7279,golf,g^lf,4,3,1,0,4,golf,1,4,386,5,13,14,1302,11476,1441,88335035,5
5190,doom,dum,24,22,2,14,10,doom,1,3,458,5,77,11,286,1191,203,6067656,4
1505,bank,b@Gk,15,11,4,12,3,bank,1,4,366,5,57,37,4334,29833,6432,91561546,5
7499,guinea,gIni,6,6,0,5,1,guinea,2,4,579,7,52,3,227,1485,141,20757599,5
15821,slit,slIt,18,15,3,7,11,slit,1,4,383,5,35,18,194,842,78,1424732,5
10966,mistral,mIstrL,1,0,1,1,0,mistral,2,7,525,7,5,3,6,86,3,372478,7
16487,strive,strYv,5,5,0,0,5,strive,1,5,632,7,14,10,67,1355,113,4152261,6
4913,dim,dIm,21,20,1,12,9,dim,1,3,290,4,87,36,243,2714,123,5580441,4
9896,lie,lY,36,21,15,21,15,lie,1,2,300,4,156,58,6133,12906,2815,13539916,3
7631,hang,h@G,23,19,4,9,14,hang,1,3,370,5,79,54,7535,9104,2159,11079733,4
18199,upstate,^pstet,1,1,0,0,1,upstate,2,6,391,6,3,1,131,1035,240,1439984,6
16533,stunt,st^nt,2,1,1,1,1,stunt,1,5,462,6,14,11,469,931,293,1754828,6
17057,teethe,tiD,11,10,1,4,7,teethe,1,3,550,7,44,4,1,3,0,10130,4
2484,calves,k@vz,4,3,1,2,2,calves,1,4,544,6,16,12,82,1032,40,1208012,4
7685,haste,hest,10,9,1,8,2,haste,1,4,465,6,36,20,106,556,36,1059853,5
9753,learning,lRnIG,1,1,0,1,0,learning,2,5,379,6,18,3,1036,42808,2585,117676773,5
15616,shrapnel,Sr@pnL,1,1,0,1,0,shrapnel,2,7,582,5,1,0,113,440,105,335328,4
3357,cobalt,kobclt,1,1,0,0,1,cobalt,2,6,484,5,2,1,30,598,16,2642969,6
2611,captor,k@ptX,4,4,0,3,1,captor,2,5,491,7,20,4,15,173,42,313307,6
5564,elusive,xlusIv,1,1,0,1,0,elusive,3,6,596,8,1,0,72,1786,149,1584397,7
9820,lentil,lEntL,6,5,1,5,1,lentil,2,6,529,7,10,1,11,191,0,358846,7
17680,trench,trEnC,4,3,1,3,1,trench,1,5,405,7,11,6,157,1234,133,1709629,6
11009,modify,madxfY,3,2,1,2,1,modify,3,6,535,7,3,1,50,3008,163,21717358,7
10067,location,lokeS|n,1,1,0,1,0,location,3,7,592,9,2,3,1263,11928,1258,211247184,8
4998,discourse,dIskors,1,1,0,0,1,discourse,2,7,649,10,1,2,20,5914,274,4221411,8
2615,carabao,k@rxbW,1,1,0,0,1,carabao,3,6,808,7,0,0,2,2,1,24712,6
2966,charm,Carm,7,5,2,3,4,charm,1,4,435,6,15,11,794,2861,363,10557764,5
2086,bottle,batL,8,7,1,5,3,bottle,2,5,420,7,35,10,2588,9485,882,17717296,6
6166,fade,fed,22,19,3,12,10,fade,1,3,384,5,80,33,286,2246,207,3618325,4
2694,cartridge,kartrIJ,3,2,1,1,2,cartridge,2,7,529,10,2,4,49,670,20,15410900,8
7117,german,JRmxn,5,4,1,4,1,german,2,5,380,7,47,30,1624,15726,1764,53712683,6
18723,vulgarize,v^lgXYz,1,0,1,0,1,vulgarize,3,7,778,9,0,0,0,1,1,4290,6
3868,contributor,kxntrIbyutX,1,0,1,0,1,contributor,4,11,584,12,1,2,18,2169,839,5902799,12
16389,stitch,stIC,7,7,0,2,5,stitch,1,4,609,7,22,4,381,597,39,5050736,5
3381,cod,kad,27,22,5,17,10,cod,1,3,375,4,100,40,114,1378,174,10428610,4
15839,slum,sl^m,14,12,2,5,9,slum,1,4,519,5,36,21,65,568,75,617168,5
1664,bed,bEd,25,21,4,19,6,bed,1,3,296,4,90,38,9543,31440,3390,64267669,4
19193,wreath,riT,17,17,0,7,10,wreath,1,3,337,7,87,6,54,574,98,1330354,4
17880,tweed,twid,4,3,1,2,2,tweed,1,4,539,6,11,4,61,456,43,1632363,5
11122,mop,map,16,15,1,11,5,mop,1,3,327,4,79,33,211,648,75,1840725,4
12961,picket,pIk|t,5,5,0,5,0,picket,2,5,479,7,19,15,113,665,119,816389,6
4776,dessert,dIzRt,2,2,0,1,1,dessert,2,5,585,8,10,6,715,2830,329,4392650,6
16543,stutter,st^tX,1,1,0,1,0,stutter,2,5,512,8,17,8,96,294,31,238419,6
15558,shellfish,SElfIS,1,1,0,1,0,shellfish,2,6,718,6,2,0,50,628,60,1623214,5
14450,refract,rIfr@kt,1,1,0,1,0,refract,2,7,539,8,1,1,2,31,1,66964,8
6374,fiction,fIkS|n,4,2,2,4,0,fiction,2,6,587,8,6,4,310,8011,924,47450864,7
13925,puke,pyuk,2,1,1,0,2,puke,1,4,379,5,10,14,319,221,16,528407,5
9601,lady,ledi,6,5,1,1,5,lady,2,4,321,5,50,21,11071,16341,4050,29359462,5
313,advice,xdvYs,1,1,0,0,1,advice,2,5,650,5,4,3,2447,14583,3472,71278594,5
9503,kinsfolk,kInzfok,1,0,1,0,1,kinsfolk,2,7,599,5,1,1,0,5,1,26647,5
7404,gremlin,grEml|n,1,1,0,1,0,gremlin,2,7,450,8,2,3,11,26,0,297178,8
7413,grief,grif,11,10,1,2,9,grief,1,4,509,5,41,11,552,4197,736,4552843,4
15914,snug,sn^g,6,5,1,2,4,snug,1,4,482,5,8,5,73,738,28,844329,5
12490,pass,p@s,24,19,5,11,13,pass,1,3,415,5,89,40,5514,25153,5209,55196751,4
6639,foot,fUt,10,9,1,9,1,foot,1,3,366,5,27,20,3311,28872,2692,40403729,4
109,accede,@ksid,2,2,0,1,1,accede,2,5,589,7,5,2,7,114,14,199886,6
11134,morass,mX@s,4,3,1,2,2,morass,2,4,541,7,14,6,5,216,35,135710,5
9952,lineament,lInixmxnt,1,0,1,1,0,lineament,3,8,501,6,0,0,0,2,0,26878,5
7703,havoc,h@vxk,3,3,0,3,0,havoc,2,5,442,4,9,0,69,935,137,1697879,5
15707,simulation,sImyUleS|n,1,0,1,1,0,simulation,4,10,749,11,2,3,115,1671,66,16169993,11
8342,immortal,ImortL,1,0,1,1,0,immortal,3,7,524,9,3,2,260,805,93,2278580,8
3771,conserve,kxnsRv,2,2,0,0,2,conserve,2,6,610,9,4,1,44,931,88,1607331,7
14168,radium,redixm,2,2,0,1,1,radium,3,6,510,6,4,1,56,75,15,510988,6
15059,saddle,s@dL,7,4,3,3,4,saddle,2,5,440,7,31,9,399,2254,99,4499280,6
18953,while,hwYl,8,5,3,2,6,while,1,4,434,6,20,13,17821,166569,20173,226203589,5
11576,ninth,nYnT,1,0,1,0,1,ninth,1,4,479,6,6,1,334,3796,551,4390562,5
4041,council,kWnsL,2,2,0,2,0,council,2,6,514,8,14,1,863,24475,4431,112896752,7
15958,solemn,salxm,2,1,1,1,1,solemn,2,5,438,7,22,2,112,1019,129,1101329,6
4893,dig,dIg,17,17,0,9,8,dig,1,3,285,4,63,33,2357,4107,726,7295418,4
2936,chaos,keas,1,0,1,0,1,chaos,2,4,548,5,14,6,479,4860,1194,8709959,4
11774,oar,or,32,13,19,21,11,oar,1,2,330,4,146,40,42,211,17,909269,3
13056,pitcher,pICX,4,1,3,2,2,pitcher,2,4,371,8,25,7,165,3491,203,2963438,5
9545,knot,nat,27,27,0,23,4,knot,1,3,497,5,93,14,188,1998,145,2981225,4
14248,rash,r@S,26,20,6,15,11,rash,1,3,447,5,86,35,410,1209,150,2430246,4
12510,paste,pest,13,11,2,8,5,paste,1,4,549,6,38,18,87,1927,97,8913055,5
2651,caribou,k@rxbu,1,1,0,0,1,caribou,3,6,462,6,1,1,15,546,51,1112781,6
19024,widow,wIdo,5,3,2,0,5,widow,2,4,347,6,16,2,617,2583,403,3805265,5
17906,type,tYp,18,16,2,9,9,type,1,3,409,5,56,12,3093,31397,5200,272349815,4
4081,cove,kov,18,17,1,9,9,cove,1,3,414,5,64,33,166,1175,104,5869534,4
16504,struck,str^k,8,6,2,2,6,struck,1,5,462,7,25,8,826,10968,2270,8489716,6
17285,thou,DW,14,14,0,9,5,thou,1,2,439,5,65,10,1144,1388,169,11669293,3
10547,matinee,m@tNe,1,1,0,0,1,matinee,3,6,504,8,1,1,58,287,53,553768,7
6392,fifty,fIfti,2,1,1,1,1,fifty,2,5,373,6,6,3,960,9950,1638,8133138,6
6034,expand,Iksp@nd,2,2,0,0,2,expand,2,7,626,7,4,2,178,6893,963,24485562,8
2463,call,kcl,26,23,3,21,5,call,1,3,357,5,145,40,43931,81621,25832,199619947,4
12523,pasture,p@sCX,2,2,0,1,1,pasture,2,5,573,8,6,3,78,1302,44,1913652,6
15222,scavenger,sk@vxnJX,1,0,1,0,1,scavenger,3,8,768,10,2,2,44,226,12,692800,9
4595,degradation,dEgrxdeS|n,1,1,0,1,0,degradation,4,10,664,12,2,1,39,1635,79,4236424,11
17160,terrify,tErxfY,1,1,0,1,0,terrify,3,6,559,8,6,0,25,111,22,103254,7
1115,ashore,xSor,3,2,1,2,1,ashore,2,4,498,5,8,6,317,967,202,876754,3
550,aloud,xlWd,5,3,2,2,3,aloud,2,4,545,4,12,3,94,2451,83,3743858,4
14852,risen,rIzN,8,7,1,6,2,risen,2,5,373,6,26,15,79,2757,352,2619862,5
4040,could,kUd,11,11,0,10,1,could,1,3,419,6,32,5,83109,384988,82935,302322314,4
16026,source,sors,8,7,1,5,3,source,1,4,493,7,37,2,1437,23969,2620,179974540,5
4792,detention,dItEnC|n,2,2,0,2,0,detention,3,8,623,10,4,3,333,2075,504,5003311,9
2530,candle,k@ndL,11,9,2,6,5,candle,2,6,414,7,44,13,409,1978,202,10193814,7
18638,vitals,vYtLz,1,0,1,0,1,vitals,2,6,430,6,6,7,184,168,6,200318,6
7424,grinder,grYndX,1,0,1,0,1,grinder,2,6,452,8,13,8,65,497,21,2282361,7
7287,goo,gu,26,21,5,19,7,goo,1,2,569,4,150,40,109,415,32,3884124,3
8393,imperil,ImpErL,1,0,1,0,1,imperil,3,7,484,8,2,3,4,90,9,71029,8
16513,stubble,st^bL,4,2,2,1,3,stubble,2,6,450,8,8,3,18,478,6,297662,7
12341,panic,p@nIk,1,0,1,0,1,panic,2,5,398,6,26,6,1114,4759,993,6401215,6
12907,phony,foni,8,6,2,5,3,phony,2,4,474,5,48,4,421,1214,521,768812,5
1931,blitz,blIts,2,0,2,0,2,blitz,1,5,404,6,26,9,64,635,119,2478467,6
1258,attract,xtr@kt,1,0,1,1,0,attract,2,6,547,8,5,1,290,4955,591,7608984,7
1143,assault,xsclt,2,0,2,2,0,assault,2,5,538,8,5,2,896,6306,1657,10011530,6
17196,that,D@t,14,13,1,13,1,that,1,3,518,5,36,18,719677,3326809,1186240,3400063273,4
9685,latch,l@C,18,18,0,8,10,latch,1,3,424,6,65,14,98,739,49,1777882,4
14347,recess,risEs,1,1,0,0,1,recess,2,5,655,7,5,0,178,1271,319,1661246,6
15701,simple,sImpL,6,6,0,4,2,simple,2,6,477,7,13,13,4555,29437,4870,85630690,7
10673,memorable,mEmXxbL,1,1,0,1,0,memorable,4,8,537,9,1,1,115,2265,346,4538880,7
15774,slake,slek,12,9,3,5,7,slake,1,4,392,4,23,14,3,35,1,54780,4
7093,genteel,JEntil,2,2,0,0,2,genteel,2,6,442,6,3,0,28,360,27,170745,5
15844,slur,slR,9,8,1,3,6,slur,1,3,511,5,85,12,24,248,69,252466,4
17119,tenet,tEn|t,6,4,2,2,4,tenet,2,5,425,6,16,8,6,768,269,838507,6
12273,pajamas,pxJamxz,1,1,0,1,0,pajamas,3,7,603,7,2,3,297,944,124,1435077,7
12304,palm,pam,14,9,5,4,10,palm,1,4,356,5,16,24,675,7791,1278,42632962,5
18956,whim,hwIm,9,8,1,2,7,whim,1,3,353,5,82,17,119,561,49,658300,4
13051,pistil,pIstL,2,2,0,2,0,pistil,2,6,403,7,11,2,5,20,0,90108,7
6482,flag,fl@g,8,6,2,3,5,flag,1,4,589,5,30,17,892,6243,1599,33053840,5
15629,shrivel,SrIvL,1,1,0,1,0,shrivel,2,6,574,8,2,1,20,106,4,61038,7
15497,sewer,suX,9,6,3,1,8,sewer,2,3,426,6,68,16,240,1088,130,5008805,4
15798,sleep,slip,13,10,3,5,8,sleep,1,4,407,6,28,13,11625,21585,3484,29496833,5
16438,strand,str@nd,1,0,1,1,0,strand,1,6,701,7,3,7,94,1580,58,6383727,7
11785,obese,obis,1,0,1,0,1,obese,2,4,557,5,2,1,25,1375,227,1673406,5
10874,minister,mIn|stX,2,1,1,2,0,minister,3,7,560,9,3,4,941,19040,7203,43935143,8
16956,tame,tem,19,18,1,16,3,tame,1,3,369,5,54,29,139,891,86,1270648,4
16387,stir,stR,9,6,3,3,6,stir,1,3,499,5,81,10,301,9098,329,4833763,4
4100,coxswain,kaks|n,2,1,1,2,0,coxswain,2,7,608,4,0,0,5,40,2,82266,6
10038,lives,lYvz,5,5,0,5,0,lives,1,4,513,6,34,26,7124,43821,10557,42752134,4
11896,ogle,ogL,6,5,1,5,1,ogle,2,4,424,5,33,16,19,139,4,493507,5
11224,mud,m^d,20,19,1,10,10,mud,1,3,379,4,57,18,756,4961,570,5916902,4
3209,citation,sYteS|n,1,0,1,1,0,citation,3,7,708,9,4,1,81,818,51,9810893,8
8840,inlet,InlEt,1,1,0,1,0,inlet,2,5,417,6,3,4,23,1124,17,3433125,6
14827,rightful,rYtfL,1,0,1,0,1,rightful,2,6,569,9,5,1,119,531,59,712223,7
16467,strew,stru,6,3,3,2,4,strew,1,4,520,6,22,10,2,17,1,37469,5
408,aghast,xg@st,1,1,0,1,0,aghast,2,5,637,5,4,0,7,287,27,183464,5
4420,damp,d@mp,9,8,1,7,2,damp,1,4,364,5,33,19,149,2879,83,1883132,5
2114,bowler,bolX,11,9,2,5,6,bowler,2,4,509,7,118,21,67,270,21,841643,5
14522,relegate,rElxget,1,1,0,1,0,relegate,3,7,508,9,1,3,2,134,8,86498,8
6605,foal,fol,30,28,2,24,6,foal,1,3,479,5,114,14,14,96,2,552193,4
8270,ill,Il,31,15,16,23,8,ill,1,2,459,4,109,28,1085,13142,2559,16153052,3
13303,pope,pop,22,21,1,16,6,pope,1,3,386,5,55,28,546,6188,2078,8561616,4
6758,fragrant,fregrxnt,1,1,0,1,0,fragrant,2,8,522,8,2,1,36,1195,11,1182515,8
13054,pit,pIt,33,30,3,23,10,pit,1,3,243,4,87,42,674,3729,392,8536397,4
4471,deacon,dik|n,1,1,0,1,0,deacon,2,5,364,7,26,4,146,586,24,1214127,6
8898,insidious,InsIdixs,1,1,0,1,0,insidious,4,8,631,6,1,1,45,618,87,501543,6
17394,tip,tIp,25,23,2,18,7,tip,1,3,222,4,72,31,1409,9125,1193,28816642,4
6066,explore,Iksplor,2,1,1,0,2,explore,2,7,568,8,3,4,317,8264,623,31746663,8
3536,committee,kxmIti,1,0,1,0,1,committee,3,6,549,10,8,4,1123,29490,9260,121347358,7
8229,icy,Ysi,4,2,2,3,1,icy,2,3,377,3,37,5,135,2040,140,1565708,3
18214,urchin,RC|n,2,2,0,2,0,urchin,2,4,380,7,14,2,22,276,8,481596,5
18466,vertebrate,vRtxbrxt,1,0,1,0,1,vertebrate,3,8,559,11,2,2,7,342,10,896746,9
9345,job,Jab,19,18,1,13,6,job,1,3,388,4,53,24,21063,72084,21065,177720493,4
7790,helmet,hElmxt,1,0,1,0,1,helmet,2,6,312,7,6,6,483,3062,262,6119462,7
11401,nation,neS|n,1,1,0,1,0,nation,2,5,443,7,13,6,1045,42567,13031,44431261,6
17161,territorial,tErxtoriL,1,0,1,0,1,territorial,5,10,728,12,1,0,85,2023,159,3387028,11
10184,lunch,l^nC,7,7,0,6,1,lunch,1,4,419,6,24,9,5310,12963,1530,20807697,5
10017,litigation,lIt|geS|n,1,1,0,1,0,litigation,4,9,597,11,1,2,74,3089,408,10681707,10
19154,wool,wUl,13,11,2,9,4,wool,1,3,519,5,53,14,161,2798,106,7657323,4
10126,loss,lcs,19,15,4,13,6,loss,1,3,551,5,87,47,1485,25339,3574,83019752,4
529,allow,xlW,5,4,1,2,3,allow,2,3,678,6,26,13,2263,25960,4805,67052832,4
4753,deserve,dIzRv,2,2,0,1,1,deserve,2,5,609,8,5,5,2230,4579,1471,6619274,6
10161,luck,l^k,26,23,3,19,7,luck,1,3,356,5,94,37,7840,9427,2575,16739504,4
10055,loaves,lovz,2,2,0,2,0,loaves,1,4,534,4,26,2,28,451,20,396713,4
18702,vortex,vortEks,1,1,0,1,0,vortex,2,7,639,6,3,3,76,405,28,2249799,7
7023,gasp,g@sp,6,2,4,4,2,gasp,1,4,409,5,21,17,88,1003,72,1065362,5
17138,tepee,tipi,3,3,0,0,3,tepee,2,4,419,6,19,3,27,118,10,56962,5
14799,ribbon,rIb|n,2,2,0,2,0,ribbon,2,5,320,7,31,3,258,2185,188,7950639,6
15716,single,sIGgL,6,5,1,6,0,single,2,6,418,7,22,21,3676,46085,7546,134757808,7
9397,juggle,J^gL,5,2,3,2,3,juggle,2,5,315,7,7,8,74,354,69,378788,6
606,ambition,@mbIS|n,1,1,0,0,1,ambition,3,7,538,9,2,1,273,2067,285,2592749,8
1220,atoll,@tcl,2,1,1,2,0,atoll,2,4,451,4,9,2,27,148,9,908471,4
12826,pestilence,pEstLxns,1,1,0,0,1,pestilence,3,9,630,7,0,0,30,117,10,286455,7
7729,hearing,hIrIG,2,2,0,1,1,hearing,2,5,470,8,18,24,2281,20247,6978,38521785,6
16680,summon,s^mxn,7,6,1,5,2,summon,2,5,405,7,36,3,197,699,47,820528,6
17405,titan,tYtN,5,4,1,2,3,titan,2,5,351,6,30,8,74,733,56,3985761,6
4856,diaphragm,dYxfr@m,1,1,0,1,0,diaphragm,3,7,764,10,2,1,105,485,39,1212110,8
16788,swamp,swamp,1,0,1,0,1,swamp,1,5,569,6,8,10,458,1831,112,2576121,6
15941,sofa,sofx,1,1,0,0,1,sofa,2,4,599,5,19,14,299,2858,122,6588539,5
17732,triple,trIpL,5,2,3,3,2,triple,2,6,509,7,14,9,479,3554,487,12479150,7
1864,bisque,bIsk,5,4,1,4,1,bisque,1,4,370,4,34,3,20,96,3,749555,5
2143,brandy,br@ndi,3,1,2,2,1,brandy,2,6,492,7,19,13,567,1364,123,2246036,7
2273,Buddhism,budIzM,1,1,0,1,0,buddhism,3,7,624,8,0,1,33,701,62,3249137,5
14964,rubber,r^bX,4,3,1,1,3,rubber,2,4,419,7,24,5,714,4519,420,17685875,5
9823,leopard,lEpXd,2,1,1,1,1,leopard,2,5,396,8,24,5,276,766,99,2153753,6
3248,clarity,kl@rxti,1,0,1,0,1,clarity,3,7,520,7,1,3,107,3056,273,7198788,6
11072,monitor,man|tX,1,1,0,0,1,monitor,3,6,554,8,6,2,669,9472,1094,43856439,7
3462,cologne,kxlon,1,0,1,1,0,cologne,2,5,417,5,12,0,161,626,62,5078538,6
9,abash,xb@S,2,1,1,1,1,abash,2,4,579,6,4,4,0,2,2,12974,5
7158,giggle,gIgL,6,5,1,5,1,giggle,2,5,371,7,23,9,87,631,45,732656,6
9966,lining,lYnIG,5,3,2,4,1,lining,2,5,386,7,26,12,231,2520,410,4758401,6
7366,graphite,gr@fYt,1,0,1,0,1,graphite,2,6,492,7,2,0,21,883,20,2667183,5
7952,hoe,ho,28,20,8,14,14,hoe,1,2,306,4,162,58,47,335,32,1485846,3
10897,mirror,mIrX,1,0,1,0,1,mirror,2,4,387,7,31,1,1233,10408,864,21543071,5
12383,paradigm,p@rxdYm,1,1,0,0,1,paradigm,3,7,651,9,3,1,37,2726,111,4080214,8
2137,brake,brek,13,10,3,3,10,brake,1,4,392,6,44,16,305,1737,118,9322146,5
10403,manned,m@nd,15,12,3,10,5,manned,1,4,566,6,58,11,66,818,132,1084387,5
2893,Chablis,S@bli,2,0,2,1,1,chablis,2,5,477,5,6,1,25,92,12,185934,4
11236,muggy,m^gi,4,3,1,1,3,muggy,2,4,388,5,33,3,5,171,14,83634,5
1984,boatman,botmxn,2,1,1,2,0,boatman,2,6,405,6,18,3,30,92,10,191091,5
1727,belong,bxlcG,1,0,1,1,0,belong,2,5,646,7,3,2,2263,4809,903,9234728,6
1732,bench,bEnC,7,6,1,4,3,bench,1,4,364,6,40,13,493,5986,511,8992211,5
4248,cruise,kruz,8,6,2,1,7,cruise,1,4,581,7,68,6,626,5266,1349,27828163,5
4844,diagram,dYxgr@m,1,1,0,1,0,diagram,3,7,592,8,3,1,65,2638,37,9460260,8
1434,bag,b@g,28,26,2,17,11,bag,1,3,439,4,74,39,4796,17692,1987,40683161,4
5029,disparity,dIsp@rxti,1,0,1,0,1,disparity,4,9,768,9,1,0,10,1121,158,1085365,10
10141,loving,l^vIG,1,1,0,1,0,loving,2,5,379,7,12,11,1275,5410,1290,10173654,6
13455,pray,pre,15,10,5,9,6,pray,1,3,329,5,50,21,1847,4496,1123,8562999,4
14222,rank,r@Gk,20,10,10,16,4,rank,1,4,373,5,57,36,433,5078,457,36409068,5
488,alike,xlYk,5,4,1,1,4,alike,2,4,435,6,19,8,579,4512,545,6220960,5
10041,living,lIvIG,1,1,0,1,0,living,2,5,503,7,9,9,7983,53369,9593,107223805,6
13587,preside,prIzYd,1,0,1,1,0,preside,2,6,584,8,3,7,17,303,51,499894,7
411,agitate,@J|tet,2,1,1,1,1,agitate,3,6,495,8,4,1,22,108,10,129541,7
7716,he,hi,33,24,9,18,15,he,1,2,388,3,175,59,389497,1741940,427494,842847219,3
18669,vogue,vog,4,4,0,2,2,vogue,1,3,519,4,18,8,119,852,131,2159792,4
9742,league,lig,19,17,2,4,15,league,1,3,379,7,87,4,950,20154,2169,41115798,4
5425,easy,izi,4,2,2,2,2,easy,2,3,479,5,35,7,13551,37554,6970,125553907,4
884,appal,xpcl,3,2,1,1,2,appal,2,4,568,6,6,5,2,3,0,27946,3
9546,know,no,27,19,8,14,13,know,1,2,358,5,161,12,291780,412099,244658,306133754,3
14408,red,rEd,29,21,8,21,8,red,1,3,358,4,110,50,7551,53727,5891,140812404,4
16187,sprig,sprIg,2,1,1,1,1,sprig,1,5,470,6,9,5,12,250,4,143773,6
13494,predator,prEd|tX,1,1,0,1,0,predator,3,7,515,9,2,2,134,1596,394,3647058,8
2810,cedar,sidX,6,5,1,3,3,cedar,2,4,499,6,64,5,127,1971,146,9488016,5
13883,pry,prY,17,9,8,8,9,pry,1,3,414,4,48,23,210,604,50,437884,4
2106,bout,bWt,23,20,3,20,3,bout,1,3,363,5,69,20,974,1461,147,3363878,4
15851,smash,sm@S,4,2,2,3,1,smash,1,4,577,6,10,6,421,1210,199,3192305,5
8991,intentional,IntEnC|nL,1,0,1,0,1,intentional,4,10,738,12,1,0,75,1331,202,2206039,11
2375,butler,b^tlX,2,1,1,1,1,butler,2,5,440,7,16,16,508,3313,444,8416594,6
7616,hand,h@nd,13,9,4,9,4,hand,1,4,615,5,51,36,14262,90807,11316,121304346,5
18684,volt,volt,9,7,2,7,2,volt,1,4,479,5,34,19,9,812,111,8205091,5
6445,fir,fR,18,11,7,7,11,fir,1,2,434,4,110,29,22,806,35,2319833,3
6598,flutist,flut|st,1,1,0,1,0,flutist,2,7,634,5,1,0,1,63,11,106283,5
6723,fortification,fort|fxkeS|n,1,1,0,1,0,fortification,5,12,759,14,2,2,5,107,5,331954,13
7063,gene,Jin,17,14,3,13,4,gene,1,3,431,5,120,25,743,7341,1702,34268022,4
13636,prime,prYm,11,8,3,3,8,prime,1,4,422,6,31,15,933,15300,5155,38313992,5
4922,din,dIn,32,28,4,21,11,din,1,3,314,4,141,50,60,904,36,5003611,4
3913,coo,ku,31,24,7,19,12,coo,1,2,237,4,193,51,35,347,36,1167246,3
13987,purity,pyUr|ti,1,1,0,0,1,purity,3,7,454,6,1,2,121,1209,119,3005735,7
3262,clavicle,kl@vIkL,1,1,0,1,0,clavicle,3,8,609,7,1,0,50,96,7,100689,7
2975,chasm,k@zM,1,1,0,0,1,chasm,2,5,585,5,7,6,18,480,46,517864,5
15561,shelves,SElvz,3,1,2,2,1,shelves,1,5,573,7,8,4,140,3093,298,4560501,5
19097,witch,wIC,20,15,5,11,9,witch,1,3,389,6,79,23,1410,2019,387,6673262,4
19036,wild,wYld,10,8,2,7,3,wild,1,4,524,5,50,24,2923,17681,2361,39947661,5
17162,territory,tErxtori,1,0,1,0,1,territory,4,8,587,10,1,0,748,7748,1395,21963698,9
6900,further,fRDX,3,3,0,2,1,further,2,4,428,8,16,3,2690,37182,4796,109528141,5
2692,carton,kartN,5,3,2,4,1,carton,2,6,449,7,42,28,96,619,44,2028105,7
4440,daring,d@rIG,3,3,0,3,0,daring,2,5,407,6,49,21,214,1709,212,1796196,6
8848,inning,InIG,2,1,1,1,1,inning,2,4,469,7,23,9,128,1935,113,2119847,5
12641,pen,pEn,29,25,4,21,8,pen,1,3,332,4,113,40,1261,4424,425,16375579,4
11990,orange,crInJ,2,2,0,2,0,orange,2,5,499,7,8,5,1138,11628,1008,37322068,6
11277,murk,mRk,17,14,3,14,3,murk,1,3,318,5,96,17,5,133,3,85667,4
16037,soy,sO,13,12,1,4,9,soy,1,2,529,4,78,39,118,2697,121,4654795,3
6436,finger,fIGgX,1,1,0,1,0,finger,2,5,586,7,4,21,1870,10142,1249,13628993,6
18859,wealth,wElT,6,5,1,1,5,wealth,1,4,521,7,26,4,324,8451,1231,14325239,5
4748,descent,dIsEnt,2,2,0,0,2,descent,2,6,395,8,5,4,132,2469,193,3295064,7
6539,flight,flYt,16,13,3,7,9,flight,1,4,467,7,38,10,3044,14737,3280,39233015,5
11866,oddity,ad|ti,1,1,0,0,1,oddity,3,5,570,6,3,0,6,219,23,374784,6
3509,coming,k^mIG,2,2,0,2,0,coming,2,5,314,7,19,11,26878,68719,32442,69892089,6
5537,elephant,Elxfxnt,1,1,0,1,0,elephant,3,7,511,9,5,1,580,2438,436,6116985,8
3022,cherry,CEri,10,8,2,9,1,cherry,2,4,411,7,98,8,693,3902,400,12858592,5
9688,late,let,32,26,6,21,11,late,1,3,320,5,99,44,13756,52321,7816,65578140,4
16181,sprang,spr@G,3,3,0,0,3,sprang,1,5,552,7,9,8,39,1194,49,758246,6
16889,syringe,sXInJ,1,0,1,1,0,syringe,2,5,694,8,2,2,99,593,69,1086828,6
6850,fry,frY,13,9,4,7,6,fry,1,3,544,4,40,19,428,2070,143,4484595,4
5629,employee,ImplOi,2,1,1,0,2,employee,3,6,469,9,8,6,590,7290,1262,45719822,7
16146,splendor,splEndX,1,0,1,1,0,splendor,2,7,550,7,2,0,60,683,50,1183490,7
16828,Swiss,swIs,6,6,0,0,6,swiss,1,4,481,6,14,5,321,2684,367,21325754,5
10953,miss,mIs,23,18,5,12,11,miss,1,3,392,5,99,27,23850,21310,4199,39913030,4
197,acropolis,xkrapLxs,1,0,1,1,0,acropolis,4,9,729,5,1,0,6,130,6,429879,4
10058,lobby,labi,4,3,1,3,1,lobby,2,4,420,6,50,8,647,4595,671,6887680,5
13997,pursue,pXsu,1,0,1,0,1,pursue,2,4,475,7,17,5,327,5916,1122,7615784,5
10339,mallet,m@l|t,6,6,0,6,0,mallet,2,5,414,7,22,15,35,266,16,698695,5
19058,wind,wInd,11,8,3,3,8,wind,1,4,374,5,57,27,3028,22149,2499,42983281,5
16263,stalked,stckt,1,0,1,0,1,stalked,1,5,576,7,12,5,79,661,86,309313,5
10715,merge,mRJ,11,7,4,7,4,merge,1,3,440,6,48,15,71,983,122,5962129,4
17867,tusk,t^sk,9,6,3,5,4,tusk,1,4,379,5,19,15,13,156,3,245115,5
14928,rot,rat,29,26,3,25,4,rot,1,3,405,4,122,50,394,1021,81,2043647,4
9752,learned,lRnd,4,3,1,3,1,learned,1,4,455,7,27,5,2964,29847,6176,23121323,4
2891,cession,sES|n,1,0,1,1,0,cession,2,5,549,5,14,2,0,87,9,134553,6
5679,enfold,Infold,1,1,0,0,1,enfold,2,6,555,5,3,3,15,31,1,74308,5
12401,paranoid,p@rxnOd,1,1,0,0,1,paranoid,3,7,542,8,1,1,543,1169,228,1643627,7
6829,frontage,fr^ntIJ,1,1,0,0,1,frontage,2,7,668,7,3,0,10,78,7,1027134,7
7904,hilt,hIlt,12,10,2,9,3,hilt,1,4,368,5,42,24,28,322,38,348212,5
10924,miscount,mIskWnt,1,1,0,1,0,miscount,2,7,611,6,3,3,0,5,0,11448,5
6065,exploration,EksplXeS|n,1,0,1,1,0,exploration,4,10,613,12,3,2,96,4478,370,10799574,11
4343,custard,k^stXd,1,1,0,1,0,custard,2,6,497,5,7,2,64,528,17,742881,6
18540,vie,vY,25,18,7,17,8,vie,1,2,308,4,105,48,110,616,43,2473789,3
13806,prose,proz,9,5,4,3,6,prose,1,4,551,6,50,17,48,1610,59,3090254,5
8021,horn,horn,13,11,2,8,5,horn,1,4,433,5,61,36,1075,3306,362,8042414,5
8252,idly,Ydli,1,0,1,1,0,idly,2,4,481,4,14,1,32,488,37,292990,4
8675,indoors,Indorz,2,1,1,0,2,indoors,2,6,688,7,2,1,126,1290,149,2389570,6
1386,awful,cfL,4,3,1,1,3,awful,2,4,362,6,9,1,3234,6138,2394,5217620,4
9365,jolt,Jolt,7,7,0,7,0,jolt,1,4,403,5,27,15,70,881,86,855351,5
8251,idle,YdL,5,3,2,3,2,idle,2,4,529,5,40,12,141,1528,226,5922650,5
12072,osprey,aspri,2,1,1,2,0,osprey,2,5,540,4,2,0,1,221,21,1263936,4
7229,gloss,glcs,3,2,1,2,1,gloss,1,4,519,6,23,14,74,969,90,3430659,5
15710,since,sIns,8,7,1,4,4,since,1,4,560,6,30,7,16064,124182,21334,214305928,5
7165,gimmick,gImIk,1,1,0,1,0,gimmick,2,5,454,8,9,3,55,450,130,444825,6
13326,porous,por|s,1,1,0,1,0,porous,2,5,486,4,21,0,15,574,50,1353861,5
6449,firm,fRm,13,11,2,6,7,firm,1,3,513,5,48,10,1799,21235,2259,44248193,4
12221,own,on,27,13,14,18,9,own,1,2,315,4,123,17,23419,155358,30390,232021125,3
7885,hidden,hIdN,6,5,1,5,1,hidden,2,5,346,4,32,8,1085,10808,2924,26531973,4